window-id,queue-size-CL,queue-size-LL,10.0.0.13:46701 -> 10.0.1.13:3000,10.0.1.13:3000 -> 10.0.0.13:46701,10.0.0.13:43902 -> 10.0.1.13:1000
0,0,41,12,29,
1,0,34,9,25,
2,0,31,10,21,
3,0,32,10,22,
4,0,31,10,21,
5,0,25,8,17,
6,0,26,8,18,
7,0,27,10,17,
8,0,30,13,17,
9,0,27,11,16,
10,0,30,13,17,
11,0,31,13,18,
12,0,28,12,16,
13,0,29,13,16,
14,0,29,13,16,
15,0,30,13,17,
16,0,31,13,18,
17,0,27,12,15,
18,0,27,12,15,
19,0,29,13,16,
20,0,29,13,16,
21,0,27,12,15,
22,0,28,13,15,
23,0,29,12,17,
24,0,30,11,19,
25,0,30,13,17,
26,0,31,13,18,
27,0,29,12,17,
28,0,31,13,18,
29,0,29,13,16,
30,0,28,12,16,
31,0,28,12,16,
32,0,29,13,16,
33,0,30,13,17,
34,0,29,12,17,
35,0,30,13,17,
36,0,31,13,18,
37,0,28,11,17,
38,0,30,13,17,
39,0,27,11,16,
40,0,30,13,17,
41,0,29,12,17,
42,0,28,13,15,
43,0,28,13,15,
44,0,30,13,17,
45,0,29,12,17,
46,0,30,13,17,
47,0,27,11,16,
48,0,29,13,16,
49,0,29,12,17,
50,0,29,13,16,
51,0,28,10,18,
52,0,31,13,18,
53,0,29,10,19,
54,0,30,11,19,
55,0,30,12,18,
56,0,29,11,18,
57,0,30,11,19,
58,0,31,11,20,
59,0,34,13,21,
60,0,29,10,19,
61,0,30,11,19,
62,0,30,10,20,
63,0,28,10,18,
64,0,29,11,18,
65,0,30,12,18,
66,0,29,11,18,
67,0,31,12,19,
68,0,29,11,18,
69,0,30,11,19,
70,0,32,12,20,
71,0,30,12,18,
72,0,27,10,17,
73,0,31,11,20,
74,0,30,11,19,
75,0,29,11,18,
76,0,30,10,20,
77,0,32,13,19,
78,0,32,11,21,
79,0,33,13,20,
80,0,30,11,19,
81,0,30,11,19,
82,0,30,11,19,
83,0,34,12,22,
84,0,30,10,20,
85,0,30,12,18,
86,0,29,11,18,
87,0,31,13,18,
88,0,30,12,18,
89,0,31,13,18,
90,0,30,12,18,
91,0,30,11,19,
92,0,29,11,18,
93,0,29,11,18,
94,0,32,12,20,
95,0,30,12,18,
96,0,29,12,17,
97,0,30,11,19,
98,0,29,11,18,
99,0,31,12,19,
100,0,28,10,18,
101,0,31,11,20,
102,0,31,12,19,
103,0,30,11,19,
104,0,33,12,21,
105,0,33,12,21,
106,0,29,9,20,
107,0,32,11,21,
108,0,30,11,19,
109,0,29,10,19,
110,0,31,11,20,
111,0,29,11,18,
112,0,31,11,20,
113,0,29,11,18,
114,0,31,10,21,
115,0,26,9,17,
116,0,23,6,17,
117,0,23,7,16,
118,0,23,7,16,
119,0,24,7,17,
120,0,25,7,18,
121,0,23,6,17,
122,0,25,7,18,
123,0,25,7,18,
124,0,24,6,18,
125,0,24,7,17,
126,0,23,7,16,
127,0,21,6,15,
128,0,23,7,16,
129,0,22,6,16,
130,0,22,7,15,
131,0,23,6,17,
132,0,23,6,17,
133,0,23,7,16,
134,0,23,6,17,
135,0,22,6,16,
136,0,24,7,17,
137,0,22,6,16,
138,0,23,7,16,
139,0,24,6,18,
140,0,23,6,17,
141,0,24,7,17,
142,0,24,6,18,
143,0,23,6,17,
144,0,24,7,17,
145,0,24,7,17,
146,0,23,7,16,
147,0,23,7,16,
148,0,21,6,15,
149,0,25,7,18,
150,0,23,6,17,
151,0,24,7,17,
152,0,23,7,16,
153,0,23,7,16,
154,0,23,6,17,
155,0,23,7,16,
156,0,23,6,17,
157,0,24,7,17,
158,0,22,6,16,
159,0,25,7,18,
160,0,24,6,18,
161,0,24,7,17,
162,0,23,7,16,
163,0,21,6,15,
164,0,23,7,16,
165,0,22,6,16,
166,0,22,6,16,
167,0,28,8,20,
168,0,24,6,18,
169,0,26,8,18,
170,0,24,6,18,
171,0,24,7,17,
172,0,23,6,17,
173,0,22,6,16,
174,0,22,7,15,
175,0,22,6,16,
176,0,22,6,16,
177,0,24,7,17,
178,0,22,6,16,
179,0,24,7,17,
180,0,23,7,16,
181,0,24,6,18,
182,0,26,8,18,
183,0,24,7,17,
184,0,22,6,16,
185,0,21,6,15,
186,0,22,7,15,
187,0,22,6,16,
188,0,21,6,15,
189,0,24,7,17,
190,0,22,6,16,
191,0,25,7,18,
192,0,23,6,17,
193,0,22,6,16,
194,0,25,7,18,
195,0,23,6,17,
196,0,23,7,16,
197,0,23,6,17,
198,0,23,6,17,
199,0,24,7,17,
200,0,23,6,17,
201,0,23,7,16,
202,0,23,6,17,
203,0,22,6,16,
204,0,23,7,16,
205,0,24,6,18,
206,0,27,10,17,
207,0,22,6,16,
208,0,24,7,17,
209,0,22,6,16,
210,0,23,7,16,
211,0,22,6,16,
212,0,24,7,17,
213,0,24,7,17,
214,0,23,6,17,
215,0,23,7,16,
216,0,25,7,18,
217,0,23,6,17,
218,0,23,8,15,
219,0,23,6,17,
220,0,24,6,18,
221,0,23,6,17,
222,0,24,7,17,
223,0,24,6,18,
224,0,24,7,17,
225,0,24,6,18,
226,0,23,6,17,
227,0,24,7,17,
228,0,24,7,17,
229,0,22,6,16,
230,0,24,7,17,
231,0,23,6,17,
232,0,24,7,17,
233,0,24,6,18,
234,0,22,6,16,
235,0,25,7,18,
236,0,24,7,17,
237,0,25,7,18,
238,0,23,6,17,
239,0,22,6,16,
240,0,22,7,15,
241,0,24,7,17,
242,0,22,6,16,
243,0,26,7,19,
244,0,26,7,19,
245,0,22,6,16,
246,0,25,7,18,
247,0,22,6,16,
248,0,24,8,16,
249,0,27,7,20,
250,0,24,6,18,
251,0,25,7,18,
252,0,25,7,18,
253,0,23,6,17,
254,0,25,7,18,
255,0,24,6,18,
256,0,24,6,18,
257,0,24,7,17,
258,0,22,6,16,
259,0,22,6,16,
260,0,22,7,15,
261,0,22,6,16,
262,0,21,6,15,
263,0,24,7,17,
264,0,23,6,17,
265,0,22,6,16,
266,0,24,7,17,
267,0,22,6,16,
268,0,23,7,16,
269,0,23,6,17,
270,0,23,7,16,
271,0,25,7,18,
272,0,22,6,16,
273,0,24,7,17,
274,0,21,6,15,
275,0,23,7,16,
276,0,24,7,17,
277,0,25,6,19,
278,0,25,7,18,
279,0,25,7,18,
280,0,25,6,19,
281,0,23,6,17,
282,0,24,7,17,
283,0,23,6,17,
284,0,22,6,16,
285,0,22,7,15,
286,0,22,6,16,
287,0,22,6,16,
288,0,22,7,15,
289,0,25,6,19,
290,0,23,6,17,
291,0,26,7,19,
292,0,24,6,18,
293,0,22,6,16,
294,0,24,7,17,
295,0,23,6,17,
296,0,28,9,19,
297,0,25,8,17,
298,0,24,6,18,
299,0,23,7,16,
300,0,24,6,18,
301,0,26,8,18,
302,0,22,6,16,
303,0,24,7,17,
304,0,24,8,16,
305,0,24,7,17,
306,0,24,7,17,
307,0,21,6,15,
308,0,23,7,16,
309,0,24,7,17,
310,0,23,7,16,
311,0,21,6,15,
312,0,22,6,16,
313,0,22,7,15,
314,0,22,7,15,
315,0,26,7,19,
316,0,24,7,17,
317,0,24,7,17,
318,0,25,6,19,
319,0,24,6,18,
320,0,23,6,17,
321,0,24,7,17,
322,0,22,6,16,
323,0,21,6,15,
324,0,23,7,16,
325,0,22,6,16,
326,0,22,6,16,
327,0,27,7,20,
328,0,23,7,16,
329,0,24,7,17,
330,0,22,6,16,
331,0,25,7,18,
332,0,24,6,18,
333,0,24,7,17,
334,0,22,6,16,
335,0,21,6,15,
336,0,24,7,17,
337,0,22,7,15,
338,0,21,6,15,
339,0,23,7,16,
340,0,23,6,17,
341,0,26,7,19,
342,0,24,6,18,
343,0,23,7,16,
344,0,23,6,17,
345,0,23,6,17,
346,0,22,7,15,
347,0,25,6,19,
348,0,23,6,17,
349,0,27,8,19,
350,0,24,6,18,
351,0,23,6,17,
352,0,24,7,17,
353,0,24,6,18,
354,0,24,6,18,
355,0,23,7,16,
356,0,23,6,17,
357,0,22,6,16,
358,0,24,7,17,
359,0,25,7,18,
360,0,24,6,18,
361,0,23,7,16,
362,0,23,6,17,
363,0,23,6,17,
364,0,25,8,17,
365,0,23,7,16,
366,0,24,7,17,
367,0,22,6,16,
368,0,26,7,19,
369,0,24,7,17,
370,0,21,6,15,
371,0,22,7,15,
372,0,22,6,16,
373,0,21,6,15,
374,0,27,7,20,
375,0,24,6,18,
376,0,24,7,17,
377,0,24,6,18,
378,0,23,6,17,
379,0,25,7,18,
380,0,23,6,17,
381,0,22,6,16,
382,0,24,7,17,
383,0,23,6,17,
384,0,24,7,17,
385,0,22,6,16,
386,0,21,6,15,
387,0,26,9,17,
388,0,26,8,18,
389,0,23,6,17,
390,0,24,7,17,
391,0,22,6,16,
392,0,23,6,17,
393,0,23,7,16,
394,0,24,7,17,
395,0,24,8,16,
396,0,23,7,16,
397,0,23,6,17,
398,0,22,6,16,
399,0,23,7,16,
400,0,26,10,16,
401,0,24,7,17,
402,0,23,6,17,
403,0,24,7,17,
404,0,24,6,18,
405,0,25,7,18,
406,0,22,6,16,
407,0,25,7,18,
408,0,23,6,17,
409,0,23,6,17,
410,0,24,8,16,
411,0,24,7,17,
412,0,22,6,16,
413,0,25,7,18,
414,0,23,6,17,
415,0,23,7,16,
416,0,25,6,19,
417,0,24,6,18,
418,0,25,7,18,
419,0,23,6,17,
420,0,25,7,18,
421,0,23,7,16,
422,0,25,7,18,
423,0,23,6,17,
424,0,24,7,17,
425,0,23,6,17,
426,0,26,7,19,
427,0,24,6,18,
428,0,22,6,16,
429,0,24,7,17,
430,0,22,6,16,
431,0,23,7,16,
432,0,24,6,18,
433,0,24,7,17,
434,0,23,6,17,
435,0,23,6,17,
436,0,24,7,17,
437,0,23,6,17,
438,0,24,7,17,
439,0,21,6,15,
440,0,25,7,18,
441,0,24,6,18,
442,0,22,6,16,
443,0,25,7,18,
444,0,23,6,17,
445,0,23,7,16,
446,0,23,6,17,
447,0,22,6,16,
448,0,24,7,17,
449,0,23,7,16,
450,0,24,6,18,
451,0,24,6,18,
452,0,25,7,18,
453,0,24,7,17,
454,0,24,7,17,
455,0,22,6,16,
456,0,21,6,15,
457,0,24,7,17,
458,0,23,6,17,
459,0,23,6,17,
460,0,25,7,18,
461,0,23,7,16,
462,0,25,7,18,
463,0,23,6,17,
464,0,23,7,16,
465,0,24,7,17,
466,0,22,6,16,
467,0,21,6,15,
468,0,24,7,17,
469,0,22,6,16,
470,0,25,7,18,
471,0,23,6,17,
472,0,23,7,16,
473,0,23,6,17,
474,0,22,6,16,
475,0,24,7,17,
476,0,22,6,16,
477,0,22,7,15,
478,0,26,8,18,
479,0,24,6,18,
480,0,23,6,17,
481,0,26,8,18,
482,0,24,6,18,
483,0,23,7,16,
484,0,23,6,17,
485,0,22,6,16,
486,0,25,7,18,
487,0,25,7,18,
488,0,23,6,17,
489,0,22,6,16,
490,0,24,7,17,
491,0,22,6,16,
492,0,25,7,18,
493,0,23,6,17,
494,0,24,7,17,
495,0,24,6,18,
496,0,24,7,17,
497,0,22,6,16,
498,0,25,7,18,
499,0,23,6,17,
500,0,23,7,16,
501,0,24,6,18,
502,0,24,7,17,
503,0,22,6,16,
504,0,22,6,16,
505,0,22,7,15,
506,0,22,6,16,
507,0,22,7,15,
508,0,23,7,16,
509,0,24,7,17,
510,0,23,7,16,
511,0,25,7,18,
512,0,23,7,16,
513,0,23,6,17,
514,0,22,6,16,
515,0,25,7,18,
516,0,23,6,17,
517,0,23,7,16,
518,0,22,6,16,
519,0,21,6,15,
520,0,23,7,16,
521,0,24,7,17,
522,0,22,6,16,
523,0,23,6,17,
524,0,24,7,17,
525,0,23,6,17,
526,0,23,6,17,
527,0,24,7,17,
528,0,24,6,18,
529,0,24,7,17,
530,0,23,6,17,
531,0,23,7,16,
532,0,23,7,16,
533,0,22,6,16,
534,0,21,6,15,
535,0,24,7,17,
536,0,22,6,16,
537,0,24,7,17,
538,0,23,6,17,
539,0,26,8,18,
540,0,22,6,16,
541,0,25,7,18,
542,0,24,7,17,
543,0,23,6,17,
544,0,25,7,18,
545,0,22,6,16,
546,0,26,8,18,
547,0,24,6,18,
548,0,25,7,18,
549,0,23,6,17,
550,0,22,6,16,
551,0,23,7,16,
552,0,22,7,15,
553,0,22,6,16,
554,0,21,6,15,
555,0,27,11,16,
556,0,23,6,17,
557,0,24,7,17,
558,0,22,6,16,
559,0,24,7,17,
560,0,23,6,17,
561,0,24,7,17,
562,0,26,7,19,
563,0,23,6,17,
564,0,22,6,16,
565,0,24,7,17,
566,0,22,6,16,
567,0,25,7,18,
568,0,23,6,17,
569,0,28,10,18,
570,0,23,7,16,
571,0,23,6,17,
572,0,24,6,18,
573,0,24,7,17,
574,0,24,7,17,
575,0,23,6,17,
576,0,23,7,16,
577,0,24,6,18,
578,0,23,7,16,
579,0,22,6,16,
580,0,23,7,16,
581,0,21,6,15,
582,0,23,7,16,
583,0,23,6,17,
584,0,24,7,17,
585,0,23,6,17,
586,0,24,8,16,
587,0,23,6,17,
588,0,24,7,17,
589,0,23,7,16,
590,0,24,6,18,
591,0,24,6,18,
592,0,23,7,16,
593,0,23,7,16,
594,0,23,6,17,
595,0,22,6,16,
596,0,25,7,18,
597,0,23,6,17,
598,0,23,6,17,
599,0,24,7,17,
600,0,25,7,18,
601,0,23,6,17,
602,0,24,7,17,
603,0,22,6,16,
604,0,21,6,15,
605,0,23,7,16,
606,0,24,7,17,
607,0,23,7,16,
608,0,21,6,15,
609,0,22,7,15,
610,0,24,6,18,
611,0,24,7,17,
612,0,23,7,16,
613,0,24,7,17,
614,0,24,6,18,
615,0,23,6,17,
616,0,23,7,16,
617,0,23,6,17,
618,0,24,7,17,
619,0,22,6,16,
620,0,22,6,16,
621,0,26,7,19,
622,0,24,7,17,
623,0,23,7,16,
624,0,24,6,18,
625,0,23,6,17,
626,0,24,7,17,
627,0,23,6,17,
628,0,22,6,16,
629,0,22,7,15,
630,0,21,6,15,
631,0,23,7,16,
632,0,21,6,15,
633,0,25,7,18,
634,0,24,6,18,
635,0,25,7,18,
636,0,24,6,18,
637,0,24,7,17,
638,0,22,6,16,
639,0,21,6,15,
640,0,23,7,16,
641,0,22,6,16,
642,0,23,8,15,
643,0,23,6,17,
644,0,23,6,17,
645,0,23,6,17,
646,0,24,7,17,
647,0,25,7,18,
648,0,22,6,16,
649,0,25,8,17,
650,0,24,7,17,
651,0,22,6,16,
652,0,21,6,15,
653,0,24,7,17,
654,0,22,6,16,
655,0,21,6,15,
656,0,24,7,17,
657,0,22,6,16,
658,0,23,7,16,
659,0,23,6,17,
660,0,26,9,17,
661,0,22,6,16,
662,0,23,6,17,
663,0,25,7,18,
664,0,24,8,16,
665,0,24,7,17,
666,0,23,7,16,
667,0,24,7,17,
668,0,23,6,17,
669,0,24,7,17,
670,0,21,6,15,
671,0,25,7,18,
672,0,23,6,17,
673,0,24,7,17,
674,0,22,6,16,
675,0,24,7,17,
676,0,23,6,17,
677,0,23,7,16,
678,0,24,7,17,
679,0,22,6,16,
680,0,25,7,18,
681,0,24,6,18,
682,0,24,7,17,
683,0,24,6,18,
684,0,24,7,17,
685,0,24,6,18,
686,0,22,6,16,
687,0,24,7,17,
688,0,23,6,17,
689,0,24,7,17,
690,0,23,6,17,
691,0,23,6,17,
692,0,23,8,15,
693,0,21,6,15,
694,0,24,7,17,
695,0,25,7,18,
696,0,22,6,16,
697,0,23,7,16,
698,0,24,6,18,
699,0,23,6,17,
700,0,22,6,16,
701,0,24,7,17,
702,0,24,6,18,
703,0,25,7,18,
704,0,23,6,17,
705,0,25,7,18,
706,0,23,6,17,
707,0,21,6,15,
708,0,22,7,15,
709,0,24,6,18,
710,0,28,9,19,
711,0,23,6,17,
712,0,23,7,16,
713,0,24,8,16,
714,0,23,6,17,
715,0,22,6,16,
716,0,23,7,16,
717,0,24,6,18,
718,0,23,6,17,
719,0,25,7,18,
720,0,23,6,17,
721,0,21,6,15,
722,0,22,7,15,
723,0,23,6,17,
724,0,22,6,16,
725,0,26,9,17,
726,0,24,7,17,
727,0,24,6,18,
728,0,24,7,17,
729,0,24,7,17,
730,0,23,6,17,
731,0,23,7,16,
732,0,23,7,16,
733,0,23,7,16,
734,0,23,7,16,
735,0,23,6,17,
736,0,22,6,16,
737,0,25,7,18,
738,0,22,6,16,
739,0,21,6,15,
740,0,25,7,18,
741,0,24,6,18,
742,0,22,6,16,
743,0,23,7,16,
744,0,25,7,18,
745,0,24,6,18,
746,0,23,6,17,
747,0,24,7,17,
748,0,22,6,16,
749,0,21,6,15,
750,0,23,7,16,
751,0,24,8,16,
752,0,22,6,16,
753,0,25,6,19,
754,0,25,8,17,
755,0,26,8,18,
756,0,24,7,17,
757,0,24,7,17,
758,0,24,6,18,
759,0,23,6,17,
760,0,23,7,16,
761,0,24,6,18,
762,0,23,6,17,
763,0,23,7,16,
764,0,21,6,15,
765,0,24,7,17,
766,0,23,6,17,
767,0,22,6,16,
768,0,22,7,15,
769,0,23,6,17,
770,0,23,6,17,
771,0,23,7,16,
772,0,24,7,17,
773,0,22,6,16,
774,0,25,7,18,
775,0,22,6,16,
776,0,21,6,15,
777,0,23,7,16,
778,0,22,6,16,
779,0,22,7,15,
780,0,24,7,17,
781,0,23,7,16,
782,0,24,7,17,
783,0,23,7,16,
784,0,21,6,15,
785,0,23,7,16,
786,0,22,6,16,
787,0,24,8,16,
788,0,22,7,15,
789,0,23,7,16,
790,0,24,6,18,
791,0,24,7,17,
792,0,25,7,18,
793,0,22,6,16,
794,0,25,7,18,
795,0,22,6,16,
796,0,22,7,15,
797,0,24,6,18,
798,0,23,6,17,
799,0,22,6,16,
800,0,24,7,17,
801,0,23,7,16,
802,0,25,8,17,
803,0,23,6,17,
804,0,23,7,16,
805,0,24,6,18,
806,0,22,6,16,
807,0,23,7,16,
808,0,24,6,18,
809,0,24,6,18,
810,0,23,6,17,
811,0,23,7,16,
812,0,24,7,17,
813,0,22,6,16,
814,0,22,7,15,
815,0,22,6,16,
816,0,24,7,17,
817,0,25,7,18,
818,0,23,6,17,
819,0,22,6,16,
820,0,24,7,17,
821,0,23,6,17,
822,0,22,6,16,
823,0,24,7,17,
824,0,24,7,17,
825,0,22,6,16,
826,0,21,6,15,
827,0,26,7,19,
828,0,24,6,18,
829,0,24,6,18,
830,0,25,7,18,
831,0,24,6,18,
832,0,25,7,18,
833,0,23,6,17,
834,0,24,7,17,
835,0,23,6,17,
836,0,22,6,16,
837,0,23,7,16,
838,0,22,6,16,
839,0,22,6,16,
840,0,23,7,16,
841,0,21,6,15,
842,0,26,9,17,
843,0,22,7,15,
844,0,25,6,19,
845,0,26,7,19,
846,0,24,7,17,
847,0,25,7,18,
848,0,23,7,16,
849,0,23,8,15,
850,0,23,6,17,
851,0,22,6,16,
852,0,24,7,17,
853,0,23,6,17,
854,0,25,8,17,
855,0,22,6,16,
856,0,25,7,18,
857,0,25,6,19,
858,0,23,6,17,
859,0,24,7,17,
860,0,23,6,17,
861,0,22,6,16,
862,0,24,7,17,
863,0,22,6,16,
864,0,25,8,17,
865,0,23,7,16,
866,0,23,6,17,
867,0,23,7,16,
868,0,24,7,17,
869,0,21,6,15,
870,0,27,7,20,
871,0,24,6,18,
872,0,26,7,19,
873,0,25,6,19,
874,0,24,6,18,
875,0,24,7,17,
876,0,23,6,17,
877,0,22,6,16,
878,0,23,7,16,
879,0,21,6,15,
880,0,25,7,18,
881,0,24,6,18,
882,0,25,6,19,
883,0,24,7,17,
884,0,24,6,18,
885,0,23,6,17,
886,0,25,7,18,
887,0,28,11,17,
888,0,25,7,18,
889,0,29,10,19,
890,0,28,11,17,
891,0,29,12,17,
892,0,31,13,18,
893,0,28,11,17,
894,0,29,11,18,
895,0,30,12,18,
896,0,30,12,18,
897,0,28,12,16,
898,0,30,13,17,
899,0,30,13,17,
900,0,32,13,19,
901,0,31,11,20,
902,0,30,13,17,
903,0,29,12,17,
904,0,31,13,18,
905,0,30,13,17,
906,0,28,12,16,
907,0,29,13,16,
908,0,28,12,16,
909,0,30,13,16,1
910,0,24,7,17,
911,0,25,7,18,
912,0,25,7,18,
913,0,23,6,17,
914,0,24,6,18,
915,0,24,7,17,
916,0,25,7,18,
917,0,25,7,17,1
918,0,23,6,17,
919,0,23,7,16,
920,0,25,7,18,
921,0,24,6,18,
922,0,23,6,17,
923,0,24,7,17,
924,0,24,7,16,1
925,0,23,7,16,
926,0,21,6,15,
927,0,22,6,16,
928,0,21,6,15,
929,0,25,7,18,
930,0,23,6,17,
931,0,24,6,18,
932,0,26,7,19,
933,0,25,8,17,
934,0,24,6,18,
935,0,23,6,17,
936,0,24,7,17,
937,0,23,7,16,
938,0,22,6,16,
939,0,23,8,15,
940,0,22,6,15,1
941,0,24,7,17,
942,0,24,7,17,
943,0,22,6,16,
944,0,22,7,15,
945,0,25,7,18,
946,0,24,6,18,
947,0,23,6,17,
948,0,25,7,18,
949,0,24,6,18,
950,0,22,6,16,
951,0,23,7,16,
952,0,23,6,17,
953,0,22,6,16,
954,0,24,7,17,
955,0,25,7,17,1
956,0,25,7,18,
957,0,23,6,17,
958,0,24,7,17,
959,0,22,6,16,
960,0,21,6,15,
961,0,22,7,15,
962,0,22,6,16,
963,0,24,7,17,
964,0,24,7,17,
965,0,22,6,16,
966,0,24,7,17,
967,0,23,6,17,
968,0,22,6,16,
969,0,24,7,17,
970,0,24,7,17,
971,0,24,6,18,
972,0,24,7,17,
973,0,22,6,16,
974,0,21,6,15,
975,0,23,7,16,
976,0,22,6,16,
977,0,21,6,15,
978,0,24,7,17,
979,0,23,6,17,
980,0,23,7,16,
981,0,23,6,17,
982,0,22,6,16,
983,0,24,7,17,
984,0,22,6,16,
985,0,25,8,16,1
986,0,24,6,18,
987,0,23,6,17,
988,0,24,7,17,
989,0,23,6,17,
990,0,21,6,15,
991,0,22,7,15,
992,0,23,6,17,
993,0,22,6,16,
994,0,24,7,17,
995,0,26,6,20,
996,0,25,6,19,
997,0,26,7,19,
998,0,26,6,20,
999,0,28,7,21,
1000,0,34,8,26,
1001,0,33,7,26,
1002,0,32,6,26,
1003,0,34,7,27,
1004,0,35,6,29,
1005,0,36,7,29,
1006,0,36,7,29,
1007,0,36,6,30,
1008,0,36,6,30,
1009,0,39,7,32,
1010,0,37,6,31,
1011,0,42,8,34,
1012,0,39,6,33,
1013,0,39,6,33,
1014,0,42,7,35,
1015,0,42,6,35,1
1016,0,40,6,34,
1017,0,43,7,36,
1018,0,41,6,35,
1019,0,45,7,38,
1020,0,46,10,36,
1021,0,46,8,38,
1022,0,48,9,39,
1023,0,43,6,37,
1024,0,48,9,39,
1025,0,44,6,38,
1026,0,47,7,40,
1027,0,47,7,40,
1028,0,48,9,39,
1029,0,48,7,41,
1030,0,48,7,41,
1031,0,48,7,41,
1032,0,48,6,42,
1033,0,49,7,42,
1034,0,49,7,42,
1035,0,50,7,43,
1036,0,50,7,43,
1037,0,49,6,43,
1038,0,51,7,44,
1039,0,51,6,45,
1040,0,51,7,44,
1041,0,51,6,45,
1042,0,52,6,46,
1043,0,52,7,45,
1044,0,52,6,46,
1045,0,51,6,45,
1046,0,57,9,47,1
1047,0,52,6,46,
1048,0,53,7,46,
1049,0,54,6,48,
1050,0,53,6,47,
1051,0,56,7,49,
1052,0,55,6,49,
1053,0,54,6,48,
1054,0,56,7,49,
1055,0,57,7,50,
1056,0,56,6,50,
1057,0,56,7,49,
1058,0,56,6,50,
1059,0,56,6,50,
1060,0,59,7,52,
1061,0,58,7,51,
1062,0,57,6,51,
1063,0,59,7,52,
1064,0,58,6,52,
1065,0,59,7,52,
1066,0,60,7,53,
1067,0,58,6,52,
1068,0,60,7,53,
1069,0,59,6,53,
1070,0,59,6,53,
1071,0,61,7,54,
1072,0,59,6,53,
1073,0,60,7,53,
1074,0,61,6,55,
1075,0,61,7,54,
1076,0,64,8,55,1
1077,0,63,7,56,
1078,0,62,6,56,
1079,0,61,6,55,
1080,0,63,7,56,
1081,0,63,6,57,
1082,0,65,8,57,
1083,0,63,6,57,
1084,0,65,8,57,
1085,0,63,6,57,
1086,0,65,7,58,
1087,0,64,6,58,
1088,0,63,6,57,
1089,0,65,7,58,
1090,0,65,6,59,
1091,0,66,7,59,
1092,0,64,6,58,
1093,0,66,7,59,
1094,0,65,6,59,
1095,0,68,7,61,
1096,0,67,7,60,
1097,0,65,6,59,
1098,0,76,12,64,
1099,0,74,10,64,
1100,0,73,12,61,
1101,0,73,12,61,
1102,0,74,13,61,
1103,0,75,12,63,
1104,0,74,12,62,
1105,0,76,12,64,
1106,0,75,12,63,
1107,0,77,13,63,1
1108,0,76,12,64,
1109,0,76,11,65,
1110,0,75,11,64,
1111,0,78,12,66,
1112,0,77,11,66,
1113,0,76,12,64,
1114,0,77,13,64,
1115,0,77,11,66,
1116,0,78,12,66,
1117,0,77,11,66,
1118,0,77,11,66,
1119,0,79,11,68,
1120,0,80,12,68,
1121,0,79,10,69,
1122,0,79,12,67,
1123,0,79,12,67,
1124,0,80,12,68,
1125,0,80,11,69,
1126,0,80,10,70,
1127,0,80,10,70,
1128,0,81,11,70,
1129,0,80,12,68,
1130,0,82,13,69,
1131,0,81,11,70,
1132,0,80,10,70,
1133,0,82,12,70,
1134,0,82,11,71,
1135,0,83,11,72,
1136,0,81,10,71,
1137,0,85,13,71,1
1138,0,82,11,71,
1139,0,82,11,71,
1140,0,83,12,71,
1141,0,83,12,71,
1142,0,86,11,75,
1143,0,83,10,73,
1144,0,83,11,72,
1145,0,84,12,72,
1146,0,84,11,73,
1147,0,84,11,73,
1148,0,84,11,73,
1149,0,85,11,74,
1150,0,85,11,74,
1151,0,85,11,74,
1152,0,86,12,74,
1153,0,85,11,74,
1154,0,85,12,73,
1155,0,85,11,74,
1156,0,86,11,75,
1157,0,87,10,77,
1158,0,86,10,76,
1159,0,86,10,76,
1160,0,87,12,75,
1161,0,87,11,76,
1162,0,88,13,75,
1163,0,87,11,76,
1164,0,86,10,76,
1165,0,88,12,76,
1166,0,89,11,78,
1167,0,89,12,76,1
1168,0,89,12,77,
1169,0,90,11,79,
1170,0,88,11,77,
1171,0,88,11,77,
1172,0,88,12,76,
1173,0,88,11,77,
1174,0,89,12,77,
1175,0,89,12,77,
1176,0,89,12,77,
1177,0,74,11,63,
1178,0,61,11,50,
1179,0,61,11,50,
1180,0,55,11,44,
1181,0,48,10,38,
1182,0,45,10,35,
1183,0,47,11,36,
1184,0,56,13,43,
1185,0,61,10,51,
1186,0,61,11,50,
1187,0,62,12,50,
1188,0,64,11,53,
1189,0,63,11,52,
1190,0,63,12,51,
1191,0,65,12,53,
1192,0,64,12,52,
1193,0,64,12,52,
1194,0,66,11,55,
1195,0,65,11,54,
1196,0,65,11,54,
1197,0,66,11,55,
1198,0,66,11,54,1
1199,0,66,12,54,
1200,0,66,12,54,
1201,0,66,10,56,
1202,0,68,11,57,
1203,0,68,11,57,
1204,0,69,11,58,
1205,0,69,12,57,
1206,0,67,11,56,
1207,0,62,7,55,
1208,0,64,7,57,
1209,0,64,7,57,
1210,0,62,6,56,
1211,0,66,7,59,
1212,0,65,7,58,
1213,0,65,7,58,
1214,0,63,6,57,
1215,0,65,7,58,
1216,0,65,6,59,
1217,0,64,6,58,
1218,0,67,8,59,
1219,0,66,6,60,
1220,0,65,6,59,
1221,0,68,7,61,
1222,0,67,6,61,
1223,0,66,6,60,
1224,0,68,7,61,
1225,0,66,6,60,
1226,0,68,7,61,
1227,0,68,6,62,
1228,0,69,7,61,1
1229,0,69,7,62,
1230,0,69,6,63,
1231,0,68,6,62,
1232,0,70,7,63,
1233,0,68,6,62,
1234,0,70,7,63,
1235,0,70,6,64,
1236,0,71,8,63,
1237,0,71,7,64,
1238,0,70,6,64,
1239,0,73,7,66,
1240,0,71,6,65,
1241,0,70,6,64,
1242,0,74,7,67,
1243,0,72,6,66,
1244,0,72,7,65,
1245,0,72,6,66,
1246,0,72,6,66,
1247,0,74,7,67,
1248,0,73,6,67,
1249,0,72,6,66,
1250,0,74,7,67,
1251,0,74,6,68,
1252,0,74,7,67,
1253,0,74,6,68,
1254,0,73,6,67,
1255,0,76,7,69,
1256,0,75,6,69,
1257,0,75,7,68,
1258,0,75,6,68,1
1259,0,77,7,70,
1260,0,76,6,70,
1261,0,75,6,69,
1262,0,77,7,70,
1263,0,75,6,69,
1264,0,79,7,72,
1265,0,77,6,71,
1266,0,77,7,70,
1267,0,77,6,71,
1268,0,77,6,71,
1269,0,79,7,72,
1270,0,78,6,72,
1271,0,78,7,71,
1272,0,79,7,72,
1273,0,78,7,71,
1274,0,80,7,73,
1275,0,78,6,72,
1276,0,79,7,72,
1277,0,79,6,73,
1278,0,80,7,73,
1279,0,80,7,73,
1280,0,80,6,74,
1281,0,79,6,73,
1282,0,81,7,74,
1283,0,80,6,74,
1284,0,83,7,76,
1285,0,81,6,75,
1286,0,80,6,74,
1287,0,83,7,76,
1288,0,82,6,76,
1289,0,84,8,75,1
1290,0,88,11,77,
1291,0,88,11,77,
1292,0,88,11,77,
1293,0,89,10,79,
1294,0,89,11,78,
1295,0,88,10,78,
1296,0,88,11,77,
1297,0,88,10,78,
1298,0,76,12,64,
1299,0,61,11,50,
1300,0,61,11,50,
1301,0,56,12,44,
1302,0,43,10,33,
1303,0,37,11,26,
1304,0,35,13,22,
1305,0,38,11,27,
1306,0,47,13,34,
1307,0,46,11,35,
1308,0,48,12,36,
1309,0,48,11,37,
1310,0,49,11,38,
1311,0,49,11,38,
1312,0,49,10,39,
1313,0,49,11,38,
1314,0,51,11,40,
1315,0,52,13,39,
1316,0,51,11,40,
1317,0,54,11,43,
1318,0,53,10,43,
1319,0,55,10,44,1
1320,0,55,11,44,
1321,0,54,10,44,
1322,0,55,12,43,
1323,0,55,11,44,
1324,0,56,11,45,
1325,0,58,11,47,
1326,0,56,11,45,
1327,0,58,11,47,
1328,0,58,10,48,
1329,0,58,11,47,
1330,0,57,10,47,
1331,0,53,8,45,
1332,0,53,6,47,
1333,0,52,6,46,
1334,0,54,7,47,
1335,0,54,6,48,
1336,0,55,7,48,
1337,0,56,7,49,
1338,0,55,7,48,
1339,0,56,7,49,
1340,0,55,6,49,
1341,0,57,7,50,
1342,0,56,6,50,
1343,0,57,7,50,
1344,0,57,6,51,
1345,0,57,6,51,
1346,0,58,7,51,
1347,0,58,6,52,
1348,0,57,6,51,
1349,0,60,7,52,1
1350,0,59,7,52,
1351,0,59,6,53,
1352,0,59,7,52,
1353,0,61,7,54,
1354,0,60,6,54,
1355,0,59,6,53,
1356,0,62,7,55,
1357,0,62,7,55,
1358,0,61,6,55,
1359,0,62,7,55,
1360,0,62,6,56,
1361,0,63,7,56,
1362,0,61,6,55,
1363,0,65,7,58,
1364,0,63,6,57,
1365,0,62,6,56,
1366,0,65,7,58,
1367,0,64,6,58,
1368,0,64,7,57,
1369,0,64,6,58,
1370,0,64,6,58,
1371,0,66,7,59,
1372,0,65,6,59,
1373,0,64,6,58,
1374,0,67,7,60,
1375,0,66,6,60,
1376,0,66,7,59,
1377,0,67,6,61,
1378,0,66,6,60,
1379,0,68,7,61,
1380,0,70,7,62,1
1381,0,68,6,62,
1382,0,67,6,61,
1383,0,70,7,63,
1384,0,68,6,62,
1385,0,69,7,62,
1386,0,69,6,63,
1387,0,70,8,62,
1388,0,69,7,62,
1389,0,72,7,65,
1390,0,70,6,64,
1391,0,69,6,63,
1392,0,73,8,65,
1393,0,71,6,65,
1394,0,72,7,65,
1395,0,70,6,64,
1396,0,72,7,65,
1397,0,73,7,66,
1398,0,72,7,65,
1399,0,72,6,66,
1400,0,71,6,65,
1401,0,74,7,67,
1402,0,73,6,67,
1403,0,72,6,66,
1404,0,74,7,67,
1405,0,72,6,66,
1406,0,75,7,68,
1407,0,74,6,68,
1408,0,74,7,67,
1409,0,74,7,67,
1410,0,79,8,70,1
1411,0,75,6,69,
1412,0,76,7,69,
1413,0,74,6,68,
1414,0,75,7,68,
1415,0,76,7,69,
1416,0,76,6,70,
1417,0,76,7,69,
1418,0,77,8,69,
1419,0,77,6,71,
1420,0,77,6,71,
1421,0,77,7,70,
1422,0,78,7,71,
1423,0,76,6,70,
1424,0,80,7,73,
1425,0,81,8,73,
1426,0,77,6,71,
1427,0,80,7,73,
1428,0,78,7,71,
1429,0,79,6,73,
1430,0,80,7,73,
1431,0,79,7,72,
1432,0,79,6,73,
1433,0,78,6,72,
1434,0,81,7,74,
1435,0,79,6,73,
1436,0,80,7,73,
1437,0,80,6,74,
1438,0,80,6,74,
1439,0,82,7,75,
1440,0,83,7,75,1
1441,0,80,6,74,
1442,0,82,7,75,
1443,0,83,7,76,
1444,0,83,7,76,
1445,0,82,7,75,
1446,0,82,6,76,
1447,0,81,6,75,
1448,0,83,7,76,
1449,0,82,7,75,
1450,0,83,7,76,
1451,0,81,6,75,
1452,0,84,7,77,
1453,0,82,6,76,
1454,0,74,8,66,
1455,0,61,7,54,
1456,0,53,7,46,
1457,0,51,6,45,
1458,0,47,7,40,
1459,0,36,6,30,
1460,0,27,6,21,
1461,0,24,7,17,
1462,0,25,6,19,
1463,0,36,7,29,
1464,0,39,6,33,
1465,0,40,7,33,
1466,0,42,7,35,
1467,0,41,6,35,
1468,0,41,6,35,
1469,0,43,7,36,
1470,0,42,6,36,
1471,0,45,7,37,1
1472,0,44,7,37,
1473,0,44,6,38,
1474,0,44,6,38,
1475,0,46,7,39,
1476,0,46,6,40,
1477,0,45,6,39,
1478,0,48,8,40,
1479,0,49,7,42,
1480,0,47,6,41,
1481,0,48,7,41,
1482,0,48,6,42,
1483,0,48,6,42,
1484,0,50,7,43,
1485,0,51,7,44,
1486,0,51,8,43,
1487,0,51,7,44,
1488,0,52,7,45,
1489,0,53,7,46,
1490,0,53,7,46,
1491,0,52,7,45,
1492,0,54,7,47,
1493,0,53,6,47,
1494,0,52,6,46,
1495,0,55,7,48,
1496,0,54,6,48,
1497,0,54,7,47,
1498,0,56,7,49,
1499,0,54,6,48,
1500,0,57,7,50,
1501,0,57,6,50,1
1502,0,57,7,50,
1503,0,55,6,49,
1504,0,58,7,51,
1505,0,57,7,50,
1506,0,57,6,51,
1507,0,57,6,51,
1508,0,58,7,51,
1509,0,60,8,52,
1510,0,58,7,51,
1511,0,59,6,53,
1512,0,58,6,52,
1513,0,61,7,54,
1514,0,60,6,54,
1515,0,59,6,53,
1516,0,61,8,53,
1517,0,62,7,55,
1518,0,61,7,54,
1519,0,61,6,55,
1520,0,63,7,56,
1521,0,62,7,55,
1522,0,64,7,57,
1523,0,62,6,56,
1524,0,62,6,56,
1525,0,64,7,57,
1526,0,63,6,57,
1527,0,63,7,56,
1528,0,64,6,58,
1529,0,63,6,57,
1530,0,65,7,58,
1531,0,66,6,59,1
1532,0,64,6,58,
1533,0,66,7,59,
1534,0,64,6,58,
1535,0,66,7,59,
1536,0,66,6,60,
1537,0,65,6,59,
1538,0,68,7,61,
1539,0,67,7,60,
1540,0,68,7,61,
1541,0,67,6,61,
1542,0,67,6,61,
1543,0,68,7,61,
1544,0,68,6,62,
1545,0,67,6,61,
1546,0,70,7,63,
1547,0,68,6,62,
1548,0,71,7,64,
1549,0,69,6,63,
1550,0,71,7,64,
1551,0,70,6,64,
1552,0,70,7,63,
1553,0,70,6,64,
1554,0,70,6,64,
1555,0,72,7,65,
1556,0,71,6,65,
1557,0,71,7,64,
1558,0,71,6,65,
1559,0,71,6,65,
1560,0,74,7,67,
1561,0,72,6,66,
1562,0,74,7,66,1
1563,0,72,6,66,
1564,0,74,7,67,
1565,0,72,6,66,
1566,0,74,7,67,
1567,0,74,6,68,
1568,0,73,6,67,
1569,0,74,7,67,
1570,0,75,7,68,
1571,0,75,6,69,
1572,0,75,7,68,
1573,0,75,6,69,
1574,0,74,6,68,
1575,0,76,7,69,
1576,0,76,6,70,
1577,0,75,6,69,
1578,0,76,7,69,
1579,0,79,8,71,
1580,0,75,6,69,
1581,0,77,7,70,
1582,0,77,7,70,
1583,0,77,6,71,
1584,0,77,7,70,
1585,0,79,7,72,
1586,0,78,6,72,
1587,0,77,6,71,
1588,0,79,7,72,
1589,0,77,6,71,
1590,0,80,7,73,
1591,0,79,6,73,
1592,0,81,7,73,1
1593,0,78,6,72,
1594,0,80,7,73,
1595,0,80,6,74,
1596,0,79,6,73,
1597,0,81,7,74,
1598,0,79,6,73,
1599,0,80,7,73,
1600,0,81,7,74,
1601,0,81,6,75,
1602,0,80,6,74,
1603,0,82,7,75,
1604,0,82,6,76,
1605,0,81,6,75,
1606,0,83,7,76,
1607,0,82,6,76,
1608,0,82,7,75,
1609,0,82,6,76,
1610,0,81,6,75,
1611,0,83,7,76,
1612,0,83,7,76,
1613,0,82,6,76,
1614,0,81,6,75,
1615,0,73,7,66,
1616,0,61,6,55,
1617,0,53,7,46,
1618,0,53,7,46,
1619,0,46,6,40,
1620,0,36,6,30,
1621,0,30,7,23,
1622,0,28,8,19,1
1623,0,25,6,19,
1624,0,39,7,32,
1625,0,39,6,33,
1626,0,40,7,33,
1627,0,42,7,35,
1628,0,40,6,34,
1629,0,43,7,36,
1630,0,42,7,35,
1631,0,43,6,37,
1632,0,42,6,36,
1633,0,46,7,39,
1634,0,46,8,38,
1635,0,45,7,38,
1636,0,46,7,39,
1637,0,47,7,40,
1638,0,45,6,39,
1639,0,47,7,40,
1640,0,47,7,40,
1641,0,49,7,42,
1642,0,49,7,42,
1643,0,47,6,41,
1644,0,51,7,44,
1645,0,49,6,43,
1646,0,50,7,43,
1647,0,50,6,44,
1648,0,49,6,43,
1649,0,52,7,45,
1650,0,51,6,45,
1651,0,51,6,45,
1652,0,53,7,46,
1653,0,55,7,47,1
1654,0,53,6,47,
1655,0,53,7,46,
1656,0,53,6,47,
1657,0,55,7,48,
1658,0,53,6,47,
1659,0,56,7,49,
1660,0,56,7,49,
1661,0,54,6,48,
1662,0,57,7,50,
1663,0,56,6,50,
1664,0,56,7,49,
1665,0,57,6,51,
1666,0,56,6,50,
1667,0,58,7,51,
1668,0,58,6,52,
1669,0,57,6,51,
1670,0,59,7,52,
1671,0,57,6,51,
1672,0,61,8,53,
1673,0,59,6,53,
1674,0,59,7,52,
1675,0,60,6,54,
1676,0,59,6,53,
1677,0,62,7,55,
1678,0,61,6,55,
1679,0,60,6,54,
1680,0,62,7,55,
1681,0,62,6,56,
1682,0,62,7,55,
1683,0,63,7,55,1
1684,0,62,6,56,
1685,0,62,6,56,
1686,0,65,7,58,
1687,0,63,7,56,
1688,0,63,6,57,
1689,0,65,7,58,
1690,0,65,7,58,
1691,0,66,8,58,
1692,0,64,6,58,
1693,0,66,7,59,
1694,0,65,6,59,
1695,0,67,7,60,
1696,0,65,6,59,
1697,0,67,7,60,
1698,0,65,6,59,
1699,0,67,7,60,
1700,0,67,6,61,
1701,0,67,7,60,
1702,0,67,6,61,
1703,0,70,7,63,
1704,0,68,6,62,
1705,0,68,7,61,
1706,0,69,7,62,
1707,0,68,6,62,
1708,0,70,7,63,
1709,0,69,6,63,
1710,0,69,7,62,
1711,0,70,6,64,
1712,0,69,6,63,
1713,0,72,7,64,1
1714,0,71,7,64,
1715,0,71,7,64,
1716,0,71,6,65,
1717,0,70,6,64,
1718,0,71,7,64,
1719,0,74,7,67,
1720,0,72,6,66,
1721,0,74,8,66,
1722,0,71,6,65,
1723,0,72,7,65,
1724,0,73,6,67,
1725,0,72,6,66,
1726,0,74,7,67,
1727,0,72,6,66,
1728,0,75,7,68,
1729,0,73,6,67,
1730,0,75,7,68,
1731,0,74,6,68,
1732,0,75,7,68,
1733,0,75,7,68,
1734,0,76,7,69,
1735,0,74,6,68,
1736,0,76,7,69,
1737,0,76,6,70,
1738,0,75,6,69,
1739,0,77,7,70,
1740,0,76,6,70,
1741,0,77,7,70,
1742,0,77,6,71,
1743,0,77,7,70,
1744,0,77,6,70,1
1745,0,78,7,71,
1746,0,78,6,72,
1747,0,78,7,71,
1748,0,79,7,72,
1749,0,77,6,71,
1750,0,79,7,72,
1751,0,80,7,73,
1752,0,79,7,72,
1753,0,81,7,74,
1754,0,80,7,73,
1755,0,79,6,73,
1756,0,81,7,74,
1757,0,81,7,74,
1758,0,81,7,74,
1759,0,80,6,74,
1760,0,82,8,74,
1761,0,81,6,75,
1762,0,80,6,74,
1763,0,82,7,75,
1764,0,82,7,75,
1765,0,83,7,76,
1766,0,81,6,75,
1767,0,83,7,76,
1768,0,82,6,76,
1769,0,82,7,75,
1770,0,82,6,76,
1771,0,81,6,75,
1772,0,84,7,77,
1773,0,82,6,76,
1774,0,84,8,75,1
1775,0,82,6,76,
1776,0,70,6,64,
1777,0,59,7,52,
1778,0,53,6,47,
1779,0,53,8,45,
1780,0,46,7,39,
1781,0,35,6,29,
1782,0,28,7,21,
1783,0,24,6,18,
1784,0,25,6,19,
1785,0,39,7,32,
1786,0,39,6,33,
1787,0,40,7,33,
1788,0,42,7,35,
1789,0,43,7,36,
1790,0,42,6,36,
1791,0,41,6,35,
1792,0,44,7,37,
1793,0,43,6,37,
1794,0,45,7,38,
1795,0,44,7,37,
1796,0,44,6,38,
1797,0,46,7,39,
1798,0,46,6,40,
1799,0,46,7,39,
1800,0,48,7,41,
1801,0,46,6,40,
1802,0,49,7,42,
1803,0,48,6,42,
1804,0,50,7,42,1
1805,0,49,7,42,
1806,0,49,6,43,
1807,0,50,6,44,
1808,0,50,7,43,
1809,0,50,6,44,
1810,0,50,6,44,
1811,0,51,7,44,
1812,0,53,7,46,
1813,0,52,6,46,
1814,0,52,7,45,
1815,0,53,6,47,
1816,0,53,6,47,
1817,0,54,7,47,
1818,0,56,8,48,
1819,0,56,8,48,
1820,0,54,6,48,
1821,0,55,7,48,
1822,0,56,7,49,
1823,0,56,6,50,
1824,0,57,7,50,
1825,0,57,7,50,
1826,0,56,6,50,
1827,0,58,7,51,
1828,0,58,7,51,
1829,0,59,7,52,
1830,0,58,7,51,
1831,0,59,7,52,
1832,0,59,6,53,
1833,0,59,7,52,
1834,0,60,7,53,
1835,0,58,6,52,
1836,0,61,7,54,
1837,0,59,6,53,
1838,0,60,7,53,
1839,0,61,6,55,
1840,0,62,7,55,
1841,0,60,6,54,
1842,0,65,8,57,
1843,0,61,6,55,
1844,0,63,7,56,
1845,0,62,7,55,
1846,0,63,6,57,
1847,0,63,7,56,
1848,0,64,7,57,
1849,0,65,7,58,
1850,0,64,7,57,
1851,0,65,7,58,
1852,0,63,6,57,
1853,0,66,7,59,
1854,0,65,6,59,
1855,0,65,7,58,
1856,0,66,6,60,
1857,0,65,6,59,
1858,0,68,7,61,
1859,0,66,6,60,
1860,0,66,6,60,
1861,0,68,7,61,
1862,0,66,6,60,
1863,0,67,7,60,
1864,0,68,7,61,
1865,0,68,6,62,
1866,0,67,6,61,
1867,0,70,7,63,
1868,0,69,6,63,
1869,0,68,6,62,
1870,0,70,7,63,
1871,0,70,7,63,
1872,0,70,7,63,
1873,0,70,7,63,
1874,0,70,6,64,
1875,0,69,6,63,
1876,0,73,7,66,
1877,0,71,6,65,
1878,0,70,6,64,
1879,0,71,7,64,
1880,0,72,7,65,
1881,0,72,6,66,
1882,0,71,6,65,
1883,0,73,7,66,
1884,0,74,7,67,
1885,0,73,6,67,
1886,0,72,6,66,
1887,0,74,7,67,
1888,0,73,6,67,
1889,0,75,7,68,
1890,0,74,7,67,
1891,0,75,7,68,
1892,0,73,6,67,
1893,0,76,7,69,
1894,0,75,6,69,
1895,0,74,6,68,
1896,0,76,7,69,
1897,0,75,6,69,
1898,0,77,7,70,
1899,0,76,7,69,
1900,0,77,7,70,
1901,0,76,7,69,
1902,0,78,7,71,
1903,0,77,6,71,
1904,0,76,6,70,
1905,0,78,7,71,
1906,0,77,6,71,
1907,0,78,7,71,
1908,0,78,6,72,
1909,0,77,6,71,
1910,0,78,7,71,
1911,0,80,7,73,
1912,0,79,6,73,
1913,0,78,6,72,
1914,0,80,8,72,
1915,0,79,7,72,
1916,0,81,7,74,
1917,0,79,6,73,
1918,0,80,7,73,
1919,0,80,6,74,
1920,0,79,6,73,
1921,0,82,7,75,
1922,0,81,6,75,
1923,0,80,6,74,
1924,0,82,7,75,
1925,0,80,6,74,
1926,0,84,7,77,
1927,0,82,6,76,
1928,0,82,7,75,
1929,0,82,6,76,
1930,0,81,6,75,
1931,0,84,7,77,
1932,0,82,6,76,
1933,0,83,8,75,
1934,0,83,7,76,
1935,0,82,6,76,
1936,0,82,7,75,
1937,0,72,8,64,
1938,0,58,6,52,
1939,0,54,7,47,
1940,0,53,7,46,
1941,0,46,6,40,
1942,0,37,7,30,
1943,0,28,6,22,
1944,0,24,7,17,
1945,0,26,7,19,
1946,0,40,7,33,
1947,0,39,6,33,
1948,0,41,7,34,
1949,0,41,6,35,
1950,0,40,6,34,
1951,0,45,9,36,
1952,0,43,8,35,
1953,0,43,7,36,
1954,0,43,6,37,
1955,0,45,8,37,
1956,0,44,7,37,
1957,0,46,7,39,
1958,0,45,7,38,
1959,0,46,6,40,
1960,0,46,6,40,
1961,0,47,7,40,
1962,0,47,7,40,
1963,0,48,7,41,
1964,0,49,7,42,
1965,0,49,7,42,
1966,0,49,6,43,
1967,0,49,7,42,
1968,0,51,8,43,
1969,0,50,6,44,
1970,0,50,6,44,
1971,0,51,7,44,
1972,0,51,6,45,
1973,0,51,6,45,
1974,0,53,7,46,
1975,0,53,7,46,
1976,0,53,6,47,
1977,0,53,7,46,
1978,0,53,6,47,
1979,0,56,7,49,
1980,0,54,6,48,
1981,0,54,6,48,
1982,0,56,7,49,
1983,0,54,6,48,
1984,0,56,7,49,
1985,0,56,6,50,
1986,0,57,7,50,
1987,0,56,6,50,
1988,0,59,7,52,
1989,0,57,6,51,
1990,0,57,6,51,
1991,0,59,7,52,
1992,0,58,6,52,
1993,0,59,7,52,
1994,0,59,6,53,
1995,0,60,7,53,
1996,0,60,6,54,
1997,0,59,6,53,
1998,0,62,7,55,
1999,0,60,6,54,
2000,0,62,7,55,
2001,0,61,7,54,
2002,0,62,7,55,
2003,0,61,6,55,
2004,0,62,7,55,
2005,0,62,6,56,
2006,0,63,7,56,
2007,0,63,6,57,
2008,0,63,7,56,
2009,0,63,6,57,
2010,0,63,6,57,
2011,0,65,7,58,
2012,0,64,6,58,
2013,0,64,7,57,
2014,0,66,7,59,
2015,0,64,6,58,
2016,0,66,7,59,
2017,0,66,7,59,
2018,0,67,7,60,
2019,0,65,6,59,
2020,0,67,7,60,
2021,0,67,6,61,
2022,0,67,7,60,
2023,0,66,6,60,
2024,0,68,7,61,
2025,0,68,6,62,
2026,0,67,6,61,
2027,0,69,7,62,
2028,0,67,6,61,
2029,0,69,7,62,
2030,0,69,6,63,
2031,0,68,6,62,
2032,0,70,7,63,
2033,0,72,7,65,
2034,0,70,6,64,
2035,0,69,6,63,
2036,0,70,7,63,
2037,0,73,7,66,
2038,0,71,6,65,
2039,0,72,7,65,
2040,0,70,6,64,
2041,0,73,7,66,
2042,0,71,6,65,
2043,0,74,7,67,
2044,0,72,6,66,
2045,0,73,7,66,
2046,0,73,6,67,
2047,0,72,6,66,
2048,0,74,7,67,
2049,0,72,6,66,
2050,0,76,7,69,
2051,0,74,6,68,
2052,0,73,6,67,
2053,0,76,7,69,
2054,0,75,6,69,
2055,0,75,7,68,
2056,0,75,7,68,
2057,0,76,7,69,
2058,0,74,6,68,
2059,0,76,7,69,
2060,0,76,6,70,
2061,0,78,8,70,
2062,0,75,6,69,
2063,0,78,7,71,
2064,0,76,6,70,
2065,0,77,7,70,
2066,0,77,7,70,
2067,0,77,6,71,
2068,0,77,6,71,
2069,0,79,8,71,
2070,0,78,6,72,
2071,0,78,6,72,
2072,0,79,7,72,
2073,0,79,6,73,
2074,0,78,6,72,
2075,0,82,8,74,
2076,0,81,8,73,
2077,0,81,7,74,
2078,0,79,6,73,
2079,0,82,7,75,
2080,0,80,6,74,
2081,0,79,6,73,
2082,0,83,7,76,
2083,0,81,6,75,
2084,0,82,7,75,
2085,0,80,6,74,
2086,0,82,7,75,
2087,0,81,6,75,
2088,0,82,7,75,
2089,0,82,6,76,
2090,0,81,6,75,
2091,0,82,7,75,
2092,0,82,6,76,
2093,0,81,6,75,
2094,0,83,7,76,
2095,0,81,6,75,
2096,0,83,7,76,
2097,0,80,7,73,
2098,0,67,6,61,
2099,0,56,6,50,
2100,0,55,9,46,
2101,0,50,6,44,
2102,0,42,6,36,
2103,0,32,6,26,
2104,0,28,7,21,
2105,0,23,6,17,
2106,0,29,7,22,
2107,0,39,6,33,
2108,0,40,6,34,
2109,0,40,7,33,
2110,0,41,6,35,
2111,0,40,6,34,
2112,0,43,7,36,
2113,0,41,6,35,
2114,0,44,7,37,
2115,0,44,7,37,
2116,0,43,6,37,
2117,0,46,7,39,
2118,0,45,7,38,
2119,0,46,7,39,
2120,0,45,6,39,
2121,0,46,7,39,
2122,0,47,7,40,
2123,0,48,7,41,
2124,0,48,7,41,
2125,0,48,6,42,
2126,0,48,6,42,
2127,0,49,7,42,
2128,0,49,6,43,
2129,0,49,6,43,
2130,0,51,7,44,
2131,0,51,6,45,
2132,0,51,7,44,
2133,0,51,6,45,
2134,0,51,6,45,
2135,0,54,7,47,
2136,0,52,6,46,
2137,0,54,7,47,
2138,0,52,6,46,
2139,0,55,7,48,
2140,0,54,6,48,
2141,0,54,7,47,
2142,0,55,6,49,
2143,0,54,6,48,
2144,0,57,7,50,
2145,0,56,6,50,
2146,0,55,6,49,
2147,0,56,7,49,
2148,0,59,7,52,
2149,0,57,6,51,
2150,0,57,7,50,
2151,0,59,7,52,
2152,0,59,7,52,
2153,0,60,7,53,
2154,0,59,6,53,
2155,0,58,6,52,
2156,0,60,7,53,
2157,0,59,7,52,
2158,0,60,6,54,
2159,0,59,6,53,
2160,0,61,7,54,
2161,0,60,6,54,
2162,0,63,7,56,
2163,0,61,6,55,
2164,0,61,6,55,
2165,0,64,7,57,
2166,0,62,6,56,
2167,0,62,7,55,
2168,0,63,7,56,
2169,0,64,7,57,
2170,0,62,6,56,
2171,0,64,7,57,
2172,0,64,6,58,
2173,0,63,6,57,
2174,0,64,7,57,
2175,0,65,7,58,
2176,0,65,6,59,
2177,0,64,6,58,
2178,0,67,7,60,
2179,0,65,6,59,
2180,0,66,7,59,
2181,0,68,7,61,
2182,0,67,7,60,
2183,0,68,7,61,
2184,0,68,7,61,
2185,0,66,6,60,
2186,0,68,7,61,
2187,0,68,7,61,
2188,0,68,6,62,
2189,0,67,6,61,
2190,0,71,7,64,
2191,0,69,6,63,
2192,0,68,6,62,
2193,0,70,7,63,
2194,0,69,6,63,
2195,0,70,7,63,
2196,0,70,6,64,
2197,0,71,7,64,
2198,0,70,6,64,
2199,0,72,7,65,
2200,0,71,7,64,
2201,0,72,7,65,
2202,0,71,6,65,
2203,0,73,7,66,
2204,0,72,6,66,
2205,0,72,7,65,
2206,0,79,12,67,
2207,0,79,10,69,
2208,0,80,11,69,
2209,0,79,10,69,
2210,0,81,11,70,
2211,0,81,11,70,
2212,0,81,12,69,
2213,0,80,12,68,
2214,0,81,11,70,
2215,0,82,12,70,
2216,0,81,11,70,
2217,0,82,12,70,
2218,0,82,11,71,
2219,0,82,11,71,
2220,0,83,12,71,
2221,0,83,11,72,
2222,0,85,11,74,
2223,0,84,11,73,
2224,0,84,11,73,
2225,0,83,11,72,
2226,0,85,11,74,
2227,0,84,11,73,
2228,0,85,11,74,
2229,0,84,11,73,
2230,0,86,11,75,
2231,0,85,10,75,
2232,0,85,11,74,
2233,0,86,12,74,
2234,0,86,11,75,
2235,0,86,11,75,
2236,0,87,11,76,
2237,0,88,12,76,
2238,0,87,12,75,
2239,0,88,11,77,
2240,0,87,11,76,
2241,0,88,12,76,
2242,0,87,11,76,
2243,0,88,10,78,
2244,0,88,11,77,
2245,0,89,11,78,
2246,0,88,11,77,
2247,0,89,12,77,
2248,0,89,11,78,
2249,0,88,11,77,
2250,0,88,12,76,
2251,0,88,12,76,
2252,0,84,10,74,
2253,0,72,11,61,
2254,0,61,11,50,
2255,0,59,10,49,
2256,0,53,12,41,
2257,0,44,11,33,
2258,0,35,11,24,
2259,0,31,10,21,
2260,0,42,12,30,
2261,0,46,12,34,
2262,0,47,12,35,
2263,0,46,11,35,
2264,0,47,11,36,
2265,0,50,13,37,
2266,0,48,12,36,
2267,0,51,12,39,
2268,0,50,11,39,
2269,0,51,11,40,
2270,0,51,11,40,
2271,0,52,12,40,
2272,0,52,11,41,
2273,0,54,11,43,
2274,0,53,11,42,
2275,0,54,11,43,
2276,0,54,10,44,
2277,0,55,12,43,
2278,0,56,11,45,
2279,0,56,12,44,
2280,0,59,12,47,
2281,0,57,10,47,
2282,0,57,11,46,
2283,0,57,11,46,
2284,0,58,12,46,
2285,0,58,10,48,
2286,0,59,11,48,
2287,0,60,12,48,
2288,0,59,12,47,
2289,0,60,11,49,
2290,0,61,11,50,
2291,0,60,11,49,
2292,0,62,11,51,
2293,0,61,12,49,
2294,0,63,12,51,
2295,0,62,11,51,
2296,0,63,11,52,
2297,0,64,11,53,
2298,0,63,11,52,
2299,0,64,12,52,
2300,0,65,12,53,
2301,0,66,12,54,
2302,0,66,12,54,
2303,0,65,12,53,
2304,0,67,12,55,
2305,0,66,10,56,
2306,0,68,11,57,
2307,0,67,11,56,
2308,0,67,12,55,
2309,0,67,12,55,
2310,0,66,10,56,
2311,0,70,11,59,
2312,0,70,12,58,
2313,0,68,11,57,
2314,0,70,11,59,
2315,0,69,11,58,
2316,0,70,12,58,
2317,0,71,13,58,
2318,0,71,11,60,
2319,0,72,11,61,
2320,0,73,11,62,
2321,0,71,11,60,
2322,0,72,12,60,
2323,0,71,11,60,
2324,0,73,12,61,
2325,0,73,12,61,
2326,0,72,11,61,
2327,0,76,13,63,
2328,0,73,10,63,
2329,0,74,12,62,
2330,0,76,12,64,
2331,0,75,11,64,
2332,0,75,13,62,
2333,0,74,11,63,
2334,0,75,10,65,
2335,0,75,10,65,
2336,0,75,10,65,
2337,0,77,11,66,
2338,0,77,12,65,
2339,0,76,11,65,
2340,0,76,12,64,
2341,0,79,11,68,
2342,0,77,11,66,
2343,0,77,10,67,
2344,0,79,12,67,
2345,0,78,11,67,
2346,0,81,12,69,
2347,0,82,12,70,
2348,0,80,10,70,
2349,0,79,12,67,
2350,0,80,12,68,
2351,0,83,13,70,
2352,0,81,11,70,
2353,0,80,11,69,
2354,0,82,11,71,
2355,0,81,10,71,
2356,0,81,10,71,
2357,0,81,11,70,
2358,0,82,12,70,
2359,0,82,10,72,
2360,0,84,12,72,
2361,0,83,11,72,
2362,0,83,12,71,
2363,0,82,11,71,
2364,0,84,12,72,
2365,0,84,12,72,
2366,0,83,11,72,
2367,0,83,11,72,
2368,0,85,12,73,
2369,0,87,12,75,
2370,0,84,11,73,
2371,0,85,11,74,
2372,0,86,13,73,
2373,0,87,12,75,
2374,0,86,12,74,
2375,0,86,11,75,
2376,0,87,11,76,
2377,0,86,10,76,
2378,0,87,12,75,
2379,0,87,12,75,
2380,0,88,13,75,
2381,0,87,11,76,
2382,0,88,13,75,
2383,0,88,11,77,
2384,0,88,12,76,
2385,0,87,11,76,
2386,0,83,7,76,
2387,0,83,7,76,
2388,0,81,6,75,
2389,0,83,7,76,
2390,0,83,7,76,
2391,0,82,6,76,
2392,0,81,6,75,
2393,0,83,7,76,
2394,0,82,6,76,
2395,0,82,7,75,
2396,0,69,6,63,
2397,0,58,7,51,
2398,0,52,6,46,
2399,0,51,7,44,
2400,0,44,6,38,
2401,0,34,6,28,
2402,0,26,6,20,
2403,0,24,7,17,
2404,0,28,6,22,
2405,0,40,7,33,
2406,0,41,7,34,
2407,0,39,6,33,
2408,0,42,7,35,
2409,0,40,6,34,
2410,0,44,7,37,
2411,0,42,6,36,
2412,0,42,6,36,
2413,0,46,7,39,
2414,0,44,6,38,
2415,0,44,7,37,
2416,0,47,8,39,
2417,0,46,7,39,
2418,0,47,7,40,
2419,0,45,6,39,
2420,0,49,7,42,
2421,0,48,7,41,
2422,0,48,7,41,
2423,0,47,6,41,
2424,0,50,7,43,
2425,0,52,8,44,
2426,0,49,6,43,
2427,0,50,7,43,
2428,0,51,7,44,
2429,0,51,6,45,
2430,0,51,7,44,
2431,0,52,7,45,
2432,0,51,6,45,
2433,0,53,7,46,
2434,0,52,6,46,
2435,0,53,7,46,
2436,0,53,7,46,
2437,0,55,7,48,
2438,0,54,6,48,
2439,0,54,7,47,
2440,0,54,6,48,
2441,0,56,7,49,
2442,0,54,6,48,
2443,0,56,7,49,
2444,0,56,6,50,
2445,0,55,6,49,
2446,0,58,7,51,
2447,0,57,6,51,
2448,0,56,6,50,
2449,0,59,7,52,
2450,0,57,6,51,
2451,0,60,8,52,
2452,0,59,6,53,
2453,0,59,7,52,
2454,0,59,6,53,
2455,0,59,6,53,
2456,0,62,7,55,
2457,0,60,6,54,
2458,0,59,6,53,
2459,0,62,7,55,
2460,0,61,7,54,
2461,0,63,7,56,
2462,0,62,6,56,
2463,0,62,7,55,
2464,0,62,6,56,
2465,0,63,6,57,
2466,0,63,7,56,
2467,0,64,7,57,
2468,0,62,6,56,
2469,0,65,7,58,
2470,0,65,7,58,
2471,0,64,6,58,
2472,0,64,7,57,
2473,0,65,6,59,
2474,0,65,6,59,
2475,0,65,7,58,
2476,0,66,6,60,
2477,0,65,6,59,
2478,0,68,8,60,
2479,0,65,6,59,
2480,0,67,7,60,
2481,0,67,7,60,
2482,0,69,7,62,
2483,0,66,6,60,
2484,0,69,7,62,
2485,0,67,6,61,
2486,0,70,7,63,
2487,0,69,7,62,
2488,0,69,7,62,
2489,0,70,7,63,
2490,0,70,7,63,
2491,0,69,6,63,
2492,0,70,7,63,
2493,0,71,7,64,
2494,0,69,6,63,
2495,0,72,7,65,
2496,0,71,6,65,
2497,0,73,8,65,
2498,0,71,7,64,
2499,0,72,7,65,
2500,0,72,6,66,
2501,0,73,7,66,
2502,0,71,6,65,
2503,0,73,7,66,
2504,0,72,6,66,
2505,0,75,7,68,
2506,0,73,6,67,
2507,0,73,7,66,
2508,0,75,7,68,
2509,0,76,7,69,
2510,0,80,10,70,
2511,0,80,11,69,
2512,0,82,11,71,
2513,0,82,11,71,
2514,0,83,11,72,
2515,0,85,12,73,
2516,0,84,12,72,
2517,0,83,10,73,
2518,0,83,10,73,
2519,0,82,12,70,
2520,0,84,11,73,
2521,0,85,12,73,
2522,0,84,10,74,
2523,0,83,11,72,
2524,0,85,10,75,
2525,0,84,11,73,
2526,0,87,12,75,
2527,0,85,12,73,
2528,0,86,12,74,
2529,0,85,11,74,
2530,0,86,12,74,
2531,0,85,10,75,
2532,0,87,11,76,
2533,0,86,12,74,
2534,0,86,12,74,
2535,0,86,11,75,
2536,0,87,12,75,
2537,0,88,11,77,
2538,0,88,10,78,
2539,0,89,12,77,
2540,0,88,11,77,
2541,0,88,11,77,
2542,0,89,11,78,
2543,0,88,12,76,
2544,0,88,11,77,
2545,0,91,12,79,
2546,0,90,12,78,
2547,0,89,10,79,
2548,0,88,11,77,
2549,0,89,11,78,
2550,0,81,11,70,
2551,0,71,12,59,
2552,0,63,12,51,
2553,0,60,11,49,
2554,0,55,12,43,
2555,0,40,8,32,
2556,0,33,10,23,
2557,0,32,12,20,
2558,0,44,12,32,
2559,0,45,11,34,
2560,0,47,12,35,
2561,0,47,11,36,
2562,0,48,12,36,
2563,0,48,11,37,
2564,0,48,12,36,
2565,0,50,11,39,
2566,0,50,11,39,
2567,0,51,12,39,
2568,0,53,11,42,
2569,0,49,9,40,
2570,0,46,7,39,
2571,0,46,7,39,
2572,0,48,8,40,
2573,0,47,6,41,
2574,0,50,7,43,
2575,0,48,6,42,
2576,0,48,7,41,
2577,0,50,7,43,
2578,0,48,6,42,
2579,0,50,7,43,
2580,0,50,6,44,
2581,0,51,7,44,
2582,0,52,7,45,
2583,0,50,6,44,
2584,0,54,7,47,
2585,0,52,6,46,
2586,0,51,6,45,
2587,0,54,7,47,
2588,0,53,6,47,
2589,0,53,7,46,
2590,0,54,6,48,
2591,0,53,6,47,
2592,0,54,7,47,
2593,0,57,7,50,
2594,0,55,6,49,
2595,0,55,6,49,
2596,0,57,7,50,
2597,0,56,6,50,
2598,0,57,7,50,
2599,0,57,6,51,
2600,0,58,7,51,
2601,0,58,7,51,
2602,0,60,7,53,
2603,0,58,6,52,
2604,0,58,7,51,
2605,0,60,7,53,
2606,0,58,6,52,
2607,0,61,8,53,
2608,0,60,6,54,
2609,0,60,7,53,
2610,0,61,7,54,
2611,0,63,7,56,
2612,0,61,6,55,
2613,0,60,6,54,
2614,0,63,7,56,
2615,0,61,6,55,
2616,0,64,7,57,
2617,0,62,6,56,
2618,0,63,7,56,
2619,0,63,6,57,
2620,0,63,6,57,
2621,0,64,7,57,
2622,0,65,8,57,
2623,0,65,7,58,
2624,0,63,6,57,
2625,0,66,7,59,
2626,0,65,6,59,
2627,0,65,7,58,
2628,0,65,6,59,
2629,0,66,6,60,
2630,0,66,7,59,
2631,0,66,6,60,
2632,0,65,6,59,
2633,0,68,7,61,
2634,0,67,7,60,
2635,0,67,7,60,
2636,0,68,6,62,
2637,0,69,7,62,
2638,0,68,6,62,
2639,0,68,7,61,
2640,0,69,6,63,
2641,0,68,6,62,
2642,0,70,7,63,
2643,0,68,6,62,
2644,0,71,7,64,
2645,0,70,6,64,
2646,0,69,6,63,
2647,0,72,7,65,
2648,0,71,6,65,
2649,0,72,7,65,
2650,0,70,6,64,
2651,0,72,7,65,
2652,0,71,6,65,
2653,0,74,7,67,
2654,0,72,7,65,
2655,0,72,6,66,
2656,0,71,6,65,
2657,0,73,7,66,
2658,0,73,6,67,
2659,0,73,7,66,
2660,0,75,8,67,
2661,0,73,6,67,
2662,0,75,7,68,
2663,0,75,7,68,
2664,0,73,6,67,
2665,0,76,7,69,
2666,0,76,7,69,
2667,0,76,7,69,
2668,0,75,7,68,
2669,0,76,7,69,
2670,0,75,6,69,
2671,0,78,8,70,
2672,0,78,7,71,
2673,0,76,6,70,
2674,0,76,6,70,
2675,0,76,7,69,
2676,0,78,7,71,
2677,0,77,6,71,
2678,0,76,6,70,
2679,0,79,7,72,
2680,0,79,7,72,
2681,0,78,6,72,
2682,0,77,6,71,
2683,0,79,7,72,
2684,0,79,6,73,
2685,0,79,7,72,
2686,0,79,6,73,
2687,0,78,6,72,
2688,0,81,7,74,
2689,0,79,6,73,
2690,0,80,7,73,
2691,0,80,6,74,
2692,0,79,6,73,
2693,0,81,7,74,
2694,0,81,6,75,
2695,0,80,6,74,
2696,0,81,7,74,
2697,0,82,7,75,
2698,0,82,6,76,
2699,0,82,7,75,
2700,0,82,6,76,
2701,0,82,6,76,
2702,0,83,7,76,
2703,0,83,7,76,
2704,0,82,6,76,
2705,0,82,7,75,
2706,0,82,6,76,
2707,0,81,6,75,
2708,0,83,7,76,
2709,0,72,6,66,
2710,0,61,7,54,
2711,0,54,7,47,
2712,0,52,6,46,
2713,0,48,7,41,
2714,0,36,6,30,
2715,0,29,7,22,
2716,0,24,6,18,
2717,0,24,6,18,
2718,0,37,7,30,
2719,0,39,6,33,
2720,0,40,7,33,
2721,0,42,7,35,
2722,0,40,6,34,
2723,0,43,7,36,
2724,0,42,6,36,
2725,0,43,7,36,
2726,0,43,7,36,
2727,0,45,7,38,
2728,0,47,8,39,
2729,0,44,6,38,
2730,0,46,7,39,
2731,0,48,8,40,
2732,0,45,6,39,
2733,0,47,7,40,
2734,0,48,7,41,
2735,0,48,6,42,
2736,0,48,7,41,
2737,0,49,7,42,
2738,0,49,6,43,
2739,0,49,7,42,
2740,0,50,6,44,
2741,0,49,6,43,
2742,0,51,7,44,
2743,0,53,7,46,
2744,0,51,6,45,
2745,0,52,7,45,
2746,0,53,7,46,
2747,0,52,6,46,
2748,0,53,7,46,
2749,0,54,7,47,
2750,0,52,6,46,
2751,0,57,10,47,
2752,0,59,11,48,
2753,0,62,12,50,
2754,0,62,12,50,
2755,0,63,11,52,
2756,0,62,11,51,
2757,0,63,11,52,
2758,0,62,12,50,
2759,0,65,12,53,
2760,0,63,10,53,
2761,0,64,11,53,
2762,0,65,12,53,
2763,0,65,11,54,
2764,0,67,11,56,
2765,0,65,10,55,
2766,0,67,11,56,
2767,0,67,12,55,
2768,0,67,12,55,
2769,0,66,11,55,
2770,0,67,13,54,
2771,0,68,11,57,
2772,0,68,12,56,
2773,0,70,12,58,
2774,0,68,10,58,
2775,0,69,12,57,
2776,0,69,11,58,
2777,0,69,11,58,
2778,0,70,12,58,
2779,0,70,12,58,
2780,0,70,11,59,
2781,0,72,11,61,
2782,0,71,10,61,
2783,0,71,10,61,
2784,0,72,11,61,
2785,0,73,12,61,
2786,0,72,12,60,
2787,0,71,11,60,
2788,0,74,12,62,
2789,0,75,11,64,
2790,0,73,11,62,
2791,0,74,11,63,
2792,0,74,10,64,
2793,0,75,11,64,
2794,0,74,11,63,
2795,0,75,11,64,
2796,0,76,12,64,
2797,0,76,10,66,
2798,0,76,11,65,
2799,0,77,11,66,
2800,0,76,12,64,
2801,0,76,12,64,
2802,0,76,11,65,
2803,0,79,11,68,
2804,0,77,11,66,
2805,0,78,11,67,
2806,0,79,11,68,
2807,0,79,11,68,
2808,0,78,12,66,
2809,0,78,10,68,
2810,0,80,11,69,
2811,0,80,11,69,
2812,0,79,11,68,
2813,0,80,11,69,
2814,0,80,11,69,
2815,0,80,11,69,
2816,0,81,11,70,
2817,0,81,11,70,
2818,0,81,10,71,
2819,0,82,12,70,
2820,0,81,11,70,
2821,0,81,10,71,
2822,0,84,12,72,
2823,0,83,10,73,
2824,0,82,11,71,
2825,0,83,12,71,
2826,0,84,12,72,
2827,0,83,11,72,
2828,0,83,10,73,
2829,0,83,11,72,
2830,0,85,11,74,
2831,0,84,11,73,
2832,0,85,10,75,
2833,0,84,10,74,
2834,0,86,12,74,
2835,0,85,12,73,
2836,0,85,10,75,
2837,0,85,12,73,
2838,0,87,11,76,
2839,0,88,12,76,
2840,0,87,11,76,
2841,0,86,11,75,
2842,0,84,8,76,
2843,0,80,6,74,
2844,0,82,7,75,
2845,0,83,7,76,
2846,0,82,7,75,
2847,0,83,7,76,
2848,0,82,6,76,
2849,0,82,7,75,
2850,0,82,6,76,
2851,0,82,7,75,
2852,0,83,7,76,
2853,0,81,6,75,
2854,0,83,7,76,
2855,0,83,7,76,
2856,0,82,6,76,
2857,0,83,7,76,
2858,0,69,6,63,
2859,0,58,7,51,
2860,0,53,6,47,
2861,0,52,7,45,
2862,0,45,6,39,
2863,0,36,7,29,
2864,0,29,8,21,
2865,0,24,6,18,
2866,0,26,6,20,
2867,0,40,7,33,
2868,0,40,6,34,
2869,0,40,7,33,
2870,0,41,6,35,
2871,0,40,6,34,
2872,0,43,7,36,
2873,0,42,6,36,
2874,0,44,7,37,
2875,0,42,6,36,
2876,0,46,7,39,
2877,0,44,6,38,
2878,0,45,7,38,
2879,0,46,7,39,
2880,0,45,6,39,
2881,0,47,7,40,
2882,0,49,7,42,
2883,0,46,7,39,
2884,0,49,7,42,
2885,0,50,7,43,
2886,0,49,6,43,
2887,0,48,6,42,
2888,0,50,7,43,
2889,0,49,6,43,
2890,0,51,7,44,
2891,0,51,6,45,
2892,0,51,7,44,
2893,0,52,7,45,
2894,0,52,6,46,
2895,0,52,7,45,
2896,0,53,7,46,
2897,0,52,6,46,
2898,0,55,7,48,
2899,0,54,6,48,
2900,0,54,7,47,
2901,0,54,6,48,
2902,0,54,6,48,
2903,0,57,7,50,
2904,0,54,6,48,
2905,0,57,7,50,
2906,0,55,6,49,
2907,0,56,7,49,
2908,0,57,6,51,
2909,0,57,7,50,
2910,0,57,7,50,
2911,0,59,7,52,
2912,0,58,6,52,
2913,0,61,8,53,
2914,0,59,6,53,
2915,0,58,6,52,
2916,0,60,7,53,
2917,0,59,6,53,
2918,0,60,7,53,
2919,0,60,6,54,
2920,0,60,7,53,
2921,0,62,7,55,
2922,0,61,6,55,
2923,0,61,7,54,
2924,0,63,7,56,
2925,0,62,7,55,
2926,0,63,7,56,
2927,0,63,6,57,
2928,0,63,7,56,
2929,0,63,6,57,
2930,0,62,6,56,
2931,0,66,7,59,
2932,0,64,6,58,
2933,0,65,7,58,
2934,0,63,6,57,
2935,0,67,7,60,
2936,0,65,7,58,
2937,0,65,6,59,
2938,0,65,6,59,
2939,0,67,7,60,
2940,0,68,7,61,
2941,0,66,6,60,
2942,0,68,7,61,
2943,0,66,6,60,
2944,0,68,7,61,
2945,0,68,7,61,
2946,0,68,6,62,
2947,0,68,7,61,
2948,0,68,6,62,
2949,0,67,6,61,
2950,0,71,7,64,
2951,0,69,6,63,
2952,0,68,6,62,
2953,0,70,7,63,
2954,0,69,6,63,
2955,0,70,7,63,
2956,0,70,6,64,
2957,0,69,6,63,
2958,0,72,7,65,
2959,0,71,6,65,
2960,0,70,6,64,
2961,0,72,7,65,
2962,0,71,6,65,
2963,0,74,7,67,
2964,0,72,6,66,
2965,0,72,7,65,
2966,0,74,7,67,
2967,0,72,6,66,
2968,0,75,7,68,
2969,0,73,6,67,
2970,0,77,8,69,
2971,0,73,6,67,
2972,0,74,7,67,
2973,0,74,6,68,
2974,0,73,6,67,
2975,0,76,8,68,
2976,0,76,7,69,
2977,0,75,6,69,
2978,0,74,6,68,
2979,0,77,7,70,
2980,0,76,6,70,
2981,0,76,7,69,
2982,0,76,6,70,
2983,0,75,6,69,
2984,0,78,7,71,
2985,0,76,6,70,
2986,0,79,8,71,
2987,0,77,6,71,
2988,0,76,6,70,
2989,0,80,7,73,
2990,0,78,6,72,
2991,0,78,7,71,
2992,0,78,6,72,
2993,0,78,6,72,
2994,0,80,7,73,
2995,0,79,6,73,
2996,0,78,6,72,
2997,0,80,7,73,
2998,0,79,6,73,
2999,0,80,7,73,
3000,0,80,7,73,
3001,0,80,7,73,
3002,0,81,7,74,
3003,0,80,6,74,
3004,0,83,7,76,
3005,0,81,7,74,
3006,0,81,7,74,
3007,0,81,7,74,
3008,0,84,7,77,
3009,0,82,6,76,
3010,0,82,7,75,
3011,0,82,6,76,
3012,0,81,6,75,
3013,0,84,7,77,
3014,0,82,6,76,
3015,0,82,7,75,
3016,0,82,7,75,
3017,0,83,7,76,
3018,0,79,6,73,
3019,0,67,7,60,
3020,0,54,6,48,
3021,0,52,6,46,
3022,0,50,7,43,
3023,0,40,5,35,
3024,0,34,8,26,
3025,0,25,6,19,
3026,0,25,7,18,
3027,0,31,7,24,
3028,0,39,7,32,
3029,0,40,6,34,
3030,0,39,6,33,
3031,0,43,7,36,
3032,0,42,7,35,
3033,0,41,6,35,
3034,0,43,7,36,
3035,0,43,6,37,
3036,0,44,7,37,
3037,0,44,7,37,
3038,0,44,6,38,
3039,0,44,6,38,
3040,0,47,7,40,
3041,0,45,6,39,
3042,0,47,7,40,
3043,0,46,6,40,
3044,0,47,7,40,
3045,0,48,6,42,
3046,0,48,7,41,
3047,0,51,8,43,
3048,0,48,6,42,
3049,0,51,7,44,
3050,0,50,6,44,
3051,0,49,6,43,
3052,0,52,7,45,
3053,0,51,6,45,
3054,0,52,8,44,
3055,0,52,6,46,
3056,0,51,6,45,
3057,0,53,7,46,
3058,0,53,6,47,
3059,0,53,7,46,
3060,0,55,7,48,
3061,0,53,6,47,
3062,0,54,7,47,
3063,0,55,7,48,
3064,0,55,6,49,
3065,0,55,7,48,
3066,0,58,8,50,
3067,0,55,6,49,
3068,0,57,7,50,
3069,0,57,6,51,
3070,0,57,7,50,
3071,0,57,6,51,
3072,0,57,6,51,
3073,0,59,7,52,
3074,0,57,6,51,
3075,0,59,7,52,
3076,0,58,6,52,
3077,0,60,7,53,
3078,0,60,6,54,
3079,0,60,7,53,
3080,0,60,6,54,
3081,0,59,6,53,
3082,0,62,7,55,
3083,0,61,6,55,
3084,0,62,7,55,
3085,0,61,6,55,
3086,0,63,7,56,
3087,0,62,6,56,
3088,0,63,8,55,
3089,0,63,6,57,
3090,0,64,7,57,
3091,0,62,6,56,
3092,0,65,7,58,
3093,0,65,7,58,
3094,0,63,6,57,
3095,0,66,7,59,
3096,0,65,6,59,
3097,0,65,7,58,
3098,0,65,6,59,
3099,0,65,6,59,
3100,0,67,7,60,
3101,0,66,6,60,
3102,0,66,7,59,
3103,0,67,6,61,
3104,0,67,6,61,
3105,0,67,7,60,
3106,0,67,7,60,
3107,0,68,6,62,
3108,0,68,7,61,
3109,0,69,7,62,
3110,0,68,6,62,
3111,0,69,7,62,
3112,0,69,6,63,
3113,0,69,6,63,
3114,0,70,7,63,
3115,0,71,7,64,
3116,0,69,6,63,
3117,0,71,7,64,
3118,0,71,7,64,
3119,0,71,6,65,
3120,0,71,7,64,
3121,0,73,7,66,
3122,0,71,6,65,
3123,0,71,6,65,
3124,0,73,7,66,
3125,0,71,6,65,
3126,0,72,7,65,
3127,0,74,7,67,
3128,0,75,7,68,
3129,0,72,6,66,
3130,0,74,7,67,
3131,0,74,6,68,
3132,0,74,7,67,
3133,0,74,6,68,
3134,0,73,6,67,
3135,0,75,7,68,
3136,0,76,6,70,
3137,0,76,7,69,
3138,0,75,6,69,
3139,0,75,7,68,
3140,0,76,6,70,
3141,0,76,7,69,
3142,0,76,6,70,
3143,0,75,6,69,
3144,0,77,7,70,
3145,0,79,7,72,
3146,0,77,6,71,
3147,0,76,6,70,
3148,0,78,7,71,
3149,0,81,8,73,
3150,0,78,7,71,
3151,0,78,6,72,
3152,0,79,7,72,
3153,0,77,6,71,
3154,0,81,7,74,
3155,0,79,6,73,
3156,0,78,6,72,
3157,0,80,7,73,
3158,0,78,6,72,
3159,0,81,7,74,
3160,0,80,7,73,
3161,0,80,6,74,
3162,0,79,6,73,
3163,0,82,7,75,
3164,0,81,6,75,
3165,0,81,7,74,
3166,0,82,7,75,
3167,0,82,7,75,
3168,0,81,7,74,
3169,0,83,7,76,
3170,0,81,6,75,
3171,0,84,7,77,
3172,0,82,6,76,
3173,0,81,6,75,
3174,0,83,7,76,
3175,0,82,7,75,
3176,0,82,6,76,
3177,0,82,7,75,
3178,0,83,7,76,
3179,0,76,6,70,
3180,0,66,7,59,
3181,0,53,6,47,
3182,0,52,6,46,
3183,0,49,7,42,
3184,0,40,7,33,
3185,0,31,7,24,
3186,0,25,6,19,
3187,0,25,7,18,
3188,0,33,6,27,
3189,0,39,7,32,
3190,0,40,6,34,
3191,0,40,6,34,
3192,0,42,7,35,
3193,0,41,7,34,
3194,0,42,6,36,
3195,0,42,6,36,
3196,0,44,7,37,
3197,0,45,7,38,
3198,0,45,8,37,
3199,0,45,6,39,
3200,0,47,7,40,
3201,0,46,6,40,
3202,0,46,7,39,
3203,0,48,7,41,
3204,0,46,6,40,
3205,0,49,7,42,
3206,0,48,6,42,
3207,0,49,7,42,
3208,0,48,6,42,
3209,0,51,7,44,
3210,0,49,7,42,
3211,0,50,6,44,
3212,0,49,6,43,
3213,0,51,7,44,
3214,0,51,7,44,
3215,0,52,7,45,
3216,0,52,7,45,
3217,0,53,7,46,
3218,0,55,7,48,
3219,0,53,6,47,
3220,0,52,6,46,
3221,0,55,7,48,
3222,0,54,6,48,
3223,0,56,8,48,
3224,0,54,7,47,
3225,0,41,7,34,
3226,0,46,6,40,
3227,0,49,7,42,
3228,0,50,7,43,
3229,0,54,7,47,
3230,0,59,8,51,
3231,0,56,6,50,
3232,0,57,7,50,
3233,0,58,6,52,
3234,0,57,6,51,
3235,0,59,7,52,
3236,0,59,6,53,
3237,0,59,7,52,
3238,0,60,7,53,
3239,0,59,6,53,
3240,0,62,7,55,
3241,0,60,6,54,
3242,0,61,7,54,
3243,0,61,6,55,
3244,0,60,6,54,
3245,0,63,7,56,
3246,0,62,6,56,
3247,0,61,6,55,
3248,0,62,7,55,
3249,0,63,7,56,
3250,0,63,6,57,
3251,0,62,6,56,
3252,0,64,7,57,
3253,0,63,6,57,
3254,0,65,7,58,
3255,0,63,6,57,
3256,0,66,7,59,
3257,0,65,6,59,
3258,0,65,7,58,
3259,0,65,6,59,
3260,0,66,7,59,
3261,0,65,6,59,
3262,0,67,7,60,
3263,0,66,6,60,
3264,0,66,6,60,
3265,0,68,7,61,
3266,0,67,6,61,
3267,0,67,7,60,
3268,0,68,6,62,
3269,0,67,6,61,
3270,0,69,7,62,
3271,0,68,6,62,
3272,0,69,7,62,
3273,0,68,6,62,
3274,0,71,7,64,
3275,0,69,6,63,
3276,0,71,8,63,
3277,0,71,7,64,
3278,0,70,7,63,
3279,0,71,7,64,
3280,0,71,6,65,
3281,0,71,7,64,
3282,0,71,6,65,
3283,0,71,6,65,
3284,0,72,7,65,
3285,0,72,6,66,
3286,0,71,6,65,
3287,0,73,7,66,
3288,0,74,7,67,
3289,0,73,6,67,
3290,0,73,7,66,
3291,0,75,8,67,
3292,0,74,6,68,
3293,0,74,7,67,
3294,0,75,7,68,
3295,0,73,6,67,
3296,0,75,7,68,
3297,0,75,7,68,
3298,0,75,6,69,
3299,0,75,7,68,
3300,0,76,7,69,
3301,0,76,6,70,
3302,0,78,8,70,
3303,0,75,6,69,
3304,0,76,7,69,
3305,0,77,7,70,
3306,0,78,7,71,
3307,0,77,7,70,
3308,0,77,6,71,
3309,0,78,7,71,
3310,0,78,6,72,
3311,0,77,6,71,
3312,0,79,7,72,
3313,0,77,6,71,
3314,0,78,7,71,
3315,0,79,7,72,
3316,0,80,8,72,
3317,0,80,7,73,
3318,0,78,6,72,
3319,0,81,7,74,
3320,0,80,6,74,
3321,0,79,6,73,
3322,0,82,7,75,
3323,0,80,6,74,
3324,0,80,7,73,
3325,0,82,7,75,
3326,0,80,6,74,
3327,0,82,7,75,
3328,0,81,7,74,
3329,0,81,6,75,
3330,0,81,6,75,
3331,0,84,8,76,
3332,0,83,7,76,
3333,0,82,6,76,
3334,0,83,8,75,
3335,0,82,7,75,
3336,0,81,6,75,
3337,0,83,7,76,
3338,0,82,6,76,
3339,0,83,7,76,
3340,0,80,6,74,
3341,0,68,7,61,
3342,0,56,6,50,
3343,0,53,7,46,
3344,0,51,7,44,
3345,0,42,6,36,
3346,0,33,6,27,
3347,0,28,7,21,
3348,0,24,6,18,
3349,0,30,7,23,
3350,0,38,6,32,
3351,0,41,7,34,
3352,0,40,6,34,
3353,0,41,7,34,
3354,0,41,7,34,
3355,0,42,6,36,
3356,0,41,6,35,
3357,0,44,7,37,
3358,0,45,8,37,
3359,0,43,6,37,
3360,0,45,7,38,
3361,0,45,6,39,
3362,0,45,7,38,
3363,0,46,7,39,
3364,0,46,6,40,
3365,0,46,6,40,
3366,0,48,7,41,
3367,0,50,7,43,
3368,0,48,6,42,
3369,0,50,7,43,
3370,0,48,6,42,
3371,0,50,7,43,
3372,0,49,6,43,
3373,0,50,7,43,
3374,0,51,6,45,
3375,0,50,6,44,
3376,0,53,7,46,
3377,0,52,6,46,
3378,0,52,7,45,
3379,0,52,7,45,
3380,0,54,7,47,
3381,0,53,6,47,
3382,0,54,7,47,
3383,0,55,7,48,
3384,0,53,6,47,
3385,0,57,7,50,
3386,0,55,6,49,
3387,0,55,7,48,
3388,0,56,7,49,
3389,0,57,7,50,
3390,0,55,6,49,
3391,0,57,7,50,
3392,0,57,6,51,
3393,0,56,6,50,
3394,0,60,8,52,
3395,0,58,6,52,
3396,0,61,8,53,
3397,0,59,6,53,
3398,0,59,7,52,
3399,0,59,7,52,
3400,0,59,6,53,
3401,0,61,7,54,
3402,0,60,6,54,
3403,0,59,6,53,
3404,0,62,7,55,
3405,0,60,6,54,
3406,0,61,7,54,
3407,0,62,6,56,
3408,0,62,7,55,
3409,0,63,7,56,
3410,0,64,7,57,
3411,0,63,6,57,
3412,0,62,6,56,
3413,0,64,7,57,
3414,0,63,6,57,
3415,0,64,7,57,
3416,0,64,6,58,
3417,0,63,6,57,
3418,0,65,7,58,
3419,0,65,7,58,
3420,0,67,7,60,
3421,0,66,6,60,
3422,0,65,6,59,
3423,0,68,7,61,
3424,0,66,6,60,
3425,0,67,7,60,
3426,0,68,7,61,
3427,0,66,6,60,
3428,0,68,7,61,
3429,0,68,6,62,
3430,0,67,6,61,
3431,0,69,7,62,
3432,0,68,6,62,
3433,0,69,7,62,
3434,0,69,6,63,
3435,0,68,6,62,
3436,0,70,7,63,
3437,0,69,6,63,
3438,0,70,7,63,
3439,0,70,6,64,
3440,0,70,7,63,
3441,0,72,7,65,
3442,0,74,7,67,
3443,0,71,7,64,
3444,0,70,6,64,
3445,0,73,7,66,
3446,0,71,6,65,
3447,0,74,7,67,
3448,0,72,6,66,
3449,0,72,6,66,
3450,0,75,7,68,
3451,0,73,6,67,
3452,0,75,9,66,
3453,0,73,7,66,
3454,0,74,6,68,
3455,0,73,6,67,
3456,0,75,7,68,
3457,0,73,6,67,
3458,0,76,7,69,
3459,0,74,6,68,
3460,0,77,7,70,
3461,0,75,6,69,
3462,0,76,7,69,
3463,0,76,6,70,
3464,0,75,6,69,
3465,0,78,7,71,
3466,0,76,6,70,
3467,0,76,6,70,
3468,0,78,7,71,
3469,0,77,6,71,
3470,0,78,8,70,
3471,0,77,6,71,
3472,0,77,6,71,
3473,0,79,7,72,
3474,0,78,6,72,
3475,0,77,6,71,
3476,0,80,7,73,
3477,0,78,6,72,
3478,0,82,9,73,
3479,0,79,7,72,
3480,0,79,6,73,
3481,0,81,7,74,
3482,0,79,6,73,
3483,0,82,7,75,
3484,0,79,6,73,
3485,0,80,7,73,
3486,0,81,6,75,
3487,0,81,7,74,
3488,0,82,7,75,
3489,0,80,6,74,
3490,0,83,7,76,
3491,0,82,6,76,
3492,0,81,6,75,
3493,0,83,7,76,
3494,0,82,6,76,
3495,0,82,7,75,
3496,0,82,6,76,
3497,0,81,6,75,
3498,0,83,7,76,
3499,0,81,6,75,
3500,0,83,7,76,
3501,0,79,7,72,
3502,0,67,7,60,
3503,0,53,6,47,
3504,0,54,7,47,
3505,0,48,6,42,
3506,0,42,6,36,
3507,0,33,7,26,
3508,0,27,7,20,
3509,0,26,7,19,
3510,0,32,6,26,
3511,0,39,7,32,
3512,0,40,6,34,
3513,0,39,6,33,
3514,0,42,7,35,
3515,0,42,6,36,
3516,0,43,7,36,
3517,0,44,7,37,
3518,0,43,6,37,
3519,0,43,6,37,
3520,0,45,7,38,
3521,0,44,6,38,
3522,0,45,7,38,
3523,0,46,6,40,
3524,0,46,7,39,
3525,0,48,7,41,
3526,0,46,6,40,
3527,0,49,7,42,
3528,0,48,6,42,
3529,0,47,6,41,
3530,0,50,7,43,
3531,0,49,6,43,
3532,0,49,7,42,
3533,0,50,6,44,
3534,0,49,6,43,
3535,0,52,7,45,
3536,0,51,6,45,
3537,0,51,7,44,
3538,0,53,7,46,
3539,0,53,7,46,
3540,0,52,6,46,
3541,0,53,7,46,
3542,0,53,6,47,
3543,0,54,7,47,
3544,0,55,7,48,
3545,0,56,7,49,
3546,0,55,7,48,
3547,0,55,6,49,
3548,0,54,6,48,
3549,0,58,8,50,
3550,0,55,6,49,
3551,0,57,7,50,
3552,0,57,7,50,
3553,0,57,6,51,
3554,0,57,6,51,
3555,0,58,7,51,
3556,0,58,6,52,
3557,0,57,6,51,
3558,0,60,7,53,
3559,0,59,6,53,
3560,0,59,7,52,
3561,0,60,6,54,
3562,0,61,7,54,
3563,0,60,6,54,
3564,0,62,7,55,
3565,0,61,7,54,
3566,0,60,6,54,
3567,0,62,7,55,
3568,0,61,6,55,
3569,0,64,9,55,
3570,0,62,6,56,
3571,0,62,6,56,
3572,0,64,7,57,
3573,0,64,7,57,
3574,0,63,7,56,
3575,0,64,6,58,
3576,0,63,6,57,
3577,0,65,7,58,
3578,0,66,7,59,
3579,0,66,7,59,
3580,0,65,6,59,
3581,0,67,8,59,
3582,0,66,7,59,
3583,0,66,6,60,
3584,0,66,7,59,
3585,0,67,7,60,
3586,0,66,6,60,
3587,0,69,7,62,
3588,0,67,6,61,
3589,0,66,6,60,
3590,0,69,7,62,
3591,0,68,6,62,
3592,0,68,7,61,
3593,0,69,6,63,
3594,0,68,6,62,
3595,0,70,7,63,
3596,0,68,6,62,
3597,0,71,7,64,
3598,0,69,6,63,
3599,0,70,7,63,
3600,0,71,7,64,
3601,0,70,7,63,
3602,0,71,6,65,
3603,0,70,6,64,
3604,0,72,7,65,
3605,0,70,6,64,
3606,0,73,8,65,
3607,0,69,5,64,
3608,0,50,,50,
3609,0,26,,26,
3610,0,2,,2,
3611,0,16,2,14,
3612,0,40,7,33,
3613,0,58,7,51,
3614,0,74,6,68,
3615,0,74,7,67,
3616,0,74,6,68,
3617,0,73,6,67,
3618,0,76,7,69,
3619,0,75,6,69,
3620,0,74,6,68,
3621,0,75,7,68,
3622,0,76,7,69,
3623,0,76,7,69,
3624,0,76,6,70,
3625,0,75,6,69,
3626,0,77,7,70,
3627,0,77,7,70,
3628,0,77,6,71,
3629,0,77,7,70,
3630,0,78,7,71,
3631,0,76,6,70,
3632,0,79,7,72,
3633,0,78,6,72,
3634,0,78,7,71,
3635,0,78,6,72,
3636,0,62,1,61,
3637,0,40,,40,
3638,0,16,,16,
