window-id,queue-size-CL,queue-size-LL,10.0.0.13:55150 -> 10.0.1.13:3000,10.0.1.13:3000 -> 10.0.0.13:55150,10.0.0.13:34039 -> 10.0.1.13:1000
0,0,29,7,22,
1,0,40,9,31,
2,0,41,6,35,
3,0,36,6,30,
4,0,31,6,25,
5,0,29,6,23,
6,0,28,7,21,
7,0,24,5,19,
8,0,23,6,17,
9,0,22,7,15,
10,0,19,6,13,
11,0,16,4,12,
12,0,13,3,10,
13,0,17,4,13,
14,0,17,4,13,
15,0,15,3,12,
16,0,18,5,13,
17,0,16,3,13,
18,0,17,4,13,
19,0,14,4,10,
20,0,16,3,13,
21,0,14,3,11,
22,0,14,3,11,
23,0,18,5,13,
24,0,17,3,14,
25,0,18,4,14,
26,0,17,4,13,
27,0,16,3,13,
28,0,16,3,13,
29,0,19,4,15,
30,0,18,3,15,
31,0,14,3,11,
32,0,18,4,14,
33,0,17,3,14,
34,0,16,3,13,
35,0,18,4,14,
36,0,15,3,12,
37,0,15,4,11,
38,0,14,3,11,
39,0,16,4,12,
40,0,19,5,14,
41,0,18,3,15,
42,0,17,3,14,
43,0,16,4,12,
44,0,16,3,13,
45,0,16,3,13,
46,0,18,4,14,
47,0,18,4,14,
48,0,17,3,14,
49,0,18,4,14,
50,0,16,3,13,
51,0,14,3,11,
52,0,17,4,13,
53,0,16,3,13,
54,0,19,4,15,
55,0,19,4,15,
56,0,18,3,15,
57,0,19,3,16,
58,0,15,4,11,
59,0,16,3,13,
60,0,15,3,12,
61,0,15,4,11,
62,0,16,4,12,
63,0,17,4,13,
64,0,19,4,15,
65,0,18,3,15,
66,0,19,3,16,
67,0,16,4,12,
68,0,15,3,12,
69,0,20,5,15,
70,0,17,3,14,
71,0,15,4,11,
72,0,18,4,14,
73,0,16,3,13,
74,0,17,3,14,
75,0,18,4,14,
76,0,15,3,12,
77,0,17,4,13,
78,0,17,4,13,
79,0,17,4,13,
80,0,19,4,15,
81,0,14,3,11,
82,0,17,4,13,
83,0,16,3,13,
84,0,16,3,13,
85,0,16,4,12,
86,0,15,3,12,
87,0,18,4,14,
88,0,15,3,12,
89,0,14,3,11,
90,0,16,4,12,
91,0,15,3,12,
92,0,15,3,12,
93,0,19,4,15,
94,0,18,3,15,
95,0,19,4,15,
96,0,19,3,16,
97,0,14,3,11,
98,0,17,4,13,
99,0,16,3,13,
100,0,18,4,14,
101,0,17,5,12,
102,0,15,3,12,
103,0,19,4,15,
104,0,17,4,13,
105,0,18,3,15,
106,0,15,3,12,
107,0,16,4,12,
108,0,15,3,12,
109,0,20,5,15,
110,0,15,3,12,
111,0,16,3,13,
112,0,17,4,13,
113,0,17,3,14,
114,0,17,3,14,
115,0,18,4,14,
116,0,16,3,13,
117,0,17,3,14,
118,0,17,3,14,
119,0,20,5,15,
120,0,15,3,12,
121,0,15,3,12,
122,0,16,4,12,
123,0,14,3,11,
124,0,18,4,14,
125,0,20,5,15,
126,0,18,3,15,
127,0,18,3,15,
128,0,16,4,12,
129,0,15,3,12,
130,0,17,4,13,
131,0,20,5,15,
132,0,17,3,14,
133,0,16,4,12,
134,0,16,4,12,
135,0,15,3,12,
136,0,16,4,12,
137,0,15,4,11,
138,0,15,3,12,
139,0,19,4,15,
140,0,18,4,14,
141,0,16,3,13,
142,0,17,4,13,
143,0,16,3,13,
144,0,16,3,13,
145,0,17,4,13,
146,0,17,3,14,
147,0,18,5,13,
148,0,14,3,11,
149,0,17,4,13,
150,0,17,3,14,
151,0,16,3,13,
152,0,17,4,13,
153,0,16,4,12,
154,0,15,3,12,
155,0,19,4,15,
156,0,15,3,12,
157,0,15,3,12,
158,0,17,4,13,
159,0,16,3,13,
160,0,17,4,13,
161,0,16,3,13,
162,0,15,4,11,
163,0,15,3,12,
164,0,16,4,12,
165,0,17,4,13,
166,0,19,4,15,
167,0,17,3,14,
168,0,15,3,12,
169,0,16,4,12,
170,0,17,3,14,
171,0,15,3,12,
172,0,14,3,11,
173,0,15,4,11,
174,0,15,3,12,
175,0,15,3,12,
176,0,19,4,15,
177,0,18,3,15,
178,0,14,3,11,
179,0,18,4,14,
180,0,16,3,13,
181,0,17,3,14,
182,0,18,5,13,
183,0,15,3,12,
184,0,15,3,12,
185,0,16,4,12,
186,0,18,4,14,
187,0,17,3,14,
188,0,14,3,11,
189,0,18,5,13,
190,0,17,3,14,
191,0,16,3,13,
192,0,20,6,14,
193,0,15,3,12,
194,0,15,3,12,
195,0,19,5,14,
196,0,20,6,14,
197,0,18,3,15,
198,0,17,6,11,
199,0,19,5,14,
200,0,20,5,15,
201,0,19,6,13,
202,0,15,4,11,
203,0,16,3,13,
204,0,19,4,15,
205,0,16,4,12,
206,0,17,4,13,
207,0,18,5,13,
208,0,17,3,14,
209,0,17,4,13,
210,0,16,4,12,
211,0,18,5,13,
212,0,17,3,14,
213,0,14,3,11,
214,0,16,4,12,
215,0,16,4,12,
216,0,17,3,14,
217,0,18,4,14,
218,0,15,4,11,
219,0,15,3,12,
220,0,19,4,15,
221,0,15,3,12,
222,0,13,3,10,
223,0,3,,3,
224,0,15,4,11,
225,0,17,4,13,
226,0,18,4,14,
227,0,19,5,14,
228,0,16,4,12,
229,0,18,4,14,
230,0,17,3,14,
231,0,16,3,13,
232,0,19,5,14,
233,0,15,3,12,
234,0,15,3,12,
235,0,14,3,11,
236,0,16,4,12,
237,0,16,3,13,
238,0,16,3,13,
239,0,19,4,15,
240,0,18,3,15,
241,0,14,3,11,
242,0,17,4,13,
243,0,17,4,13,
244,0,17,4,13,
245,0,17,4,13,
246,0,15,3,12,
247,0,16,4,12,
248,0,16,4,12,
249,0,18,5,13,
250,0,18,4,14,
251,0,15,3,12,
252,0,17,4,13,
253,0,18,4,14,
254,0,16,3,13,
255,0,17,4,13,
256,0,15,3,12,
257,0,15,3,12,
258,0,17,4,13,
259,0,18,4,14,
260,0,17,3,14,
261,0,16,3,13,
262,0,18,4,14,
263,0,16,4,12,
264,0,14,3,11,
265,0,16,4,12,
266,0,15,3,12,
267,0,15,3,12,
268,0,17,4,13,
269,0,18,4,14,
270,0,17,4,13,
271,0,14,3,11,
272,0,17,4,13,
273,0,17,3,14,
274,0,18,4,14,
275,0,15,3,12,
276,0,16,4,12,
277,0,14,3,11,
278,0,15,3,12,
279,0,15,3,12,
280,0,18,4,14,
281,0,15,3,12,
282,0,14,3,11,
283,0,20,6,14,
284,0,17,3,14,
285,0,17,3,14,
286,0,16,4,12,
287,0,17,4,13,
288,0,16,3,13,
289,0,18,4,14,
290,0,16,3,13,
291,0,19,5,14,
292,0,15,3,12,
293,0,17,4,13,
294,0,17,3,14,
295,0,14,3,11,
296,0,17,4,13,
297,0,16,3,13,
298,0,16,3,13,
299,0,19,4,15,
300,0,17,3,14,
301,0,15,3,12,
302,0,15,3,12,
303,0,17,4,13,
304,0,17,4,13,
305,0,16,3,13,
306,0,16,4,12,
307,0,16,3,13,
308,0,15,3,12,
309,0,17,4,13,
310,0,17,4,13,
311,0,15,3,12,
312,0,15,3,12,
313,0,16,5,11,
314,0,15,3,12,
315,0,13,3,10,
316,0,17,4,13,
317,0,16,3,13,
318,0,16,3,13,
319,0,19,4,15,
320,0,15,3,12,
321,0,15,3,12,
322,0,15,4,11,
323,0,15,3,12,
324,0,15,3,12,
325,0,16,3,13,
326,0,18,4,14,
327,0,18,3,15,
328,0,14,3,11,
329,0,17,4,13,
330,0,17,3,14,
331,0,16,3,13,
332,0,19,4,15,
333,0,15,3,12,
334,0,17,4,13,
335,0,17,3,14,
336,0,16,3,13,
337,0,18,4,14,
338,0,15,3,12,
339,0,17,4,13,
340,0,19,4,15,
341,0,17,3,14,
342,0,16,3,13,
343,0,16,4,12,
344,0,17,4,13,
345,0,13,3,10,
346,0,15,4,11,
347,0,18,4,14,
348,0,17,3,14,
349,0,18,4,14,
350,0,17,4,13,
351,0,15,3,12,
352,0,15,3,12,
353,0,19,4,15,
354,0,17,3,14,
355,0,20,5,15,
356,0,18,4,14,
357,0,16,3,13,
358,0,16,3,13,
359,0,17,4,13,
360,0,15,3,12,
361,0,15,3,12,
362,0,16,3,13,
363,0,18,4,14,
364,0,17,3,14,
365,0,18,5,13,
366,0,16,4,12,
367,0,18,5,13,
368,0,16,3,13,
369,0,16,4,12,
370,0,15,3,12,
371,0,16,4,12,
372,0,19,4,15,
373,0,17,3,14,
374,0,20,5,15,
375,0,17,4,13,
376,0,16,3,13,
377,0,16,3,13,
378,0,17,4,13,
379,0,14,3,11,
380,0,16,3,13,
381,0,13,3,10,
382,0,15,4,11,
383,0,16,4,12,
384,0,17,3,14,
385,0,18,3,15,
386,0,14,3,11,
387,0,17,4,13,
388,0,17,3,14,
389,0,16,3,13,
390,0,20,4,16,
391,0,15,3,12,
392,0,15,3,12,
393,0,19,4,15,
394,0,17,3,14,
395,0,16,4,12,
396,0,16,4,12,
397,0,17,3,14,
398,0,13,3,10,
399,0,14,3,11,
400,0,16,4,12,
401,0,15,3,12,
402,0,15,3,12,
403,0,19,4,15,
404,0,17,3,14,
405,0,17,3,14,
406,0,17,4,13,
407,0,17,4,13,
408,0,16,3,13,
409,0,19,4,15,
410,0,17,3,14,
411,0,16,4,12,
412,0,16,3,13,
413,0,15,3,12,
414,0,19,4,15,
415,0,14,3,11,
416,0,14,3,11,
417,0,19,4,15,
418,0,17,3,14,
419,0,17,3,14,
420,0,18,4,14,
421,0,16,3,13,
422,0,16,3,13,
423,0,16,3,13,
424,0,16,4,12,
425,0,15,4,11,
426,0,19,5,14,
427,0,17,3,14,
428,0,16,3,13,
429,0,20,4,16,
430,0,15,3,12,
431,0,15,3,12,
432,0,20,5,15,
433,0,17,3,14,
434,0,19,4,15,
435,0,16,4,12,
436,0,16,3,13,
437,0,16,3,13,
438,0,16,3,13,
439,0,16,4,12,
440,0,16,3,13,
441,0,13,3,10,
442,0,17,4,13,
443,0,16,3,13,
444,0,16,3,13,
445,0,18,4,14,
446,0,15,3,12,
447,0,16,3,13,
448,0,17,4,13,
449,0,17,3,14,
450,0,18,3,15,
451,0,15,4,11,
452,0,17,4,13,
453,0,17,3,14,
454,0,16,3,13,
455,0,16,4,12,
456,0,15,3,12,
457,0,18,4,14,
458,0,14,3,11,
459,0,18,5,13,
460,0,13,3,10,
461,0,16,4,12,
462,0,15,3,12,
463,0,19,4,15,
464,0,17,3,14,
465,0,19,5,14,
466,0,19,4,15,
467,0,16,3,13,
468,0,17,5,12,
469,0,19,4,15,
470,0,15,3,12,
471,0,17,5,12,
472,0,16,4,12,
473,0,16,4,12,
474,0,16,3,13,
475,0,16,3,13,
476,0,18,4,14,
477,0,18,5,13,
478,0,15,3,12,
479,0,15,3,12,
480,0,19,4,15,
481,0,18,3,15,
482,0,14,3,11,
483,0,18,4,14,
484,0,16,3,13,
485,0,18,4,14,
486,0,19,4,15,
487,0,15,3,12,
488,0,15,3,12,
489,0,18,4,14,
490,0,17,3,14,
491,0,17,4,13,
492,0,18,5,13,
493,0,15,3,12,
494,0,19,4,15,
495,0,18,4,14,
496,0,19,4,15,
497,0,17,3,14,
498,0,16,3,13,
499,0,15,3,12,
500,0,17,4,13,
501,0,16,3,13,
502,0,18,4,14,
503,0,17,3,14,
504,0,17,3,14,
505,0,17,4,13,
506,0,17,4,13,
507,0,14,3,11,
508,0,15,4,11,
509,0,17,4,13,
510,0,17,3,14,
511,0,16,3,13,
512,0,17,4,13,
513,0,17,3,14,
514,0,16,3,13,
515,0,16,3,13,
516,0,16,4,12,
517,0,16,4,12,
518,0,15,3,12,
519,0,18,5,13,
520,0,16,3,13,
521,0,16,3,13,
522,0,20,5,15,
523,0,20,5,15,
524,0,18,3,15,
525,0,15,4,11,
526,0,17,4,13,
527,0,19,4,15,
528,0,17,3,14,
529,0,18,4,14,
530,0,15,4,11,
531,0,16,3,13,
532,0,19,4,15,
533,0,15,3,12,
534,0,14,3,11,
535,0,18,4,14,
536,0,17,3,14,
537,0,17,3,14,
538,0,18,5,13,
539,0,16,3,13,
540,0,17,3,14,
541,0,16,3,13,
542,0,17,4,13,
543,0,17,3,14,
544,0,16,3,13,
545,0,15,3,12,
546,0,17,4,13,
547,0,18,4,14,
548,0,17,3,14,
549,0,15,4,11,
550,0,14,3,11,
551,0,17,4,13,
552,0,18,4,14,
553,0,18,5,13,
554,0,15,3,12,
555,0,17,4,13,
556,0,19,5,14,
557,0,17,3,14,
558,0,17,3,14,
559,0,16,4,12,
560,0,16,3,13,
561,0,16,3,13,
562,0,18,4,14,
563,0,17,4,13,
564,0,14,3,11,
565,0,18,4,14,
566,0,17,3,14,
567,0,16,3,13,
568,0,19,4,15,
569,0,17,4,13,
570,0,16,3,13,
571,0,17,3,14,
572,0,17,4,13,
573,0,15,3,12,
574,0,16,3,13,
575,0,16,3,13,
576,0,18,4,14,
577,0,19,4,15,
578,0,16,3,13,
579,0,15,3,12,
580,0,16,3,13,
581,0,18,5,13,
582,0,17,3,14,
583,0,16,5,11,
584,0,16,4,12,
585,0,14,4,10,
586,0,16,4,12,
587,0,17,4,13,
588,0,17,3,14,
589,0,16,3,13,
590,0,19,4,15,
591,0,15,3,12,
592,0,16,4,12,
593,0,16,4,12,
594,0,15,3,12,
595,0,16,3,13,
596,0,17,4,13,
597,0,17,3,14,
598,0,17,3,14,
599,0,14,3,11,
600,0,17,4,13,
601,0,15,3,12,
602,0,14,3,11,
603,0,18,4,14,
604,0,17,3,14,
605,0,17,3,14,
606,0,16,4,12,
607,0,16,4,12,
608,0,18,4,14,
609,0,17,4,13,
610,0,15,3,12,
611,0,15,3,12,
612,0,15,3,12,
613,0,18,5,13,
614,0,18,4,14,
615,0,17,5,12,
616,0,19,5,14,
617,0,16,3,13,
618,0,16,3,13,
619,0,19,4,15,
620,0,15,3,12,
621,0,15,3,12,
622,0,18,4,14,
623,0,14,3,11,
624,0,15,3,12,
625,0,16,4,12,
626,0,15,3,12,
627,0,15,3,12,
628,0,19,4,15,
629,0,17,3,14,
630,0,16,3,13,
631,0,17,4,13,
632,0,16,3,13,
633,0,16,3,13,
634,0,18,4,14,
635,0,17,3,14,
636,0,15,3,12,
637,0,16,4,12,
638,0,15,3,12,
639,0,19,4,15,
640,0,17,3,14,
641,0,14,3,11,
642,0,15,4,11,
643,0,17,5,12,
644,0,18,4,14,
645,0,17,3,14,
646,0,17,5,12,
647,0,17,4,13,
648,0,15,3,12,
649,0,18,4,14,
650,0,19,4,15,
651,0,14,3,11,
652,0,18,4,14,
653,0,17,4,13,
654,0,17,4,13,
655,0,14,4,10,
656,0,16,3,13,
657,0,17,3,14,
658,0,16,3,13,
659,0,18,4,14,
660,0,17,3,14,
661,0,14,3,11,
662,0,18,4,14,
663,0,17,3,14,
664,0,16,3,13,
665,0,17,4,13,
666,0,15,3,12,
667,0,17,4,13,
668,0,19,4,15,
669,0,17,3,14,
670,0,15,3,12,
671,0,16,4,12,
672,0,17,3,14,
673,0,16,3,13,
674,0,16,4,12,
675,0,15,3,12,
676,0,15,4,11,
677,0,18,4,14,
678,0,17,4,13,
679,0,16,3,13,
680,0,18,4,14,
681,0,16,3,13,
682,0,14,3,11,
683,0,18,4,14,
684,0,17,3,14,
685,0,16,3,13,
686,0,17,4,13,
687,0,15,3,12,
688,0,16,4,12,
689,0,18,4,14,
690,0,17,3,14,
691,0,14,3,11,
692,0,16,4,12,
693,0,15,4,11,
694,0,15,3,12,
695,0,15,3,12,
696,0,18,4,14,
697,0,17,3,14,
698,0,17,4,13,
699,0,16,3,13,
700,0,16,4,12,
701,0,15,3,12,
702,0,15,3,12,
703,0,19,4,15,
704,0,17,3,14,
705,0,17,4,13,
706,0,17,4,13,
707,0,17,4,13,
708,0,18,4,14,
709,0,16,3,13,
710,0,17,4,13,
711,0,15,3,12,
712,0,15,3,12,
713,0,17,4,13,
714,0,16,3,13,
715,0,17,4,13,
716,0,16,3,13,
717,0,16,3,13,
718,0,19,4,15,
719,0,17,3,14,
720,0,17,3,14,
721,0,16,4,12,
722,0,17,4,13,
723,0,17,3,14,
724,0,16,3,13,
725,0,16,4,12,
726,0,16,3,13,
727,0,16,3,13,
728,0,18,4,14,
729,0,17,4,13,
730,0,17,5,12,
731,0,16,3,13,
732,0,15,3,12,
733,0,19,4,15,
734,0,19,5,14,
735,0,15,3,12,
736,0,18,4,14,
737,0,17,4,13,
738,0,18,5,13,
739,0,19,4,15,
740,0,18,4,14,
741,0,14,3,11,
742,0,18,4,14,
743,0,16,3,13,
744,0,16,4,12,
745,0,15,4,11,
746,0,16,3,13,
747,0,17,3,14,
748,0,16,3,13,
749,0,18,4,14,
750,0,15,3,12,
751,0,17,4,13,
752,0,16,3,13,
753,0,16,3,13,
754,0,15,4,11,
755,0,16,3,13,
756,0,15,3,12,
757,0,19,4,15,
758,0,17,3,14,
759,0,14,3,11,
760,0,18,4,14,
761,0,14,3,11,
762,0,14,3,11,
763,0,16,4,12,
764,0,19,5,14,
765,0,16,3,13,
766,0,14,3,11,
767,0,16,4,12,
768,0,16,4,12,
769,0,15,3,12,
770,0,15,3,12,
771,0,18,4,14,
772,0,16,3,13,
773,0,19,4,15,
774,0,16,4,12,
775,0,16,3,13,
776,0,16,3,13,
777,0,17,3,14,
778,0,18,4,14,
779,0,15,3,12,
780,0,16,3,13,
781,0,15,3,12,
782,0,18,4,14,
783,0,18,3,15,
784,0,15,3,12,
785,0,17,4,13,
786,0,16,3,13,
787,0,16,3,13,
788,0,15,4,11,
789,0,15,3,12,
790,0,16,4,12,
791,0,15,3,12,
792,0,15,3,12,
793,0,19,4,15,
794,0,18,3,15,
795,0,15,4,11,
796,0,19,5,14,
797,0,17,3,14,
798,0,18,3,15,
799,0,17,3,14,
800,0,15,4,11,
801,0,16,3,13,
802,0,17,3,14,
803,0,16,3,13,
804,0,20,5,15,
805,0,16,3,13,
806,0,14,3,11,
807,0,19,4,15,
808,0,17,3,14,
809,0,14,3,11,
810,0,18,4,14,
811,0,14,3,11,
812,0,14,3,11,
813,0,19,4,15,
814,0,17,3,14,
815,0,15,3,12,
816,0,17,4,13,
817,0,16,3,13,
818,0,17,3,14,
819,0,18,4,14,
820,0,17,3,14,
821,0,15,4,11,
822,0,16,3,13,
823,0,16,3,13,
824,0,17,4,13,
825,0,15,4,11,
826,0,18,4,14,
827,0,14,3,11,
828,0,16,5,11,
829,0,20,6,14,
830,0,21,7,14,
831,0,21,6,15,
832,0,22,7,15,
833,0,20,7,13,
834,0,20,6,14,
835,0,19,6,13,
836,0,18,7,11,
837,0,20,7,13,
838,0,19,6,13,
839,0,21,7,14,
840,0,22,8,14,
841,0,21,6,15,
842,0,21,7,14,
843,0,19,6,13,
844,0,20,7,13,
845,0,20,7,13,
846,0,17,5,12,
847,0,20,7,13,
848,0,19,6,13,
849,0,21,7,14,
850,0,20,7,13,
851,0,19,6,13,
852,0,19,6,13,
853,0,19,7,12,
854,0,17,5,12,
855,0,20,7,13,
856,0,20,6,14,
857,0,22,7,15,
858,0,20,7,13,
859,0,17,5,12,
860,0,20,7,13,
861,0,21,7,14,
862,0,21,6,15,
863,0,19,7,12,
864,0,19,6,13,
865,0,19,6,13,
866,0,21,7,14,
867,0,19,7,12,
868,0,18,5,13,
869,0,20,7,13,
870,0,20,6,14,
871,0,22,7,15,
872,0,21,7,14,
873,0,20,6,14,
874,0,19,6,13,
875,0,21,7,14,
876,0,22,7,15,
877,0,18,6,12,
878,0,20,7,13,
879,0,20,6,14,
880,0,21,7,14,
881,0,18,7,11,
882,0,19,6,13,
883,0,18,7,11,
884,0,18,6,12,
885,0,20,7,13,
886,0,21,7,14,
887,0,20,6,14,
888,0,22,7,15,
889,0,22,7,15,
890,0,20,6,14,
891,0,19,6,13,
892,0,19,6,13,
893,0,18,6,12,
894,0,21,7,14,
895,0,21,7,14,
896,0,20,6,14,
897,0,20,7,13,
898,0,19,6,13,
899,0,21,7,14,
900,0,18,6,12,
901,0,19,6,13,
902,0,21,8,13,
903,0,21,7,14,
904,0,19,5,14,
905,0,19,5,14,
906,0,19,7,12,
907,0,19,6,13,
908,0,21,7,14,
909,0,20,7,13,
910,0,18,5,12,1
911,0,17,5,12,
912,0,18,4,14,
913,0,17,3,14,
914,0,16,3,13,
915,0,17,4,13,
916,0,15,3,12,
917,0,18,4,14,
918,0,20,4,15,1
919,0,19,4,15,
920,0,20,4,16,
921,0,15,4,11,
922,0,16,3,13,
923,0,17,3,14,
924,0,13,3,10,
925,0,18,5,13,
926,0,20,4,15,1
927,0,15,3,12,
928,0,15,3,12,
929,0,17,4,13,
930,0,17,3,14,
931,0,17,3,14,
932,0,17,4,13,
933,0,15,3,12,
934,0,16,3,13,
935,0,16,3,13,
936,0,18,4,14,
937,0,17,3,14,
938,0,14,3,11,
939,0,18,4,14,
940,0,17,3,14,
941,0,17,3,13,1
942,0,17,4,13,
943,0,16,3,13,
944,0,15,4,11,
945,0,17,5,12,
946,0,18,4,14,
947,0,17,3,14,
948,0,17,3,14,
949,0,16,4,12,
950,0,16,4,12,
951,0,19,4,15,
952,0,17,3,14,
953,0,16,4,12,
954,0,16,4,12,
955,0,17,4,13,
956,0,19,5,13,1
957,0,16,3,13,
958,0,16,3,13,
959,0,19,4,15,
960,0,15,3,12,
961,0,16,3,13,
962,0,16,4,12,
963,0,17,3,14,
964,0,17,3,14,
965,0,15,4,11,
966,0,16,4,12,
967,0,16,3,13,
968,0,16,3,13,
969,0,18,4,14,
970,0,15,4,11,
971,0,15,4,11,
972,0,18,4,14,
973,0,17,3,14,
974,0,17,3,14,
975,0,17,4,13,
976,0,16,3,13,
977,0,18,4,14,
978,0,17,4,13,
979,0,17,3,14,
980,0,18,4,14,
981,0,14,3,11,
982,0,17,4,13,
983,0,17,3,14,
984,0,14,3,11,
985,0,18,4,14,
986,0,17,4,13,
987,0,14,3,10,1
988,0,18,4,14,
989,0,17,3,14,
990,0,16,3,13,
991,0,18,4,14,
992,0,17,3,14,
993,0,15,4,11,
994,0,15,3,12,
995,0,18,4,14,
996,0,17,3,14,
997,0,16,3,13,
998,0,17,4,13,
999,0,16,3,13,
1000,0,15,3,12,
1001,0,19,4,15,
1002,0,15,3,12,
1003,0,14,3,11,
1004,0,16,4,12,
1005,0,15,3,12,
1006,0,17,4,13,
1007,0,17,3,14,
1008,0,18,4,14,
1009,0,17,3,14,
1010,0,18,4,14,
1011,0,15,4,11,
1012,0,16,4,12,
1013,0,18,4,14,
1014,0,18,3,15,
1015,0,19,4,15,
1016,0,15,4,11,
1017,0,18,4,13,1
1018,0,17,4,13,
1019,0,16,4,12,
1020,0,15,3,12,
1021,0,15,3,12,
1022,0,19,4,15,
1023,0,17,3,14,
1024,0,16,3,13,
1025,0,15,4,11,
1026,0,16,3,13,
1027,0,16,3,13,
1028,0,17,4,13,
1029,0,17,3,14,
1030,0,16,4,12,
1031,0,16,3,13,
1032,0,17,4,13,
1033,0,16,3,13,
1034,0,16,3,13,
1035,0,16,3,13,
1036,0,18,4,14,
1037,0,18,4,14,
1038,0,18,4,14,
1039,0,18,4,14,
1040,0,16,4,12,
1041,0,18,4,14,
1042,0,15,3,12,
1043,0,15,4,11,
1044,0,15,4,11,
1045,0,15,3,12,
1046,0,15,3,12,
1047,0,18,4,13,1
1048,0,16,3,13,
1049,0,18,4,14,
1050,0,17,3,14,
1051,0,14,3,11,
1052,0,17,4,13,
1053,0,16,3,13,
1054,0,16,3,13,
1055,0,19,4,15,
1056,0,15,3,12,
1057,0,15,3,12,
1058,0,16,4,12,
1059,0,17,3,14,
1060,0,13,3,10,
1061,0,15,4,11,
1062,0,17,4,13,
1063,0,17,4,13,
1064,0,15,3,12,
1065,0,15,3,12,
1066,0,14,4,10,
1067,0,17,4,13,
1068,0,17,3,14,
1069,0,17,4,13,
1070,0,15,3,12,
1071,0,16,3,13,
1072,0,15,3,12,
1073,0,18,4,14,
1074,0,17,3,14,
1075,0,14,3,11,
1076,0,17,4,13,
1077,0,17,4,13,
1078,0,17,3,13,1
1079,0,19,4,15,
1080,0,15,3,12,
1081,0,15,3,12,
1082,0,14,4,10,
1083,0,15,3,12,
1084,0,16,3,13,
1085,0,16,3,13,
1086,0,16,4,12,
1087,0,15,3,12,
1088,0,15,3,12,
1089,0,19,4,15,
1090,0,17,3,14,
1091,0,14,3,11,
1092,0,19,5,14,
1093,0,16,3,13,
1094,0,16,3,13,
1095,0,17,4,13,
1096,0,15,3,12,
1097,0,15,3,12,
1098,0,18,4,14,
1099,0,18,4,14,
1100,0,17,3,14,
1101,0,20,5,15,
1102,0,14,3,11,
1103,0,20,6,14,
1104,0,17,3,14,
1105,0,17,3,14,
1106,0,14,4,10,
1107,0,16,3,13,
1108,0,17,4,12,1
1109,0,16,4,12,
1110,0,15,3,12,
1111,0,19,5,14,
1112,0,16,3,13,
1113,0,19,4,15,
1114,0,15,3,12,
1115,0,15,3,12,
1116,0,19,4,15,
1117,0,14,3,11,
1118,0,14,3,11,
1119,0,15,4,11,
1120,0,16,4,12,
1121,0,15,3,12,
1122,0,17,4,13,
1123,0,16,4,12,
1124,0,15,3,12,
1125,0,19,4,15,
1126,0,17,3,14,
1127,0,17,3,14,
1128,0,17,4,13,
1129,0,15,3,12,
1130,0,17,4,13,
1131,0,17,3,14,
1132,0,17,3,14,
1133,0,17,4,13,
1134,0,15,4,11,
1135,0,15,3,12,
1136,0,18,4,14,
1137,0,18,4,14,
1138,0,16,4,11,1
1139,0,17,4,13,
1140,0,16,4,12,
1141,0,15,3,12,
1142,0,16,4,12,
1143,0,18,4,14,
1144,0,17,3,14,
1145,0,14,3,11,
1146,0,18,4,14,
1147,0,16,3,13,
1148,0,16,3,13,
1149,0,17,4,13,
1150,0,15,3,12,
1151,0,14,3,11,
1152,0,16,4,12,
1153,0,19,5,14,
1154,0,17,3,14,
1155,0,14,3,11,
1156,0,17,4,13,
1157,0,14,3,11,
1158,0,15,4,11,
1159,0,19,4,15,
1160,0,18,4,14,
1161,0,16,4,12,
1162,0,18,4,14,
1163,0,16,3,13,
1164,0,16,3,13,
1165,0,17,5,12,
1166,0,15,3,12,
1167,0,16,3,13,
1168,0,18,4,14,
1169,0,18,4,13,1
1170,0,17,3,14,
1171,0,15,3,12,
1172,0,16,4,12,
1173,0,15,3,12,
1174,0,19,4,15,
1175,0,17,3,14,
1176,0,18,3,15,
1177,0,16,5,11,
1178,0,16,3,13,
1179,0,17,3,14,
1180,0,18,4,14,
1181,0,16,3,13,
1182,0,17,4,13,
1183,0,17,4,13,
1184,0,15,3,12,
1185,0,18,4,14,
1186,0,17,3,14,
1187,0,15,3,12,
1188,0,16,4,12,
1189,0,14,3,11,
1190,0,15,4,11,
1191,0,16,3,13,
1192,0,16,5,11,
1193,0,15,3,12,
1194,0,15,3,12,
1195,0,19,5,14,
1196,0,16,4,12,
1197,0,16,4,12,
1198,0,14,4,10,
1199,0,20,5,14,1
1200,0,17,4,13,
1201,0,16,3,13,
1202,0,17,4,13,
1203,0,16,3,13,
1204,0,14,3,11,
1205,0,15,4,11,
1206,0,16,3,13,
1207,0,17,3,14,
1208,0,16,3,13,
1209,0,18,4,14,
1210,0,17,4,13,
1211,0,16,3,13,
1212,0,16,4,12,
1213,0,16,3,13,
1214,0,5,,5,
1222,0,18,6,12,
1223,0,18,7,11,
1224,0,18,6,12,
1225,0,18,7,11,
1226,0,18,6,12,
1227,0,18,7,11,
1228,0,19,7,12,
1229,0,18,6,11,1
1230,0,19,7,12,
1231,0,18,6,12,
1232,0,19,7,12,
1233,0,17,6,11,
1234,0,18,7,11,
1235,0,18,7,11,
1236,0,17,6,11,
1237,0,17,7,10,
1238,0,17,6,11,
1239,0,18,7,11,
1240,0,18,6,12,
1241,0,17,6,11,
1242,0,17,7,10,
1243,0,17,6,11,
1244,0,17,7,10,
1245,0,18,7,11,
1246,0,16,6,10,
1247,0,18,7,11,
1248,0,16,6,10,
1249,0,18,7,11,
1250,0,19,7,12,
1251,0,16,5,11,
1252,0,17,7,10,
1253,0,18,7,11,
1254,0,16,6,10,
1255,0,18,7,11,
1256,0,16,6,10,
1257,0,18,7,11,
1258,0,16,6,10,
1259,0,18,7,11,
1260,0,19,7,11,1
1261,0,16,5,11,
1262,0,17,7,10,
1263,0,17,7,10,
1264,0,16,6,10,
1265,0,19,7,12,
1266,0,16,6,10,
1267,0,19,7,12,
1268,0,17,7,10,
1269,0,18,6,12,
1270,0,19,7,12,
1271,0,16,5,11,
1272,0,18,7,11,
1273,0,19,7,12,
1274,0,17,6,11,
1275,0,19,7,12,
1276,0,20,8,12,
1277,0,19,6,13,
1278,0,17,6,11,
1279,0,19,7,12,
1280,0,18,7,11,
1281,0,18,6,12,
1282,0,18,7,11,
1283,0,15,3,12,
1284,0,13,3,10,
1285,0,15,4,11,
1286,0,15,4,11,
1287,0,12,3,9,
1288,0,14,4,10,
1289,0,13,3,10,
1290,0,15,4,10,1
1291,0,13,4,9,
1292,0,15,3,12,
1293,0,14,3,11,
1294,0,14,3,11,
1295,0,15,4,11,
1296,0,13,3,10,
1297,0,15,4,11,
1298,0,13,3,10,
1299,0,14,4,10,
1300,0,13,3,10,
1301,0,14,3,11,
1302,0,13,3,10,
1303,0,16,4,12,
1304,0,13,3,10,
1305,0,15,4,11,
1306,0,14,3,11,
1307,0,12,3,9,
1308,0,14,4,10,
1309,0,14,3,11,
1310,0,15,3,12,
1311,0,13,4,9,
1312,0,14,4,10,
1313,0,13,3,10,
1314,0,15,4,11,
1315,0,13,3,10,
1316,0,14,4,10,
1317,0,14,3,11,
1318,0,13,3,10,
1319,0,14,3,11,
1320,0,15,4,10,1
1321,0,14,3,11,
1322,0,12,3,9,
1323,0,16,4,12,
1324,0,14,3,11,
1325,0,14,3,11,
1326,0,14,3,11,
1327,0,14,4,10,
1328,0,14,3,11,
1329,0,12,3,9,
1330,0,16,4,12,
1331,0,13,3,10,
1332,0,13,3,10,
1333,0,17,4,13,
1334,0,16,3,13,
1335,0,13,3,10,
1336,0,16,4,12,
1337,0,14,3,11,
1338,0,14,3,11,
1339,0,16,4,12,
1340,0,14,4,10,
1341,0,16,4,12,
1342,0,14,3,11,
1343,0,15,4,11,
1344,0,12,3,9,
1345,0,14,4,10,
1346,0,14,3,11,
1347,0,14,3,11,
1348,0,13,3,10,
1349,0,14,4,10,
1350,0,16,4,12,
1351,0,15,3,11,1
1352,0,14,3,11,
1353,0,12,3,9,
1354,0,16,4,12,
1355,0,13,3,10,
1356,0,13,3,10,
1357,0,16,4,12,
1358,0,15,3,12,
1359,0,15,3,12,
1360,0,15,3,12,
1361,0,16,4,12,
1362,0,13,3,10,
1363,0,14,3,11,
1364,0,13,4,9,
1365,0,13,3,10,
1366,0,15,4,11,
1367,0,14,3,11,
1368,0,12,3,9,
1369,0,14,4,10,
1370,0,14,3,11,
1371,0,14,3,11,
1372,0,13,3,10,
1373,0,14,4,10,
1374,0,15,4,11,
1375,0,15,4,11,
1376,0,14,3,11,
1377,0,15,4,11,
1378,0,15,3,12,
1379,0,12,3,9,
1380,0,18,6,12,
1381,0,18,6,11,1
1382,0,19,7,12,
1383,0,18,7,11,
1384,0,19,7,12,
1385,0,19,7,12,
1386,0,19,6,13,
1387,0,17,6,11,
1388,0,19,7,12,
1389,0,19,7,12,
1390,0,18,6,12,
1391,0,18,7,11,
1392,0,19,7,12,
1393,0,17,6,11,
1394,0,19,7,12,
1395,0,16,5,11,
1396,0,18,7,11,
1397,0,18,7,11,
1398,0,17,7,10,
1399,0,17,6,11,
1400,0,18,7,11,
1401,0,17,6,11,
1402,0,16,6,10,
1403,0,18,7,11,
1404,0,16,6,10,
1405,0,18,7,11,
1406,0,18,7,11,
1407,0,17,6,11,
1408,0,17,7,10,
1409,0,18,7,11,
1410,0,17,6,11,
1411,0,17,6,10,1
1412,0,16,6,10,
1413,0,18,7,11,
1414,0,16,6,10,
1415,0,18,7,11,
1416,0,17,7,10,
1417,0,17,6,11,
1418,0,17,7,10,
1419,0,18,7,11,
1420,0,17,6,11,
1421,0,17,6,11,
1422,0,16,6,10,
1423,0,19,7,12,
1424,0,17,7,10,
1425,0,18,6,12,
1426,0,18,7,11,
1427,0,18,6,12,
1428,0,18,7,11,
1429,0,19,7,12,
1430,0,18,6,12,
1431,0,18,6,12,
1432,0,18,7,11,
1433,0,18,6,12,
1434,0,18,7,11,
1435,0,18,6,12,
1436,0,18,7,11,
1437,0,20,7,13,
1438,0,17,6,11,
1439,0,19,7,12,
1440,0,18,6,12,
1441,0,18,6,12,
1442,0,18,7,10,1
1443,0,18,6,12,
1444,0,18,7,11,
1445,0,18,6,12,
1446,0,18,7,11,
1447,0,18,7,11,
1448,0,17,6,11,
1449,0,19,7,12,
1450,0,17,6,11,
1451,0,17,6,11,
1452,0,18,7,11,
1453,0,17,6,11,
1454,0,18,7,11,
1455,0,18,7,11,
1456,0,17,6,11,
1457,0,17,7,10,
1458,0,17,6,11,
1459,0,18,8,10,
1460,0,18,7,11,
1461,0,17,6,11,
1462,0,17,6,11,
1463,0,17,7,10,
1464,0,18,7,11,
1465,0,16,6,10,
1466,0,18,7,11,
1467,0,17,7,10,
1468,0,17,6,11,
1469,0,17,7,10,
1470,0,16,5,11,
1471,0,18,7,11,
1472,0,18,6,11,1
1473,0,16,6,10,
1474,0,19,7,12,
1475,0,17,6,11,
1476,0,18,7,11,
1477,0,17,6,11,
1478,0,19,7,12,
1479,0,17,6,11,
1480,0,19,7,12,
1481,0,18,7,11,
1482,0,18,6,12,
1483,0,18,7,11,
1484,0,18,6,12,
1485,0,19,7,12,
1486,0,19,6,13,
1487,0,18,7,11,
1488,0,18,6,12,
1489,0,18,7,11,
1490,0,19,7,12,
1491,0,17,6,11,
1492,0,18,7,11,
1493,0,17,6,11,
1494,0,19,7,12,
1495,0,14,4,10,
1496,0,15,4,11,
1497,0,16,4,12,
1498,0,15,4,11,
1499,0,15,3,12,
1500,0,12,3,9,
1501,0,15,4,11,
1502,0,15,4,10,1
1503,0,17,4,12,1
1504,0,13,3,10,
1505,0,13,3,10,
1506,0,15,4,11,
1507,0,15,3,12,
1508,0,14,3,11,
1509,0,15,3,12,
1510,0,16,4,12,
1511,0,13,3,10,
1512,0,15,4,11,
1513,0,13,3,10,
1514,0,13,3,10,
1515,0,15,4,11,
1516,0,14,3,11,
1517,0,12,3,9,
1518,0,17,4,13,
1519,0,13,3,10,
1520,0,14,4,10,
1521,0,14,3,11,
1522,0,13,4,9,
1523,0,16,4,12,
1524,0,14,3,11,
1525,0,15,4,11,
1526,0,15,4,11,
1527,0,14,3,11,
1528,0,12,3,9,
1529,0,16,4,12,
1530,0,14,3,11,
1531,0,14,3,11,
1532,0,16,5,11,
1533,0,14,3,10,1
1534,0,13,3,10,
1535,0,15,4,11,
1536,0,14,3,11,
1537,0,12,3,9,
1538,0,14,4,10,
1539,0,14,3,11,
1540,0,14,3,11,
1541,0,14,4,10,
1542,0,14,4,10,
1543,0,14,3,11,
1544,0,12,3,9,
1545,0,15,4,11,
1546,0,13,3,10,
1547,0,16,4,12,
1548,0,13,3,10,
1549,0,14,4,10,
1550,0,15,3,12,
1551,0,16,3,13,
1552,0,15,4,11,
1553,0,14,4,10,
1554,0,13,3,10,
1555,0,15,4,11,
1556,0,17,5,12,
1557,0,14,3,11,
1558,0,14,3,11,
1559,0,12,3,9,
1560,0,17,4,13,
1561,0,14,3,11,
1562,0,14,3,11,
1563,0,17,4,12,1
1564,0,13,3,10,
1565,0,14,3,11,
1566,0,14,4,10,
1567,0,14,3,11,
1568,0,12,3,9,
1569,0,17,4,13,
1570,0,14,3,11,
1571,0,14,3,11,
1572,0,14,3,11,
1573,0,14,4,10,
1574,0,14,3,11,
1575,0,12,3,9,
1576,0,16,4,12,
1577,0,14,4,10,
1578,0,13,3,10,
1579,0,13,4,9,
1580,0,15,3,12,
1581,0,13,3,10,
1582,0,15,4,11,
1583,0,14,3,11,
1584,0,13,3,10,
1585,0,13,3,10,
1586,0,14,4,10,
1587,0,14,3,11,
1588,0,12,3,9,
1589,0,17,4,13,
1590,0,14,3,11,
1591,0,14,3,11,
1592,0,16,5,11,
1593,0,14,3,11,
1594,0,16,4,11,1
1595,0,13,3,10,
1596,0,13,3,10,
1597,0,14,4,10,
1598,0,14,3,11,
1599,0,12,3,9,
1600,0,17,4,13,
1601,0,14,3,11,
1602,0,14,3,11,
1603,0,14,4,10,
1604,0,13,3,10,
1605,0,14,3,11,
1606,0,14,4,10,
1607,0,16,5,11,
1608,0,13,3,10,
1609,0,16,4,12,
1610,0,16,7,9,
1611,0,15,3,12,
1612,0,12,3,9,
1613,0,17,5,12,
1614,0,15,4,11,
1615,0,14,3,11,
1616,0,15,4,11,
1617,0,17,5,12,
1618,0,13,3,10,
1619,0,19,7,12,
1620,0,15,4,11,
1621,0,16,5,11,
1622,0,14,3,11,
1623,0,14,4,10,
1624,0,16,4,11,1
1625,0,12,3,9,
1626,0,16,4,12,
1627,0,13,3,10,
1628,0,13,3,10,
1629,0,16,4,12,
1630,0,15,3,12,
1631,0,13,3,10,
1632,0,15,4,11,
1633,0,14,3,11,
1634,0,12,3,9,
1635,0,13,3,10,
1636,0,13,4,9,
1637,0,15,4,11,
1638,0,14,5,9,
1639,0,17,4,13,
1640,0,15,3,12,
1641,0,15,3,12,
1642,0,13,3,10,
1643,0,15,5,10,
1644,0,14,3,11,
1645,0,12,3,9,
1646,0,15,4,11,
1647,0,14,4,10,
1648,0,13,3,10,
1649,0,16,4,12,
1650,0,17,4,13,
1651,0,14,3,11,
1652,0,14,3,11,
1653,0,14,4,10,
1654,0,13,3,9,1
1655,0,15,4,11,
1656,0,13,3,10,
1657,0,13,3,10,
1658,0,16,4,12,
1659,0,15,3,12,
1660,0,13,3,10,
1661,0,15,4,11,
1662,0,14,3,11,
1663,0,13,3,10,
1664,0,14,4,10,
1665,0,13,3,10,
1666,0,14,3,11,
1667,0,15,4,11,
1668,0,14,3,11,
1669,0,13,4,9,
1670,0,16,4,12,
1671,0,13,3,10,
1672,0,14,3,11,
1673,0,15,5,10,
1674,0,14,3,11,
1675,0,14,3,11,
1676,0,13,4,9,
1677,0,14,4,10,
1678,0,15,4,11,
1679,0,14,3,11,
1680,0,13,4,9,
1681,0,16,4,12,
1682,0,13,3,10,
1683,0,16,4,12,
1684,0,15,3,12,
1685,0,16,4,11,1
1686,0,14,3,11,
1687,0,13,3,10,
1688,0,14,4,10,
1689,0,14,3,11,
1690,0,15,3,12,
1691,0,14,3,11,
1692,0,14,3,11,
1693,0,15,4,11,
1694,0,13,3,10,
1695,0,13,3,10,
1696,0,15,4,11,
1697,0,14,3,11,
1698,0,16,4,12,
1699,0,13,3,10,
1700,0,17,5,12,
1701,0,15,3,12,
1702,0,13,3,10,
1703,0,15,4,11,
1704,0,14,3,11,
1705,0,12,3,9,
1706,0,14,4,10,
1707,0,16,5,11,
1708,0,16,4,12,
1709,0,13,3,10,
1710,0,13,3,10,
1711,0,16,4,12,
1712,0,15,3,12,
1713,0,16,4,12,
1714,0,15,3,12,
1715,0,15,4,10,1
1716,0,15,4,11,
1717,0,14,3,11,
1718,0,12,3,9,
1719,0,16,4,12,
1720,0,13,3,10,
1721,0,13,3,10,
1722,0,14,4,10,
1723,0,13,3,10,
1724,0,14,3,11,
1725,0,14,3,11,
1726,0,14,4,10,
1727,0,13,3,10,
1728,0,14,3,11,
1729,0,15,4,11,
1730,0,14,3,11,
1731,0,14,4,10,
1732,0,17,4,13,
1733,0,14,3,11,
1734,0,15,4,11,
1735,0,16,4,12,
1736,0,13,3,10,
1737,0,15,4,11,
1738,0,14,4,10,
1739,0,13,3,10,
1740,0,15,4,11,
1741,0,13,3,10,
1742,0,14,4,10,
1743,0,14,3,11,
1744,0,15,4,11,
1745,0,17,4,12,1
1746,0,13,3,10,
1747,0,14,4,10,
1748,0,14,3,11,
1749,0,13,3,10,
1750,0,14,3,11,
1751,0,14,4,10,
1752,0,14,3,11,
1753,0,12,3,9,
1754,0,17,4,13,
1755,0,14,3,11,
1756,0,14,3,11,
1757,0,14,3,11,
1758,0,13,4,9,
1759,0,15,4,11,
1760,0,13,3,10,
1761,0,15,4,11,
1762,0,15,4,11,
1763,0,16,4,12,
1764,0,14,3,11,
1765,0,14,3,11,
1766,0,13,3,10,
1767,0,14,4,10,
1768,0,15,4,11,
1769,0,15,5,10,
1770,0,14,3,11,
1771,0,13,4,9,
1772,0,15,3,12,
1773,0,14,3,11,
1774,0,14,3,11,
1775,0,14,4,10,
1776,0,15,3,11,1
1777,0,15,3,12,
1778,0,13,3,10,
1779,0,14,4,10,
1780,0,13,3,10,
1781,0,14,3,11,
1782,0,12,3,9,
1783,0,16,4,12,
1784,0,15,3,12,
1785,0,15,3,12,
1786,0,13,3,10,
1787,0,15,4,11,
1788,0,14,3,11,
1789,0,12,3,9,
1790,0,16,4,12,
1791,0,14,3,11,
1792,0,15,4,11,
1793,0,14,4,10,
1794,0,15,3,12,
1795,0,14,4,10,
1796,0,13,3,10,
1797,0,14,3,11,
1798,0,14,4,10,
1799,0,13,3,10,
1800,0,13,4,9,
1801,0,14,3,11,
1802,0,16,4,12,
1803,0,15,3,12,
1804,0,15,4,11,
1805,0,15,3,12,
1806,0,16,4,11,1
1807,0,15,4,11,
1808,0,14,3,11,
1809,0,13,3,10,
1810,0,14,3,11,
1811,0,15,4,11,
1812,0,14,3,11,
1813,0,12,3,9,
1814,0,17,4,13,
1815,0,14,3,11,
1816,0,14,3,11,
1817,0,14,3,11,
1818,0,15,4,11,
1819,0,16,5,11,
1820,0,17,7,10,
1821,0,14,3,11,
1822,0,15,4,11,
1823,0,13,3,10,
1824,0,14,4,10,
1825,0,14,4,10,
1826,0,13,3,10,
1827,0,14,3,11,
1828,0,16,5,11,
1829,0,16,4,12,
1830,0,14,3,11,
1831,0,14,3,11,
1832,0,15,4,11,
1833,0,14,3,11,
1834,0,14,4,10,
1835,0,15,4,11,
1836,0,14,3,11,
1837,0,14,4,10,
1838,0,14,4,10,
1839,0,16,4,12,
1840,0,15,3,12,
1841,0,14,3,11,
1842,0,15,4,11,
1843,0,14,3,11,
1844,0,13,3,10,
1845,0,14,4,10,
1846,0,14,4,10,
1847,0,14,3,11,
1848,0,12,3,9,
1849,0,16,4,12,
1850,0,14,3,11,
1851,0,14,3,11,
1852,0,16,4,12,
1853,0,14,4,10,
1854,0,3,,3,
1855,0,6,2,4,
1856,0,17,4,13,
1857,0,16,3,13,
1858,0,16,3,13,
1859,0,17,4,13,
1860,0,17,3,14,
1861,0,18,4,14,
1862,0,17,4,13,
1863,0,18,4,14,
1864,0,17,3,14,
1865,0,19,4,15,
1866,0,20,3,17,
1867,0,24,4,20,
1868,0,22,3,19,
1869,0,25,4,21,
1870,0,23,3,20,
1871,0,24,4,20,
1872,0,26,4,22,
1873,0,24,3,21,
1874,0,24,3,21,
1875,0,25,4,21,
1876,0,26,3,23,
1877,0,26,3,23,
1878,0,25,3,22,
1879,0,28,4,24,
1880,0,27,3,24,
1881,0,26,3,23,
1882,0,28,4,24,
1883,0,29,4,25,
1884,0,29,4,25,
1885,0,30,4,26,
1886,0,28,3,25,
1887,0,31,5,26,
1888,0,29,3,26,
1889,0,30,4,26,
1890,0,31,4,27,
1891,0,30,3,27,
1892,0,29,3,26,
1893,0,33,4,29,
1894,0,31,3,28,
1895,0,31,4,27,
1896,0,31,4,27,
1897,0,32,3,29,
1898,0,33,4,29,
1899,0,33,4,29,
1900,0,31,3,28,
1901,0,35,4,31,
1902,0,33,3,30,
1903,0,32,3,29,
1904,0,35,4,31,
1905,0,34,3,31,
1906,0,34,3,31,
1907,0,34,4,30,
1908,0,34,3,31,
1909,0,35,3,32,
1910,0,34,3,31,
1911,0,36,4,32,
1912,0,35,3,32,
1913,0,36,4,32,
1914,0,37,4,33,
1915,0,35,3,32,
1916,0,37,4,33,
1917,0,36,3,33,
1918,0,36,3,33,
1919,0,39,5,34,
1920,0,37,4,33,
1921,0,37,3,34,
1922,0,37,3,34,
1923,0,37,3,34,
1924,0,39,4,35,
1925,0,39,4,35,
1926,0,38,4,34,
1927,0,39,4,35,
1928,0,40,4,36,
1929,0,40,4,36,
1930,0,39,3,36,
1931,0,38,3,35,
1932,0,41,4,37,
1933,0,40,3,37,
1934,0,39,3,36,
1935,0,42,4,38,
1936,0,40,3,37,
1937,0,39,3,36,
1938,0,42,4,38,
1939,0,41,3,38,
1940,0,41,3,38,
1941,0,41,4,37,
1942,0,41,3,38,
1943,0,43,4,39,
1944,0,42,3,39,
1945,0,43,4,39,
1946,0,42,4,38,
1947,0,42,3,39,
1948,0,42,4,38,
1949,0,42,4,38,
1950,0,44,5,39,
1951,0,44,4,40,
1952,0,42,3,39,
1953,0,44,4,40,
1954,0,43,3,40,
1955,0,42,3,39,
1956,0,46,4,42,
1957,0,44,3,41,
1958,0,43,3,40,
1959,0,46,4,42,
1960,0,43,3,40,
1961,0,45,4,41,
1962,0,45,3,42,
1963,0,44,3,41,
1964,0,47,4,43,
1965,0,45,3,42,
1966,0,44,3,41,
1967,0,47,4,43,
1968,0,46,3,43,
1969,0,46,3,43,
1970,0,47,4,43,
1971,0,45,3,42,
1972,0,48,4,44,
1973,0,46,3,43,
1974,0,45,3,42,
1975,0,51,6,45,
1976,0,47,3,44,
1977,0,47,3,44,
1978,0,47,4,43,
1979,0,47,3,44,
1980,0,48,4,44,
1981,0,46,3,43,
1982,0,49,4,45,
1983,0,48,3,45,
1984,0,47,3,44,
1985,0,49,4,45,
1986,0,47,3,44,
1987,0,49,4,45,
1988,0,48,3,45,
1989,0,48,3,45,
1990,0,50,4,46,
1991,0,50,4,46,
1992,0,48,3,45,
1993,0,51,4,47,
1994,0,49,3,46,
1995,0,50,4,46,
1996,0,50,4,46,
1997,0,50,3,47,
1998,0,49,3,46,
1999,0,49,3,46,
2000,0,51,4,47,
2001,0,50,3,47,
2002,0,49,3,46,
2003,0,52,4,48,
2004,0,51,3,48,
2005,0,50,3,47,
2006,0,53,4,49,
2007,0,51,3,48,
2008,0,50,3,47,
2009,0,54,5,49,
2010,0,54,5,49,
2011,0,52,4,48,
2012,0,54,4,50,
2013,0,53,4,49,
2014,0,52,3,49,
2015,0,52,4,48,
2016,0,52,4,48,
2017,0,54,4,50,
2018,0,52,3,49,
2019,0,54,4,50,
2020,0,53,3,50,
2021,0,53,4,49,
2022,0,55,4,51,
2023,0,53,3,50,
2024,0,52,3,49,
2025,0,56,4,52,
2026,0,54,3,51,
2027,0,54,3,51,
2028,0,54,4,50,
2029,0,54,3,51,
2030,0,54,3,51,
2031,0,53,3,50,
2032,0,55,4,51,
2033,0,55,3,52,
2034,0,54,3,51,
2035,0,57,4,53,
2036,0,55,4,51,
2037,0,56,4,52,
2038,0,55,3,52,
2039,0,54,3,51,
2040,0,56,4,52,
2041,0,56,4,52,
2042,0,56,3,53,
2043,0,58,4,54,
2044,0,55,3,52,
2045,0,57,4,53,
2046,0,56,3,53,
2047,0,57,4,53,
2048,0,56,3,53,
2049,0,56,4,52,
2050,0,57,3,54,
2051,0,57,3,54,
2052,0,57,4,53,
2053,0,57,3,54,
2054,0,57,3,54,
2055,0,56,3,53,
2056,0,58,4,54,
2057,0,57,3,54,
2058,0,57,3,54,
2059,0,60,4,56,
2060,0,58,3,55,
2061,0,57,3,54,
2062,0,60,4,56,
2063,0,58,3,55,
2064,0,58,3,55,
2065,0,59,4,55,
2066,0,59,4,55,
2067,0,60,4,56,
2068,0,58,3,55,
2069,0,60,4,56,
2070,0,59,3,56,
2071,0,60,5,55,
2072,0,61,4,57,
2073,0,59,3,56,
2074,0,58,3,55,
2075,0,61,4,57,
2076,0,60,3,57,
2077,0,61,4,57,
2078,0,60,4,56,
2079,0,60,3,57,
2080,0,60,3,57,
2081,0,59,3,56,
2082,0,60,4,56,
2083,0,61,4,57,
2084,0,59,3,56,
2085,0,63,4,59,
2086,0,61,3,58,
2087,0,60,3,57,
2088,0,63,4,59,
2089,0,61,3,58,
2090,0,60,3,57,
2091,0,62,4,58,
2092,0,62,4,58,
2093,0,60,3,57,
2094,0,61,3,58,
2095,0,63,4,59,
2096,0,62,3,59,
2097,0,62,4,58,
2098,0,63,4,59,
2099,0,62,4,58,
2100,0,62,3,59,
2101,0,64,5,59,
2102,0,62,4,58,
2103,0,64,4,60,
2104,0,64,4,60,
2105,0,64,4,60,
2106,0,63,4,59,
2107,0,64,4,60,
2108,0,63,3,60,
2109,0,64,4,60,
2110,0,62,3,59,
2111,0,63,4,59,
2112,0,63,4,59,
2113,0,66,4,62,
2114,0,64,3,61,
2115,0,63,3,60,
2116,0,66,4,62,
2117,0,64,3,61,
2118,0,64,3,61,
2119,0,64,4,60,
2120,0,64,3,61,
2121,0,64,3,61,
2122,0,66,4,62,
2123,0,66,4,62,
2124,0,65,4,61,
2125,0,66,4,62,
2126,0,69,7,62,
2127,0,68,6,62,
2128,0,69,7,62,
2129,0,68,6,62,
2130,0,69,7,62,
2131,0,70,7,63,
2132,0,69,6,63,
2133,0,70,7,63,
2134,0,70,7,63,
2135,0,69,6,63,
2136,0,70,7,63,
2137,0,69,6,63,
2138,0,70,7,63,
2139,0,70,7,63,
2140,0,69,6,63,
2141,0,70,7,63,
2142,0,70,6,64,
2143,0,71,7,64,
2144,0,71,7,64,
2145,0,70,6,64,
2146,0,71,7,64,
2147,0,71,7,64,
2148,0,70,6,64,
2149,0,70,7,63,
2150,0,70,6,64,
2151,0,71,7,64,
2152,0,71,6,65,
2153,0,72,7,65,
2154,0,72,7,65,
2155,0,71,6,65,
2156,0,72,7,65,
2157,0,71,7,64,
2158,0,71,6,65,
2159,0,72,7,65,
2160,0,71,6,65,
2161,0,72,7,65,
2162,0,73,7,66,
2163,0,72,6,66,
2164,0,73,7,66,
2165,0,73,7,66,
2166,0,72,6,66,
2167,0,73,7,66,
2168,0,72,6,66,
2169,0,73,7,66,
2170,0,73,7,66,
2171,0,72,6,66,
2172,0,73,7,66,
2173,0,73,6,67,
2174,0,74,7,67,
2175,0,74,7,67,
2176,0,73,6,67,
2177,0,74,7,67,
2178,0,73,6,67,
2179,0,74,7,67,
2180,0,74,7,67,
2181,0,73,6,67,
2182,0,74,7,67,
2183,0,73,6,67,
2184,0,75,7,68,
2185,0,75,7,68,
2186,0,74,6,68,
2187,0,75,7,68,
2188,0,75,7,68,
2189,0,74,6,68,
2190,0,75,7,68,
2191,0,74,6,68,
2192,0,73,6,67,
2193,0,74,5,69,
2194,0,71,3,68,
2195,0,72,4,68,
2196,0,74,4,70,
2197,0,72,3,69,
2198,0,71,3,68,
2199,0,74,4,70,
2200,0,74,5,69,
2201,0,72,3,69,
2202,0,72,4,68,
2203,0,72,3,69,
2204,0,74,5,69,
2205,0,71,3,68,
2206,0,74,4,70,
2207,0,73,3,70,
2208,0,72,3,69,
2209,0,75,4,71,
2210,0,73,3,70,
2211,0,72,3,69,
2212,0,75,4,71,
2213,0,74,4,70,
2214,0,73,3,70,
2215,0,73,4,69,
2216,0,73,3,70,
2217,0,73,3,70,
2218,0,73,4,69,
2219,0,75,5,70,
2220,0,73,3,70,
2221,0,72,3,69,
2222,0,75,5,70,
2223,0,73,3,70,
2224,0,72,3,69,
2225,0,75,4,71,
2226,0,73,3,70,
2227,0,72,3,69,
2228,0,72,4,68,
2229,0,64,3,61,
2230,0,59,4,55,
2231,0,52,3,49,
2232,0,45,3,42,
2233,0,47,4,43,
2234,0,44,3,41,
2235,0,43,4,39,
2236,0,42,4,38,
2237,0,37,3,34,
2238,0,35,3,32,
2239,0,31,3,28,
2240,0,30,4,26,
2241,0,30,4,26,
2242,0,29,3,26,
2243,0,31,4,27,
2244,0,31,3,28,
2245,0,35,4,31,
2246,0,40,3,37,
2247,0,43,3,40,
2248,0,46,4,42,
2249,0,45,3,42,
2250,0,47,4,43,
2251,0,45,3,42,
2252,0,46,4,42,
2253,0,48,4,44,
2254,0,46,3,43,
2255,0,49,4,45,
2256,0,47,3,44,
2257,0,48,4,44,
2258,0,47,3,44,
2259,0,47,3,44,
2260,0,49,4,45,
2261,0,48,3,45,
2262,0,47,3,44,
2263,0,50,4,46,
2264,0,49,3,46,
2265,0,48,3,45,
2266,0,51,4,47,
2267,0,49,3,46,
2268,0,49,3,46,
2269,0,49,4,45,
2270,0,50,3,47,
2271,0,50,3,47,
2272,0,49,3,46,
2273,0,52,5,47,
2274,0,50,4,46,
2275,0,50,3,47,
2276,0,49,3,46,
2277,0,50,3,47,
2278,0,52,4,48,
2279,0,53,4,49,
2280,0,52,4,48,
2281,0,52,4,48,
2282,0,51,4,47,
2283,0,54,5,49,
2284,0,52,3,49,
2285,0,52,4,48,
2286,0,53,4,49,
2287,0,52,3,49,
2288,0,51,3,48,
2289,0,56,6,50,
2290,0,53,3,50,
2291,0,53,4,49,
2292,0,55,4,51,
2293,0,53,3,50,
2294,0,52,3,49,
2295,0,54,4,50,
2296,0,55,4,51,
2297,0,53,3,50,
2298,0,54,4,50,
2299,0,54,3,51,
2300,0,54,3,51,
2301,0,53,3,50,
2302,0,55,4,51,
2303,0,55,3,52,
2304,0,55,4,51,
2305,0,57,4,53,
2306,0,55,3,52,
2307,0,56,4,52,
2308,0,55,3,52,
2309,0,54,3,51,
2310,0,57,4,53,
2311,0,56,3,53,
2312,0,55,3,52,
2313,0,58,4,54,
2314,0,57,4,53,
2315,0,55,3,52,
2316,0,58,4,54,
2317,0,57,3,54,
2318,0,57,3,54,
2319,0,57,4,53,
2320,0,57,3,54,
2321,0,57,3,54,
2322,0,57,4,53,
2323,0,58,4,54,
2324,0,58,3,55,
2325,0,57,3,54,
2326,0,59,4,55,
2327,0,58,3,55,
2328,0,57,3,54,
2329,0,60,4,56,
2330,0,58,3,55,
2331,0,57,3,54,
2332,0,59,4,55,
2333,0,59,3,56,
2334,0,58,3,55,
2335,0,60,5,55,
2336,0,60,4,56,
2337,0,59,3,56,
2338,0,58,3,55,
2339,0,61,4,57,
2340,0,60,3,57,
2341,0,59,3,56,
2342,0,62,4,58,
2343,0,60,4,56,
2344,0,59,3,56,
2345,0,62,4,58,
2346,0,59,3,56,
2347,0,61,4,57,
2348,0,61,4,57,
2349,0,61,3,58,
2350,0,54,1,53,
2351,0,41,,41,
2352,0,52,6,46,
2353,0,50,3,47,
2354,0,50,3,47,
2355,0,51,3,48,
2356,0,56,4,52,
2357,0,57,3,54,
2358,0,59,3,56,
2359,0,63,4,59,
2360,0,62,3,59,
2361,0,62,3,59,
2362,0,65,4,61,
2363,0,63,3,60,
2364,0,63,4,59,
2365,0,63,4,59,
2366,0,63,3,60,
2367,0,62,3,59,
2368,0,63,4,59,
2369,0,64,3,61,
2370,0,66,4,62,
2371,0,63,3,60,
2372,0,66,5,61,
2373,0,64,3,61,
2374,0,66,5,61,
2375,0,64,3,61,
2376,0,64,4,60,
2377,0,63,3,60,
2378,0,67,4,63,
2379,0,65,3,62,
2380,0,66,4,62,
2381,0,64,3,61,
2382,0,67,4,63,
2383,0,66,4,62,
2384,0,65,4,61,
2385,0,66,4,62,
2386,0,65,3,62,
2387,0,68,4,64,
2388,0,66,3,63,
2389,0,67,4,63,
2390,0,66,3,63,
2391,0,65,3,62,
2392,0,68,4,64,
2393,0,66,3,63,
2394,0,65,3,62,
2395,0,70,5,65,
2396,0,67,3,64,
2397,0,66,3,63,
2398,0,69,4,65,
2399,0,67,3,64,
2400,0,67,3,64,
2401,0,68,4,64,
2402,0,66,3,63,
2403,0,68,4,64,
2404,0,69,5,64,
2405,0,68,3,65,
2406,0,68,3,65,
2407,0,67,3,64,
2408,0,69,4,65,
2409,0,68,3,65,
2410,0,68,4,64,
2411,0,70,4,66,
2412,0,69,3,66,
2413,0,68,3,65,
2414,0,71,4,67,
2415,0,69,3,66,
2416,0,69,3,66,
2417,0,69,4,65,
2418,0,69,3,66,
2419,0,69,3,66,
2420,0,68,3,65,
2421,0,71,4,67,
2422,0,70,4,66,
2423,0,70,3,67,
2424,0,70,3,67,
2425,0,71,4,67,
2426,0,74,7,67,
2427,0,73,6,67,
2428,0,74,7,67,
2429,0,75,7,68,
2430,0,73,6,67,
2431,0,75,7,68,
2432,0,75,7,68,
2433,0,74,6,68,
2434,0,74,7,67,
2435,0,74,6,68,
2436,0,75,7,68,
2437,0,75,7,68,
2438,0,75,7,68,
2439,0,75,7,68,
2440,0,75,6,69,
2441,0,76,7,69,
2442,0,76,7,69,
2443,0,75,6,69,
2444,0,76,7,69,
2445,0,76,7,69,
2446,0,76,7,69,
2447,0,76,7,69,
2448,0,75,6,69,
2449,0,76,7,69,
2450,0,76,6,70,
2451,0,77,7,70,
2452,0,77,7,70,
2453,0,76,6,70,
2454,0,77,7,70,
2455,0,77,7,70,
2456,0,76,6,70,
2457,0,77,7,70,
2458,0,76,6,70,
2459,0,77,7,70,
2460,0,78,7,71,
2461,0,76,6,70,
2462,0,77,7,70,
2463,0,77,7,70,
2464,0,77,7,70,
2465,0,77,7,70,
2466,0,76,6,70,
2467,0,77,7,70,
2468,0,76,6,70,
2469,0,77,7,70,
2470,0,72,7,65,
2471,0,66,6,60,
2472,0,61,7,54,
2473,0,56,7,49,
2474,0,48,6,42,
2475,0,49,7,42,
2476,0,48,6,42,
2477,0,47,7,40,
2478,0,44,6,38,
2479,0,41,7,34,
2480,0,33,5,28,
2481,0,30,7,23,
2482,0,26,6,20,
2483,0,24,7,17,
2484,0,21,6,15,
2485,0,21,6,15,
2486,0,25,7,18,
2487,0,30,7,23,
2488,0,33,6,27,
2489,0,34,7,27,
2490,0,33,6,27,
2491,0,35,7,28,
2492,0,35,7,28,
2493,0,34,6,28,
2494,0,36,7,29,
2495,0,35,6,29,
2496,0,36,7,29,
2497,0,35,7,28,
2498,0,36,6,30,
2499,0,37,7,30,
2500,0,37,7,30,
2501,0,38,7,31,
2502,0,39,7,32,
2503,0,37,6,31,
2504,0,38,7,31,
2505,0,40,7,33,
2506,0,38,6,32,
2507,0,39,7,32,
2508,0,39,7,32,
2509,0,40,7,33,
2510,0,40,7,33,
2511,0,39,6,33,
2512,0,40,7,33,
2513,0,40,6,34,
2514,0,41,7,34,
2515,0,41,7,34,
2516,0,40,6,34,
2517,0,42,7,35,
2518,0,42,7,35,
2519,0,41,6,35,
2520,0,42,7,35,
2521,0,41,6,35,
2522,0,43,7,36,
2523,0,43,7,36,
2524,0,42,6,36,
2525,0,41,6,35,
2526,0,42,4,38,
2527,0,40,3,37,
2528,0,41,5,36,
2529,0,41,5,36,
2530,0,41,4,37,
2531,0,42,4,38,
2532,0,41,3,38,
2533,0,40,3,37,
2534,0,42,4,38,
2535,0,41,3,38,
2536,0,42,3,39,
2537,0,42,4,38,
2538,0,41,3,38,
2539,0,44,4,40,
2540,0,43,4,39,
2541,0,42,3,39,
2542,0,45,4,41,
2543,0,43,3,40,
2544,0,43,3,40,
2545,0,43,4,39,
2546,0,44,3,41,
2547,0,45,4,41,
2548,0,43,3,40,
2549,0,45,4,41,
2550,0,44,3,41,
2551,0,44,3,41,
2552,0,47,4,43,
2553,0,45,3,42,
2554,0,44,3,41,
2555,0,46,4,42,
2556,0,47,5,42,
2557,0,46,3,43,
2558,0,47,4,43,
2559,0,47,4,43,
2560,0,46,3,43,
2561,0,46,4,42,
2562,0,48,4,44,
2563,0,47,3,44,
2564,0,46,3,43,
2565,0,48,4,44,
2566,0,47,3,44,
2567,0,46,3,43,
2568,0,49,4,45,
2569,0,47,3,44,
2570,0,49,4,45,
2571,0,50,4,46,
2572,0,48,3,45,
2573,0,48,3,45,
2574,0,49,4,45,
2575,0,49,3,46,
2576,0,49,3,46,
2577,0,51,5,46,
2578,0,48,3,45,
2579,0,51,4,47,
2580,0,50,3,47,
2581,0,50,3,47,
2582,0,50,4,46,
2583,0,50,3,47,
2584,0,50,3,47,
2585,0,50,4,46,
2586,0,53,5,48,
2587,0,51,3,48,
2588,0,50,3,47,
2589,0,53,5,48,
2590,0,51,3,48,
2591,0,50,3,47,
2592,0,53,4,49,
2593,0,51,3,48,
2594,0,53,4,49,
2595,0,52,3,49,
2596,0,51,3,48,
2597,0,54,4,50,
2598,0,52,3,49,
2599,0,52,3,49,
2600,0,53,4,49,
2601,0,53,3,50,
2602,0,54,4,50,
2603,0,53,3,50,
2604,0,52,3,49,
2605,0,56,4,52,
2606,0,54,3,51,
2607,0,54,4,50,
2608,0,56,4,52,
2609,0,54,3,51,
2610,0,54,3,51,
2611,0,54,4,50,
2612,0,55,3,52,
2613,0,57,4,53,
2614,0,55,3,52,
2615,0,54,3,51,
2616,0,57,4,53,
2617,0,55,3,52,
2618,0,55,4,51,
2619,0,58,4,54,
2620,0,56,3,53,
2621,0,56,3,53,
2622,0,56,4,52,
2623,0,56,3,53,
2624,0,56,3,53,
2625,0,55,3,52,
2626,0,58,4,54,
2627,0,57,3,54,
2628,0,56,3,53,
2629,0,59,4,55,
2630,0,58,4,54,
2631,0,56,3,53,
2632,0,58,4,54,
2633,0,56,3,53,
2634,0,60,4,56,
2635,0,58,3,55,
2636,0,57,3,54,
2637,0,60,4,56,
2638,0,57,3,54,
2639,0,59,4,55,
2640,0,58,3,55,
2641,0,58,3,55,
2642,0,61,4,57,
2643,0,58,3,55,
2644,0,60,4,56,
2645,0,59,3,56,
2646,0,60,4,56,
2647,0,60,4,56,
2648,0,59,4,55,
2649,0,61,4,57,
2650,0,61,4,57,
2651,0,59,3,56,
2652,0,62,5,57,
2653,0,62,4,58,
2654,0,60,3,57,
2655,0,61,4,57,
2656,0,61,3,58,
2657,0,60,3,57,
2658,0,63,4,59,
2659,0,61,3,58,
2660,0,60,3,57,
2661,0,62,4,58,
2662,0,60,3,57,
2663,0,62,4,58,
2664,0,62,3,59,
2665,0,61,3,58,
2666,0,64,4,60,
2667,0,62,3,59,
2668,0,61,3,58,
2669,0,64,4,60,
2670,0,62,3,59,
2671,0,62,3,59,
2672,0,63,4,59,
2673,0,63,3,60,
2674,0,64,4,60,
2675,0,63,4,59,
2676,0,63,3,60,
2677,0,64,4,60,
2678,0,63,4,59,
2679,0,64,4,60,
2680,0,64,3,61,
2681,0,63,3,60,
2682,0,66,4,62,
2683,0,65,4,61,
2684,0,63,3,60,
2685,0,66,4,62,
2686,0,64,3,61,
2687,0,64,3,61,
2688,0,64,4,60,
2689,0,65,3,62,
2690,0,65,3,62,
2691,0,65,4,61,
2692,0,66,4,62,
2693,0,65,3,62,
2694,0,64,3,61,
2695,0,67,4,63,
2696,0,65,3,62,
2697,0,65,3,62,
2698,0,67,4,63,
2699,0,66,4,62,
2700,0,66,3,63,
2701,0,66,3,63,
2702,0,65,3,62,
2703,0,66,4,62,
2704,0,67,4,63,
2705,0,65,3,62,
2706,0,69,4,65,
2707,0,68,4,64,
2708,0,66,3,63,
2709,0,69,4,65,
2710,0,67,3,64,
2711,0,68,4,64,
2712,0,67,4,63,
2713,0,66,3,63,
2714,0,70,4,66,
2715,0,68,3,65,
2716,0,67,3,64,
2717,0,68,4,64,
2718,0,68,3,65,
2719,0,67,3,64,
2720,0,67,3,64,
2721,0,69,4,65,
2722,0,68,3,65,
2723,0,67,3,64,
2724,0,70,5,65,
2725,0,69,4,65,
2726,0,69,3,66,
2727,0,69,3,66,
2728,0,69,4,65,
2729,0,70,4,66,
2730,0,69,3,66,
2731,0,68,3,65,
2732,0,71,4,67,
2733,0,70,3,67,
2734,0,71,4,67,
2735,0,72,4,68,
2736,0,70,3,67,
2737,0,72,5,67,
2738,0,70,3,67,
2739,0,70,4,66,
2740,0,71,4,67,
2741,0,70,3,67,
2742,0,70,3,67,
2743,0,72,4,68,
2744,0,70,3,67,
2745,0,71,4,67,
2746,0,74,5,69,
2747,0,71,3,68,
2748,0,71,3,68,
2749,0,71,4,67,
2750,0,71,3,68,
2751,0,72,3,69,
2752,0,72,4,68,
2753,0,73,4,69,
2754,0,73,4,69,
2755,0,71,3,68,
2756,0,73,4,69,
2757,0,72,3,69,
2758,0,72,4,68,
2759,0,74,4,70,
2760,0,72,3,69,
2761,0,72,3,69,
2762,0,75,4,71,
2763,0,73,3,70,
2764,0,73,3,70,
2765,0,73,4,69,
2766,0,73,3,70,
2767,0,73,3,70,
2768,0,74,5,69,
2769,0,75,5,70,
2770,0,73,3,70,
2771,0,73,4,69,
2772,0,74,4,70,
2773,0,73,3,70,
2774,0,73,4,69,
2775,0,75,4,71,
2776,0,73,3,70,
2777,0,72,3,69,
2778,0,73,4,69,
2779,0,72,3,69,
2780,0,73,4,69,
2781,0,68,4,64,
2782,0,60,3,57,
2783,0,54,3,51,
2784,0,49,4,45,
2785,0,43,3,40,
2786,0,44,4,40,
2787,0,43,3,40,
2788,0,41,3,38,
2789,0,38,4,34,
2790,0,32,3,29,
2791,0,27,3,24,
2792,0,23,3,20,
2793,0,21,4,17,
2794,0,15,3,12,
2795,0,14,4,10,
2796,0,16,4,12,
2797,0,17,3,14,
2798,0,21,3,18,
2799,0,28,4,24,
2800,0,29,3,26,
2801,0,33,4,29,
2802,0,31,3,28,
2803,0,30,3,27,
2804,0,32,4,28,
2805,0,31,3,28,
2806,0,33,4,29,
2807,0,32,3,29,
2808,0,32,3,29,
2809,0,34,4,30,
2810,0,33,3,30,
2811,0,32,3,29,
2812,0,36,4,32,
2813,0,34,3,31,
2814,0,35,4,31,
2815,0,35,4,31,
2816,0,34,3,31,
2817,0,36,4,32,
2818,0,35,3,32,
2819,0,37,4,33,
2820,0,36,3,33,
2821,0,35,3,32,
2822,0,37,4,33,
2823,0,36,3,33,
2824,0,36,3,33,
2825,0,38,4,34,
2826,0,37,4,33,
2827,0,37,3,34,
2828,0,39,4,35,
2829,0,37,3,34,
2830,0,39,4,35,
2831,0,38,4,34,
2832,0,39,3,36,
2833,0,39,3,36,
2834,0,40,4,36,
2835,0,38,3,35,
2836,0,40,4,36,
2837,0,39,3,36,
2838,0,42,4,38,
2839,0,40,3,37,
2840,0,39,3,36,
2841,0,43,4,39,
2842,0,41,3,38,
2843,0,40,3,37,
2844,0,43,4,39,
2845,0,41,3,38,
2846,0,43,4,39,
2847,0,42,3,39,
2848,0,42,4,38,
2849,0,44,4,40,
2850,0,42,3,39,
2851,0,42,3,39,
2852,0,44,4,40,
2853,0,43,3,40,
2854,0,42,3,39,
2855,0,43,4,39,
2856,0,45,4,41,
2857,0,44,3,41,
2858,0,45,4,41,
2859,0,45,4,41,
2860,0,47,5,42,
2861,0,43,3,40,
2862,0,47,4,43,
2863,0,45,3,42,
2864,0,44,3,41,
2865,0,47,5,42,
2866,0,44,3,41,
2867,0,47,4,43,
2868,0,46,3,43,
2869,0,45,3,42,
2870,0,48,4,44,
2871,0,46,3,43,
2872,0,45,3,42,
2873,0,49,4,45,
2874,0,47,3,44,
2875,0,47,3,44,
2876,0,48,4,44,
2877,0,48,4,44,
2878,0,48,3,45,
2879,0,47,3,44,
2880,0,48,4,44,
2881,0,49,4,45,
2882,0,48,3,45,
2883,0,48,3,45,
2884,0,50,4,46,
2885,0,48,3,45,
2886,0,51,4,47,
2887,0,49,3,46,
2888,0,48,3,45,
2889,0,49,4,45,
2890,0,50,3,47,
2891,0,49,3,46,
2892,0,54,6,48,
2893,0,50,3,47,
2894,0,49,3,46,
2895,0,53,5,48,
2896,0,51,3,48,
2897,0,50,3,47,
2898,0,53,4,49,
2899,0,51,3,48,
2900,0,51,3,48,
2901,0,52,4,48,
2902,0,51,3,48,
2903,0,52,3,49,
2904,0,52,4,48,
2905,0,52,3,49,
2906,0,52,4,48,
2907,0,46,1,45,
2908,0,35,,35,
2909,0,24,,24,
2910,0,26,3,23,
2911,0,23,3,20,
2912,0,34,4,30,
2913,0,41,3,38,
2914,0,49,3,46,
2915,0,56,4,52,
2916,0,54,3,51,
2917,0,53,3,50,
2918,0,56,4,52,
2919,0,54,4,50,
2920,0,56,4,52,
2921,0,56,5,51,
2922,0,55,3,52,
2923,0,55,3,52,
2924,0,54,3,51,
2925,0,56,5,51,
2926,0,55,4,51,
2927,0,55,3,52,
2928,0,58,4,54,
2929,0,56,3,53,
2930,0,55,3,52,
2931,0,58,4,54,
2932,0,56,3,53,
2933,0,56,3,53,
2934,0,57,4,53,
2935,0,57,3,54,
2936,0,57,3,54,
2937,0,56,3,53,
2938,0,58,4,54,
2939,0,57,3,54,
2940,0,56,3,53,
2941,0,60,5,55,
2942,0,57,3,54,
2943,0,59,4,55,
2944,0,58,3,55,
2945,0,57,3,54,
2946,0,60,4,56,
2947,0,58,3,55,
2948,0,57,3,54,
2949,0,61,4,57,
2950,0,59,3,56,
2951,0,59,4,55,
2952,0,61,4,57,
2953,0,60,4,56,
2954,0,58,3,55,
2955,0,61,4,57,
2956,0,61,4,57,
2957,0,61,4,57,
2958,0,60,4,56,
2959,0,60,3,57,
2960,0,60,3,57,
2961,0,59,3,56,
2962,0,61,4,57,
2963,0,60,3,57,
2964,0,60,3,57,
2965,0,63,4,59,
2966,0,61,3,58,
2967,0,60,3,57,
2968,0,63,4,59,
2969,0,61,3,58,
2970,0,61,3,58,
2971,0,62,5,57,
2972,0,62,3,59,
2973,0,62,3,59,
2974,0,61,3,58,
2975,0,63,4,59,
2976,0,62,3,59,
2977,0,63,4,59,
2978,0,62,3,59,
2979,0,61,3,58,
2980,0,64,4,60,
2981,0,63,3,60,
2982,0,62,3,59,
2983,0,65,4,61,
2984,0,63,3,60,
2985,0,62,3,59,
2986,0,65,5,60,
2987,0,63,3,60,
2988,0,65,4,61,
2989,0,64,3,61,
2990,0,63,3,60,
2991,0,65,4,61,
2992,0,64,4,60,
2993,0,64,3,61,
2994,0,64,3,61,
2995,0,63,3,60,
2996,0,66,4,62,
2997,0,65,3,62,
2998,0,64,3,61,
2999,0,67,4,63,
3000,0,65,3,62,
3001,0,65,4,61,
3002,0,68,5,63,
3003,0,65,3,62,
3004,0,65,3,62,
3005,0,66,4,62,
3006,0,66,3,63,
3007,0,67,4,63,
3008,0,66,4,62,
3009,0,68,5,63,
3010,0,68,5,63,
3011,0,65,3,62,
3012,0,68,4,64,
3013,0,69,5,64,
3014,0,66,3,63,
3015,0,68,4,64,
3016,0,68,5,63,
3017,0,67,3,64,
3018,0,67,4,63,
3019,0,67,3,64,
3020,0,67,3,64,
3021,0,67,4,63,
3022,0,69,4,65,
3023,0,68,3,65,
3024,0,67,3,64,
3025,0,69,4,65,
3026,0,68,3,65,
3027,0,67,3,64,
3028,0,70,4,66,
3029,0,67,3,64,
3030,0,69,4,65,
3031,0,71,4,67,
3032,0,68,3,65,
3033,0,70,4,66,
3034,0,69,3,66,
3035,0,68,3,65,
3036,0,71,4,67,
3037,0,69,3,66,
3038,0,68,3,65,
3039,0,71,4,67,
3040,0,70,3,67,
3041,0,69,3,66,
3042,0,71,4,67,
3043,0,74,7,67,
3044,0,74,7,67,
3045,0,73,6,67,
3046,0,74,7,67,
3047,0,73,6,67,
3048,0,74,7,67,
3049,0,76,7,69,
3050,0,74,6,68,
3051,0,75,7,68,
3052,0,75,7,68,
3053,0,74,6,68,
3054,0,75,7,68,
3055,0,74,6,68,
3056,0,75,7,68,
3057,0,75,7,68,
3058,0,75,7,68,
3059,0,76,7,69,
3060,0,75,6,69,
3061,0,76,7,69,
3062,0,76,7,69,
3063,0,75,6,69,
3064,0,76,7,69,
3065,0,76,7,69,
3066,0,74,5,69,
3067,0,75,7,68,
3068,0,76,6,70,
3069,0,77,7,70,
3070,0,76,6,70,
3071,0,77,7,70,
3072,0,77,7,70,
3073,0,76,6,70,
3074,0,77,7,70,
3075,0,77,7,70,
3076,0,76,6,70,
3077,0,77,7,70,
3078,0,76,6,70,
3079,0,77,7,70,
3080,0,78,7,71,
3081,0,76,6,70,
3082,0,77,7,70,
3083,0,77,7,70,
3084,0,76,6,70,
3085,0,76,7,69,
3086,0,76,6,70,
3087,0,77,7,70,
3088,0,75,6,69,
3089,0,70,7,63,
3090,0,64,7,57,
3091,0,57,6,51,
3092,0,52,7,45,
3093,0,50,7,43,
3094,0,49,6,43,
3095,0,49,7,42,
3096,0,46,6,40,
3097,0,43,7,36,
3098,0,36,4,32,
3099,0,32,7,25,
3100,0,28,6,22,
3101,0,26,7,19,
3102,0,22,6,16,
3103,0,21,7,14,
3104,0,22,6,16,
3105,0,25,6,19,
3106,0,32,4,28,
3107,0,30,3,27,
3108,0,29,3,26,
3109,0,32,4,28,
3110,0,31,3,28,
3111,0,31,3,28,
3112,0,31,4,27,
3113,0,32,3,29,
3114,0,32,3,29,
3115,0,31,3,28,
3116,0,34,4,30,
3117,0,33,3,30,
3118,0,32,3,29,
3119,0,35,4,31,
3120,0,34,3,31,
3121,0,33,3,30,
3122,0,36,4,32,
3123,0,34,3,31,
3124,0,36,4,32,
3125,0,35,3,32,
3126,0,34,3,31,
3127,0,37,4,33,
3128,0,35,3,32,
3129,0,37,4,33,
3130,0,36,3,33,
3131,0,37,4,33,
3132,0,40,5,35,
3133,0,37,3,34,
3134,0,36,3,33,
3135,0,39,4,35,
3136,0,38,3,35,
3137,0,37,3,34,
3138,0,39,5,34,
3139,0,38,3,35,
3140,0,39,3,36,
3141,0,38,3,35,
3142,0,40,4,36,
3143,0,39,3,36,
3144,0,38,3,35,
3145,0,42,4,38,
3146,0,40,3,37,
3147,0,39,3,36,
3148,0,42,4,38,
3149,0,41,3,38,
3150,0,40,3,37,
3151,0,42,4,38,
3152,0,40,3,37,
3153,0,41,4,37,
3154,0,42,4,38,
3155,0,42,3,39,
3156,0,42,3,39,
3157,0,42,4,38,
3158,0,41,3,38,
3159,0,44,5,39,
3160,0,42,3,39,
3161,0,44,4,40,
3162,0,43,4,39,
3163,0,44,4,40,
3164,0,45,4,41,
3165,0,44,4,40,
3166,0,45,4,41,
3167,0,44,3,41,
3168,0,43,3,40,
3169,0,46,4,42,
3170,0,45,3,42,
3171,0,44,3,41,
3172,0,47,4,43,
3173,0,45,3,42,
3174,0,44,3,41,
3175,0,46,4,42,
3176,0,47,4,43,
3177,0,46,3,43,
3178,0,45,3,42,
3179,0,47,4,43,
3180,0,46,3,43,
3181,0,46,3,43,
3182,0,49,4,45,
3183,0,47,3,44,
3184,0,46,3,43,
3185,0,49,4,45,
3186,0,48,3,45,
3187,0,47,3,44,
3188,0,49,4,45,
3189,0,49,4,45,
3190,0,49,4,45,
3191,0,48,4,44,
3192,0,49,4,45,
3193,0,51,4,47,
3194,0,49,3,46,
3195,0,50,4,46,
3196,0,49,3,46,
3197,0,48,3,45,
3198,0,50,4,46,
3199,0,49,3,46,
3200,0,50,4,46,
3201,0,52,4,48,
3202,0,50,3,47,
3203,0,50,3,47,
3204,0,50,4,46,
3205,0,51,3,48,
3206,0,51,3,48,
3207,0,51,4,47,
3208,0,52,4,48,
3209,0,51,3,48,
3210,0,50,3,47,
3211,0,53,4,49,
3212,0,52,3,49,
3213,0,53,4,49,
3214,0,52,3,49,
3215,0,52,4,48,
3216,0,53,4,49,
3217,0,55,4,51,
3218,0,53,3,50,
3219,0,55,4,51,
3220,0,53,3,50,
3221,0,53,4,49,
3222,0,55,5,50,
3223,0,53,3,50,
3224,0,53,3,50,
3225,0,56,4,52,
3226,0,54,3,51,
3227,0,54,3,51,
3228,0,54,4,50,
3229,0,54,3,51,
3230,0,54,3,51,
3231,0,56,5,51,
3232,0,56,4,52,
3233,0,55,3,52,
3234,0,54,3,51,
3235,0,56,4,52,
3236,0,55,3,52,
3237,0,54,3,51,
3238,0,58,4,54,
3239,0,56,3,53,
3240,0,55,3,52,
3241,0,58,4,54,
3242,0,56,3,53,
3243,0,58,4,54,
3244,0,56,3,53,
3245,0,56,3,53,
3246,0,58,4,54,
3247,0,58,4,54,
3248,0,56,3,53,
3249,0,58,5,53,
3250,0,57,3,54,
3251,0,57,3,54,
3252,0,57,3,54,
3253,0,60,5,55,
3254,0,58,3,55,
3255,0,57,3,54,
3256,0,60,4,56,
3257,0,58,3,55,
3258,0,57,3,54,
3259,0,62,5,57,
3260,0,59,3,56,
3261,0,58,3,55,
3262,0,61,4,57,
3263,0,59,3,56,
3264,0,58,3,55,
3265,0,61,4,57,
3266,0,59,3,56,
3267,0,60,3,57,
3268,0,60,4,56,
3269,0,60,3,57,
3270,0,60,3,57,
3271,0,59,3,56,
3272,0,61,4,57,
3273,0,61,4,57,
3274,0,59,3,56,
3275,0,63,4,59,
3276,0,61,3,58,
3277,0,61,4,57,
3278,0,63,4,59,
3279,0,61,3,58,
3280,0,63,4,59,
3281,0,61,3,58,
3282,0,60,3,57,
3283,0,65,5,60,
3284,0,62,3,59,
3285,0,61,3,58,
3286,0,63,4,59,
3287,0,61,3,58,
3288,0,63,4,59,
3289,0,62,3,59,
3290,0,62,4,58,
3291,0,65,4,61,
3292,0,62,3,59,
3293,0,64,4,60,
3294,0,63,3,60,
3295,0,62,3,59,
3296,0,65,4,61,
3297,0,63,3,60,
3298,0,63,4,59,
3299,0,66,4,62,
3300,0,64,3,61,
3301,0,63,3,60,
3302,0,66,4,62,
3303,0,64,3,61,
3304,0,66,5,61,
3305,0,64,4,60,
3306,0,64,3,61,
3307,0,66,4,62,
3308,0,65,4,61,
3309,0,66,4,62,
3310,0,65,3,62,
3311,0,64,3,61,
3312,0,66,4,62,
3313,0,66,4,62,
3314,0,66,4,62,
3315,0,65,3,62,
3316,0,65,3,62,
3317,0,66,4,62,
3318,0,68,4,64,
3319,0,65,3,62,
3320,0,67,4,63,
3321,0,66,4,62,
3322,0,67,4,63,
3323,0,66,3,63,
3324,0,66,3,63,
3325,0,68,4,64,
3326,0,67,3,64,
3327,0,66,3,63,
3328,0,69,4,65,
3329,0,67,3,64,
3330,0,66,3,63,
3331,0,69,4,65,
3332,0,67,3,64,
3333,0,68,3,65,
3334,0,69,4,65,
3335,0,69,4,65,
3336,0,70,4,66,
3337,0,68,3,65,
3338,0,68,4,64,
3339,0,70,4,66,
3340,0,68,3,65,
3341,0,67,3,64,
3342,0,69,4,65,
3343,0,69,3,66,
3344,0,69,3,66,
3345,0,70,5,65,
3346,0,68,3,65,
3347,0,69,4,65,
3348,0,68,3,65,
3349,0,70,4,66,
3350,0,70,4,66,
3351,0,69,3,66,
3352,0,72,4,68,
3353,0,71,4,67,
3354,0,69,3,66,
3355,0,72,4,68,
3356,0,70,3,67,
3357,0,70,3,67,
3358,0,70,4,66,
3359,0,70,3,67,
3360,0,71,3,68,
3361,0,70,3,67,
3362,0,72,4,68,
3363,0,71,3,68,
3364,0,72,4,68,
3365,0,73,4,69,
3366,0,71,3,68,
3367,0,70,3,67,
3368,0,73,5,68,
3369,0,72,4,68,
3370,0,74,4,70,
3371,0,72,3,69,
3372,0,71,3,68,
3373,0,74,4,70,
3374,0,73,4,69,
3375,0,71,3,68,
3376,0,73,4,69,
3377,0,71,3,68,
3378,0,73,4,69,
3379,0,73,3,70,
3380,0,74,4,70,
3381,0,73,3,70,
3382,0,74,5,69,
3383,0,73,3,70,
3384,0,73,3,70,
3385,0,72,3,69,
3386,0,74,4,70,
3387,0,73,3,70,
3388,0,72,3,69,
3389,0,75,4,71,
3390,0,73,3,70,
3391,0,72,3,69,
3392,0,75,4,71,
3393,0,73,3,70,
3394,0,73,3,70,
3395,0,73,4,69,
3396,0,73,3,70,
3397,0,73,3,70,
3398,0,73,4,69,
3399,0,73,4,69,
3400,0,66,3,63,
3401,0,59,3,56,
3402,0,55,4,51,
3403,0,48,4,44,
3404,0,45,4,41,
3405,0,47,4,43,
3406,0,45,4,41,
3407,0,41,3,38,
3408,0,39,4,35,
3409,0,31,2,29,
3410,0,26,3,23,
3411,0,24,4,20,
3412,0,19,3,16,
3413,0,15,3,12,
3414,0,15,4,11,
3415,0,14,3,11,
3416,0,19,4,15,
3417,0,24,3,21,
3418,0,28,3,25,
3419,0,32,4,28,
3420,0,30,3,27,
3421,0,30,3,27,
3422,0,33,4,29,
3423,0,31,3,28,
3424,0,32,3,29,
3425,0,33,4,29,
3426,0,33,4,29,
3427,0,33,3,30,
3428,0,33,4,29,
3429,0,34,4,30,
3430,0,33,3,30,
3431,0,33,3,30,
3432,0,35,4,31,
3433,0,34,3,31,
3434,0,35,4,31,
3435,0,35,3,32,
3436,0,36,4,32,
3437,0,34,3,31,
3438,0,38,5,33,
3439,0,36,3,33,
3440,0,35,3,32,
3441,0,37,4,33,
3442,0,35,3,32,
3443,0,39,4,35,
3444,0,37,3,34,
3445,0,38,4,34,
3446,0,37,3,34,
3447,0,37,3,34,
3448,0,40,4,36,
3449,0,38,4,34,
3450,0,38,3,35,
3451,0,39,3,36,
3452,0,38,3,35,
3453,0,40,4,36,
3454,0,39,3,36,
3455,0,39,4,35,
3456,0,42,5,37,
3457,0,40,3,37,
3458,0,39,3,36,
3459,0,42,4,38,
3460,0,41,3,38,
3461,0,40,3,37,
3462,0,43,4,39,
3463,0,41,3,38,
3464,0,42,4,38,
3465,0,43,5,38,
3466,0,43,4,39,
3467,0,43,4,39,
3468,0,41,3,38,
3469,0,43,4,39,
3470,0,43,3,40,
3471,0,43,4,39,
3472,0,45,4,41,
3473,0,44,4,40,
3474,0,42,3,39,
3475,0,44,4,40,
3476,0,44,3,41,
3477,0,43,3,40,
3478,0,44,4,40,
3479,0,45,4,41,
3480,0,46,5,41,
3481,0,45,3,42,
3482,0,44,3,41,
3483,0,46,4,42,
3484,0,44,3,41,
3485,0,47,4,43,
3486,0,46,4,42,
3487,0,45,3,42,
3488,0,48,4,44,
3489,0,46,3,43,
3490,0,45,3,42,
3491,0,46,4,42,
3492,0,46,3,43,
3493,0,49,4,45,
3494,0,47,3,44,
3495,0,46,3,43,
3496,0,48,4,44,
3497,0,47,3,44,
3498,0,51,5,46,
3499,0,48,3,45,
3500,0,48,4,44,
3501,0,51,5,46,
3502,0,48,3,45,
3503,0,48,3,45,
3504,0,51,4,47,
3505,0,49,3,46,
3506,0,52,5,47,
3507,0,49,3,46,
3508,0,48,3,45,
3509,0,52,4,48,
3510,0,50,3,47,
3511,0,49,3,46,
3512,0,50,4,46,
3513,0,50,3,47,
3514,0,50,3,47,
3515,0,50,3,47,
3516,0,52,4,48,
3517,0,51,3,48,
3518,0,50,3,47,
3519,0,53,4,49,
3520,0,51,3,48,
3521,0,51,4,47,
3522,0,54,4,50,
3523,0,52,3,49,
3524,0,51,3,48,
3525,0,53,4,49,
3526,0,51,3,48,
3527,0,54,4,50,
3528,0,52,3,49,
3529,0,54,4,50,
3530,0,53,3,50,
3531,0,52,3,49,
3532,0,55,4,51,
3533,0,53,3,50,
3534,0,52,3,49,
3535,0,56,4,52,
3536,0,54,3,51,
3537,0,55,4,51,
3538,0,54,3,51,
3539,0,53,3,50,
3540,0,56,4,52,
3541,0,54,3,51,
3542,0,54,3,51,
3543,0,57,4,53,
3544,0,55,3,52,
3545,0,54,3,51,
3546,0,55,4,51,
3547,0,54,3,51,
3548,0,56,4,52,
3549,0,56,3,53,
3550,0,55,3,52,
3551,0,58,4,54,
3552,0,55,3,52,
3553,0,57,4,53,
3554,0,56,3,53,
3555,0,57,4,53,
3556,0,58,4,54,
3557,0,57,4,53,
3558,0,57,3,54,
3559,0,57,3,54,
3560,0,58,4,54,
3561,0,56,3,53,
3562,0,57,4,53,
3563,0,59,4,55,
3564,0,60,4,56,
3565,0,57,3,54,
3566,0,59,4,55,
3567,0,58,3,55,
3568,0,57,3,54,
3569,0,60,4,56,
3570,0,59,3,56,
3571,0,58,3,55,
3572,0,61,4,57,
3573,0,59,3,56,
3574,0,58,3,55,
3575,0,61,4,57,
3576,0,60,4,56,
3577,0,59,3,56,
3578,0,60,4,56,
3579,0,60,3,57,
3580,0,60,3,57,
3581,0,60,4,56,
3582,0,62,5,57,
3583,0,61,4,57,
3584,0,59,3,56,
3585,0,62,4,58,
3586,0,62,4,58,
3587,0,61,4,57,
3588,0,62,4,58,
3589,0,62,4,58,
3590,0,61,3,58,
3591,0,61,4,57,
3592,0,60,3,57,
3593,0,64,4,60,
3594,0,62,3,59,
3595,0,61,3,58,
3596,0,62,4,58,
3597,0,62,3,59,
3598,0,61,3,58,
3599,0,62,4,58,
3600,0,63,4,59,
3601,0,62,3,59,
3602,0,62,3,59,
3603,0,64,4,60,
3604,0,63,3,60,
3605,0,62,3,59,
3606,0,65,4,61,
3607,0,63,3,60,
3608,0,62,3,59,
3609,0,65,4,61,
3610,0,64,3,61,
3611,0,63,3,60,
3612,0,65,4,61,
3613,0,65,4,61,
3614,0,64,3,61,
3615,0,64,4,60,
3616,0,63,3,60,
3617,0,66,4,62,
3618,0,65,3,62,
3619,0,66,4,62,
3620,0,65,3,62,
3621,0,64,3,61,
3622,0,67,5,62,
3623,0,64,3,61,
3624,0,66,4,62,
3625,0,65,3,62,
3626,0,64,3,61,
3627,0,68,4,64,
3628,0,67,5,62,
3629,0,66,3,63,
3630,0,66,3,63,
3631,0,65,3,62,
3632,0,67,4,63,
3633,0,66,3,63,
3634,0,65,3,62,
3635,0,69,4,65,
3636,0,58,,58,
3637,0,46,,46,
3638,0,34,,34,
3639,0,21,,21,
3640,0,10,,10,
