window-id,queue-size-CL,queue-size-LL,10.0.0.13:41195 -> 10.0.1.13:3000,10.0.1.13:3000 -> 10.0.0.13:41195,10.0.0.13:56686 -> 10.0.1.13:1000
0,0,27,7,20,
1,0,35,5,30,
2,0,35,4,31,
3,0,28,3,25,
4,0,26,4,22,
5,0,23,3,20,
6,0,25,5,20,
7,0,23,4,19,
8,0,19,3,16,
9,0,16,3,13,
10,0,17,6,11,
11,0,18,7,11,
12,0,22,7,15,
13,0,24,7,17,
14,0,23,7,16,
15,0,19,6,13,
16,0,21,7,14,
17,0,20,6,14,
18,0,22,7,15,
19,0,23,7,16,
20,0,18,6,12,
21,0,20,7,13,
22,0,20,7,13,
23,0,19,6,13,
24,0,19,6,13,
25,0,19,6,13,
26,0,21,7,14,
27,0,21,7,14,
28,0,19,6,13,
29,0,18,5,13,
30,0,18,7,11,
31,0,18,7,11,
32,0,19,6,13,
33,0,21,7,14,
34,0,20,6,14,
35,0,22,7,15,
36,0,23,7,16,
37,0,19,6,13,
38,0,18,5,13,
39,0,21,8,13,
40,0,17,5,12,
41,0,20,7,13,
42,0,17,6,11,
43,0,19,7,12,
44,0,19,7,12,
45,0,20,6,14,
46,0,22,7,15,
47,0,21,6,15,
48,0,20,7,13,
49,0,21,7,14,
50,0,19,5,14,
51,0,18,6,12,
52,0,18,6,12,
53,0,19,6,13,
54,0,21,7,14,
55,0,20,6,14,
56,0,22,7,15,
57,0,22,7,15,
58,0,20,6,14,
59,0,19,6,13,
60,0,19,7,12,
61,0,18,6,12,
62,0,19,7,12,
63,0,20,6,14,
64,0,21,7,14,
65,0,19,6,13,
66,0,20,8,12,
67,0,21,7,14,
68,0,20,6,14,
69,0,22,7,15,
70,0,21,7,14,
71,0,18,6,12,
72,0,20,7,13,
73,0,20,6,14,
74,0,21,7,14,
75,0,19,7,12,
76,0,19,5,14,
77,0,17,6,11,
78,0,19,7,12,
79,0,19,7,12,
80,0,20,6,14,
81,0,22,7,15,
82,0,21,6,15,
83,0,22,7,15,
84,0,21,7,14,
85,0,19,5,14,
86,0,18,6,12,
87,0,19,6,13,
88,0,18,6,12,
89,0,19,7,12,
90,0,19,6,13,
91,0,21,7,14,
92,0,22,8,14,
93,0,20,5,15,
94,0,22,7,15,
95,0,18,6,12,
96,0,20,7,13,
97,0,21,7,14,
98,0,17,6,11,
99,0,20,7,13,
100,0,20,7,13,
101,0,20,6,14,
102,0,22,7,15,
103,0,21,6,15,
104,0,22,7,15,
105,0,21,7,14,
106,0,19,5,14,
107,0,17,6,11,
108,0,19,7,12,
109,0,19,7,12,
110,0,21,7,14,
111,0,21,7,14,
112,0,18,6,12,
113,0,20,7,13,
114,0,20,7,13,
115,0,20,6,14,
116,0,22,7,15,
117,0,21,7,14,
118,0,20,7,13,
119,0,18,5,13,
120,0,21,7,14,
121,0,19,7,12,
122,0,20,7,13,
123,0,18,5,13,
124,0,18,7,11,
125,0,19,7,12,
126,0,20,6,14,
127,0,20,7,13,
128,0,21,6,15,
129,0,22,7,15,
130,0,21,7,14,
131,0,21,7,14,
132,0,20,6,14,
133,0,17,6,11,
134,0,20,7,13,
135,0,19,7,12,
136,0,20,6,14,
137,0,22,7,15,
138,0,22,7,15,
139,0,22,7,15,
140,0,20,7,13,
141,0,19,5,14,
142,0,17,6,11,
143,0,19,7,12,
144,0,19,7,12,
145,0,22,7,15,
146,0,22,7,15,
147,0,18,5,13,
148,0,18,7,11,
149,0,19,6,13,
150,0,21,7,14,
151,0,21,6,15,
152,0,21,7,14,
153,0,20,7,13,
154,0,19,5,14,
155,0,20,6,14,
156,0,19,7,12,
157,0,18,6,12,
158,0,19,6,13,
159,0,21,7,14,
160,0,20,6,14,
161,0,20,7,13,
162,0,20,7,13,
163,0,19,5,14,
164,0,20,6,14,
165,0,22,7,15,
166,0,20,7,13,
167,0,19,6,13,
168,0,19,6,13,
169,0,20,7,13,
170,0,18,6,12,
171,0,19,6,13,
172,0,18,6,12,
173,0,19,7,12,
174,0,19,6,13,
175,0,21,7,14,
176,0,20,6,14,
177,0,22,7,15,
178,0,21,7,14,
179,0,19,6,13,
180,0,19,6,13,
181,0,19,6,13,
182,0,19,7,12,
183,0,18,5,13,
184,0,21,7,14,
185,0,20,6,14,
186,0,22,7,15,
187,0,23,7,16,
188,0,19,6,13,
189,0,20,7,13,
190,0,20,7,13,
191,0,17,6,11,
192,0,18,7,11,
193,0,19,6,13,
194,0,21,7,14,
195,0,21,6,15,
196,0,19,7,12,
197,0,20,7,13,
198,0,21,7,14,
199,0,21,7,14,
200,0,21,7,14,
201,0,20,6,14,
202,0,20,7,13,
203,0,19,5,14,
204,0,23,8,15,
205,0,18,5,13,
206,0,18,6,12,
207,0,20,7,13,
208,0,20,6,14,
209,0,21,7,14,
210,0,20,7,13,
211,0,17,6,11,
212,0,20,7,13,
213,0,20,7,13,
214,0,21,6,15,
215,0,22,7,15,
216,0,18,6,12,
217,0,19,7,12,
218,0,11,6,5,
228,0,20,6,14,
229,0,19,7,12,
230,0,19,6,13,
231,0,18,7,11,
232,0,19,7,12,
233,0,19,6,13,
234,0,21,7,14,
235,0,20,7,13,
236,0,21,6,15,
237,0,22,7,15,
238,0,18,6,12,
239,0,20,7,13,
240,0,19,7,12,
241,0,20,7,13,
242,0,18,5,13,
243,0,21,7,14,
244,0,20,7,13,
245,0,22,7,15,
246,0,23,7,16,
247,0,20,7,13,
248,0,18,6,12,
249,0,21,7,14,
250,0,19,7,12,
251,0,19,6,13,
252,0,20,7,13,
253,0,22,7,15,
254,0,21,6,15,
255,0,19,7,12,
256,0,20,7,13,
257,0,20,6,14,
258,0,20,7,13,
259,0,21,6,15,
260,0,20,7,13,
261,0,18,5,13,
262,0,19,7,12,
263,0,20,6,14,
264,0,19,7,12,
265,0,17,5,12,
266,0,20,7,13,
267,0,21,7,14,
268,0,21,6,15,
269,0,20,7,13,
270,0,18,5,13,
271,0,19,7,12,
272,0,20,6,14,
273,0,24,8,16,
274,0,17,5,12,
275,0,20,7,13,
276,0,20,7,13,
277,0,20,6,14,
278,0,18,7,11,
279,0,18,7,11,
280,0,19,6,13,
281,0,21,7,14,
282,0,21,6,15,
283,0,19,7,12,
284,0,19,7,12,
285,0,19,6,13,
286,0,21,7,14,
287,0,22,7,15,
288,0,20,6,14,
289,0,21,7,14,
290,0,21,6,15,
291,0,19,5,14,
292,0,18,7,11,
293,0,20,7,13,
294,0,19,6,13,
295,0,21,7,14,
296,0,21,7,14,
297,0,19,6,13,
298,0,18,6,12,
299,0,19,6,13,
300,0,21,7,14,
301,0,22,7,15,
302,0,19,6,13,
303,0,18,6,12,
304,0,20,6,14,
305,0,20,7,13,
306,0,18,6,12,
307,0,19,6,13,
308,0,19,6,13,
309,0,21,7,14,
310,0,22,7,15,
311,0,19,6,13,
312,0,18,5,13,
313,0,19,7,12,
314,0,19,7,12,
315,0,19,6,13,
316,0,21,7,14,
317,0,20,7,13,
318,0,21,6,15,
319,0,23,7,16,
320,0,19,6,13,
321,0,20,6,14,
322,0,20,6,14,
323,0,19,7,12,
324,0,19,6,13,
325,0,20,7,13,
326,0,20,7,13,
327,0,21,6,15,
328,0,19,7,12,
329,0,19,6,13,
330,0,21,7,14,
331,0,22,8,14,
332,0,21,6,15,
333,0,20,7,13,
334,0,18,6,12,
335,0,20,6,14,
336,0,19,5,14,
337,0,19,7,12,
338,0,18,5,13,
339,0,18,6,12,
340,0,21,7,14,
341,0,22,7,15,
342,0,18,6,12,
343,0,20,7,13,
344,0,19,7,12,
345,0,20,6,14,
346,0,22,7,15,
347,0,19,7,12,
348,0,19,6,13,
349,0,19,6,13,
350,0,21,7,14,
351,0,18,7,11,
352,0,18,6,12,
353,0,19,7,12,
354,0,20,6,14,
355,0,22,7,15,
356,0,18,6,12,
357,0,18,6,12,
358,0,20,7,13,
359,0,20,6,14,
360,0,20,7,13,
361,0,18,5,13,
362,0,21,7,14,
363,0,20,6,14,
364,0,22,7,15,
365,0,19,7,12,
366,0,18,5,13,
367,0,19,7,12,
368,0,17,5,12,
369,0,21,7,14,
370,0,20,7,13,
371,0,20,6,14,
372,0,22,7,15,
373,0,22,6,16,
374,0,20,7,13,
375,0,19,6,13,
376,0,19,6,13,
377,0,19,7,12,
378,0,19,7,12,
379,0,19,6,13,
380,0,21,7,14,
381,0,20,6,14,
382,0,19,7,12,
383,0,20,7,13,
384,0,20,6,14,
385,0,22,7,15,
386,0,22,7,15,
387,0,19,6,13,
388,0,18,5,13,
389,0,20,7,13,
390,0,20,6,14,
391,0,21,8,13,
392,0,18,5,13,
393,0,18,7,11,
394,0,18,6,12,
395,0,20,7,13,
396,0,21,7,14,
397,0,20,6,14,
398,0,22,7,15,
399,0,22,7,15,
400,0,20,6,14,
401,0,18,6,12,
402,0,18,6,12,
403,0,19,7,12,
404,0,19,7,12,
405,0,22,8,14,
406,0,21,7,14,
407,0,19,6,13,
408,0,19,7,12,
409,0,19,7,12,
410,0,20,6,14,
411,0,21,7,14,
412,0,21,7,14,
413,0,19,7,12,
414,0,20,7,13,
415,0,20,6,14,
416,0,21,7,14,
417,0,20,6,14,
418,0,18,5,13,
419,0,17,6,11,
420,0,19,7,12,
421,0,19,6,13,
422,0,21,7,14,
423,0,22,7,15,
424,0,21,6,15,
425,0,21,7,14,
426,0,20,7,13,
427,0,18,5,13,
428,0,19,7,12,
429,0,17,5,12,
430,0,19,7,12,
431,0,20,6,14,
432,0,21,7,14,
433,0,21,6,15,
434,0,23,7,16,
435,0,18,7,11,
436,0,19,6,13,
437,0,20,7,13,
438,0,18,6,12,
439,0,20,7,13,
440,0,21,7,14,
441,0,20,6,14,
442,0,21,7,14,
443,0,18,7,11,
444,0,20,7,13,
445,0,21,7,14,
446,0,20,6,14,
447,0,22,7,15,
448,0,19,7,12,
449,0,19,6,13,
450,0,20,7,13,
451,0,21,7,14,
452,0,18,6,12,
453,0,20,7,13,
454,0,17,6,11,
455,0,19,7,12,
456,0,19,7,12,
457,0,20,6,14,
458,0,21,7,14,
459,0,21,6,15,
460,0,23,7,16,
461,0,20,7,13,
462,0,18,5,13,
463,0,20,7,13,
464,0,18,7,11,
465,0,19,6,13,
466,0,21,7,14,
467,0,20,6,14,
468,0,22,7,15,
469,0,22,7,15,
470,0,18,6,12,
471,0,20,7,13,
472,0,19,6,13,
473,0,19,7,12,
474,0,18,6,12,
475,0,19,6,13,
476,0,21,7,14,
477,0,21,7,14,
478,0,19,6,13,
479,0,18,5,13,
480,0,19,7,12,
481,0,18,6,12,
482,0,20,6,14,
483,0,20,6,14,
484,0,21,7,14,
485,0,22,7,15,
486,0,22,6,16,
487,0,20,7,13,
488,0,19,5,14,
489,0,20,6,14,
490,0,20,7,13,
491,0,18,5,13,
492,0,18,7,11,
493,0,18,6,12,
494,0,20,7,13,
495,0,21,7,14,
496,0,20,6,14,
497,0,22,7,15,
498,0,23,8,15,
499,0,21,6,15,
500,0,19,5,14,
501,0,18,6,12,
502,0,19,6,13,
503,0,19,6,13,
504,0,21,7,14,
505,0,20,6,14,
506,0,19,7,12,
507,0,17,6,11,
508,0,18,6,12,
509,0,18,6,12,
510,0,20,7,13,
511,0,20,7,13,
512,0,20,6,14,
513,0,22,7,15,
514,0,21,6,15,
515,0,20,7,13,
516,0,19,6,13,
517,0,19,6,13,
518,0,18,7,11,
519,0,20,7,13,
520,0,20,6,14,
521,0,21,7,14,
522,0,21,6,15,
523,0,19,7,12,
524,0,19,7,12,
525,0,19,6,13,
526,0,21,7,14,
527,0,21,6,15,
528,0,20,7,13,
529,0,19,6,13,
530,0,20,6,14,
531,0,20,6,14,
532,0,19,7,12,
533,0,17,5,12,
534,0,18,7,11,
535,0,18,6,12,
536,0,20,7,13,
537,0,20,7,13,
538,0,20,6,14,
539,0,22,7,15,
540,0,22,6,16,
541,0,20,7,13,
542,0,19,6,13,
543,0,20,6,14,
544,0,19,7,12,
545,0,19,7,12,
546,0,20,6,14,
547,0,21,7,14,
548,0,21,6,15,
549,0,23,7,16,
550,0,19,7,12,
551,0,19,6,13,
552,0,21,8,13,
553,0,19,7,12,
554,0,17,5,12,
555,0,20,7,13,
556,0,20,6,14,
557,0,22,7,15,
558,0,18,7,11,
559,0,19,5,14,
560,0,19,6,13,
561,0,20,7,13,
562,0,18,5,13,
563,0,21,7,14,
564,0,20,6,14,
565,0,20,7,13,
566,0,19,7,12,
567,0,19,5,14,
568,0,17,6,11,
569,0,20,7,13,
570,0,20,7,13,
571,0,20,6,14,
572,0,22,7,15,
573,0,22,7,15,
574,0,21,7,14,
575,0,20,7,13,
576,0,18,5,13,
577,0,18,7,11,
578,0,18,6,12,
579,0,20,7,13,
580,0,21,7,14,
581,0,20,6,14,
582,0,22,7,15,
583,0,22,7,15,
584,0,18,6,12,
585,0,20,7,13,
586,0,19,6,13,
587,0,20,7,13,
588,0,18,5,13,
589,0,18,7,11,
590,0,18,6,12,
591,0,21,7,14,
592,0,20,7,13,
593,0,21,6,15,
594,0,22,7,15,
595,0,20,6,14,
596,0,21,7,14,
597,0,19,6,13,
598,0,17,6,11,
599,0,19,7,12,
600,0,19,7,12,
601,0,20,6,14,
602,0,23,8,15,
603,0,21,6,15,
604,0,22,7,15,
605,0,19,7,12,
606,0,20,6,14,
607,0,19,7,12,
608,0,19,7,12,
609,0,19,7,12,
610,0,20,6,14,
611,0,21,7,14,
612,0,19,6,13,
613,0,19,7,12,
614,0,20,7,13,
615,0,20,6,14,
616,0,22,7,15,
617,0,21,7,14,
618,0,20,7,13,
619,0,18,5,13,
620,0,21,7,14,
621,0,21,7,14,
622,0,19,6,13,
623,0,18,5,13,
624,0,18,7,11,
625,0,18,6,12,
626,0,20,7,13,
627,0,20,7,13,
628,0,21,6,15,
629,0,22,7,15,
630,0,20,6,14,
631,0,17,4,13,
632,0,16,4,12,
633,0,14,3,11,
634,0,14,3,11,
635,0,15,3,12,
636,0,15,4,11,
637,0,17,4,13,
638,0,16,3,13,
639,0,16,3,13,
640,0,18,4,14,
641,0,16,3,13,
642,0,17,4,13,
643,0,16,3,13,
644,0,15,3,12,
645,0,19,4,15,
646,0,18,4,14,
647,0,15,3,12,
648,0,15,4,11,
649,0,16,3,13,
650,0,17,3,14,
651,0,14,3,11,
652,0,16,4,12,
653,0,16,3,13,
654,0,16,3,13,
655,0,19,4,15,
656,0,17,3,14,
657,0,14,3,11,
658,0,17,4,13,
659,0,16,3,13,
660,0,16,3,13,
661,0,18,4,14,
662,0,16,4,12,
663,0,15,3,12,
664,0,16,4,12,
665,0,15,3,12,
666,0,18,4,14,
667,0,17,3,14,
668,0,16,3,13,
669,0,19,4,15,
670,0,15,3,12,
671,0,15,3,12,
672,0,14,4,10,
673,0,15,4,11,
674,0,15,3,12,
675,0,16,3,13,
676,0,18,4,14,
677,0,15,3,12,
678,0,15,3,12,
679,0,18,4,14,
680,0,17,3,14,
681,0,16,3,13,
682,0,17,4,13,
683,0,16,3,13,
684,0,15,3,12,
685,0,17,4,13,
686,0,15,3,12,
687,0,14,3,11,
688,0,16,4,12,
689,0,15,3,12,
690,0,17,4,13,
691,0,17,4,13,
692,0,18,4,14,
693,0,20,4,16,
694,0,18,3,15,
695,0,15,3,12,
696,0,17,5,12,
697,0,17,3,14,
698,0,17,3,14,
699,0,15,4,11,
700,0,17,5,12,
701,0,18,4,14,
702,0,17,3,14,
703,0,17,4,13,
704,0,17,3,14,
705,0,17,3,14,
706,0,16,3,13,
707,0,17,4,13,
708,0,15,3,12,
709,0,15,3,12,
710,0,15,3,12,
711,0,16,4,12,
712,0,16,3,13,
713,0,16,3,13,
714,0,19,4,15,
715,0,15,3,12,
716,0,14,3,11,
717,0,18,4,14,
718,0,17,3,14,
719,0,17,3,14,
720,0,15,4,11,
721,0,16,3,13,
722,0,18,4,14,
723,0,17,3,14,
724,0,17,3,14,
725,0,16,3,13,
726,0,16,4,12,
727,0,15,4,11,
728,0,17,4,13,
729,0,17,3,14,
730,0,16,3,13,
731,0,17,5,12,
732,0,17,5,12,
733,0,16,4,12,
734,0,19,4,15,
735,0,17,3,14,
736,0,14,3,11,
737,0,17,4,13,
738,0,15,3,12,
739,0,19,4,15,
740,0,15,3,12,
741,0,14,3,11,
742,0,16,4,12,
743,0,17,3,14,
744,0,14,3,11,
745,0,16,4,12,
746,0,15,4,11,
747,0,15,3,12,
748,0,15,3,12,
749,0,18,4,14,
750,0,16,3,13,
751,0,16,4,12,
752,0,18,4,14,
753,0,17,3,14,
754,0,16,3,13,
755,0,17,4,13,
756,0,16,3,13,
757,0,15,3,12,
758,0,19,4,15,
759,0,17,3,14,
760,0,15,3,12,
761,0,17,4,13,
762,0,15,3,12,
763,0,19,4,15,
764,0,17,3,14,
765,0,14,3,11,
766,0,17,4,13,
767,0,15,3,12,
768,0,18,4,14,
769,0,17,3,14,
770,0,14,3,11,
771,0,18,4,14,
772,0,14,3,11,
773,0,14,3,11,
774,0,18,4,14,
775,0,17,3,14,
776,0,16,3,13,
777,0,19,4,15,
778,0,15,3,12,
779,0,16,3,13,
780,0,17,4,13,
781,0,17,3,14,
782,0,18,3,15,
783,0,16,4,12,
784,0,15,3,12,
785,0,16,4,12,
786,0,17,3,14,
787,0,14,3,11,
788,0,17,4,13,
789,0,17,4,13,
790,0,17,4,13,
791,0,16,4,12,
792,0,20,7,13,
793,0,17,6,11,
794,0,20,7,13,
795,0,20,7,13,
796,0,21,7,14,
797,0,21,7,14,
798,0,21,6,15,
799,0,21,7,14,
800,0,20,6,14,
801,0,19,6,13,
802,0,18,7,11,
803,0,18,6,12,
804,0,20,7,13,
805,0,20,7,13,
806,0,20,6,14,
807,0,22,7,15,
808,0,22,6,16,
809,0,20,7,13,
810,0,18,5,13,
811,0,19,7,12,
812,0,19,6,13,
813,0,19,6,13,
814,0,19,7,12,
815,0,20,6,14,
816,0,20,7,13,
817,0,19,6,13,
818,0,19,6,13,
819,0,19,7,12,
820,0,17,5,12,
821,0,20,7,13,
822,0,20,7,13,
823,0,20,6,14,
824,0,18,7,11,
825,0,18,5,13,
826,0,19,7,12,
827,0,18,7,11,
828,0,19,6,13,
829,0,21,7,14,
830,0,20,6,14,
831,0,22,7,15,
832,0,23,7,16,
833,0,19,6,13,
834,0,19,6,13,
835,0,20,8,12,
836,0,17,6,11,
837,0,20,7,13,
838,0,19,6,13,
839,0,21,7,14,
840,0,23,7,16,
841,0,18,6,12,
842,0,20,7,13,
843,0,20,7,13,
844,0,20,6,14,
845,0,21,7,14,
846,0,19,6,13,
847,0,19,6,13,
848,0,20,6,14,
849,0,20,7,13,
850,0,18,6,12,
851,0,17,5,12,
852,0,18,7,11,
853,0,18,7,11,
854,0,19,6,13,
855,0,21,7,14,
856,0,20,7,13,
857,0,22,7,15,
858,0,22,7,15,
859,0,19,6,13,
860,0,20,6,14,
861,0,20,7,13,
862,0,19,7,12,
863,0,20,7,13,
864,0,20,6,14,
865,0,21,7,14,
866,0,21,7,14,
867,0,22,6,16,
868,0,19,7,12,
869,0,19,6,13,
870,0,21,7,14,
871,0,19,7,12,
872,0,19,5,14,
873,0,20,6,14,
874,0,21,7,14,
875,0,21,7,14,
876,0,19,6,13,
877,0,19,6,13,
878,0,18,6,12,
879,0,18,6,12,
880,0,20,7,13,
881,0,19,6,13,
882,0,21,7,14,
883,0,19,7,12,
884,0,19,6,13,
885,0,18,5,13,
886,0,13,3,10,
887,0,17,5,12,
888,0,20,6,14,
889,0,20,6,14,
890,0,20,5,15,
891,0,20,5,15,
892,0,16,5,11,
893,0,19,6,13,
894,0,20,6,14,
895,0,21,6,15,
896,0,16,5,11,
897,0,19,6,13,
898,0,19,6,13,
899,0,20,6,14,
900,0,21,6,15,
901,0,17,6,11,
902,0,20,7,13,
903,0,20,7,13,
904,0,20,7,13,
905,0,21,6,15,
906,0,20,7,13,
907,0,19,6,13,
908,0,21,7,13,1
909,0,20,6,14,
910,0,19,7,12,
911,0,17,5,12,
912,0,20,7,13,
913,0,20,7,13,
914,0,20,6,14,
915,0,20,7,13,
916,0,20,6,13,1
917,0,19,6,13,
918,0,20,6,14,
919,0,22,7,15,
920,0,20,6,14,
921,0,20,7,13,
922,0,19,6,13,
923,0,21,6,14,1
924,0,19,7,12,
925,0,18,5,13,
926,0,18,7,11,
927,0,18,6,12,
928,0,20,7,13,
929,0,20,6,14,
930,0,21,7,14,
931,0,22,7,15,
932,0,22,6,16,
933,0,20,7,13,
934,0,18,6,12,
935,0,20,6,14,
936,0,19,7,12,
937,0,19,6,13,
938,0,22,7,14,1
939,0,22,7,15,
940,0,21,6,15,
941,0,23,7,16,
942,0,20,7,13,
943,0,19,6,13,
944,0,19,7,12,
945,0,18,6,12,
946,0,18,6,12,
947,0,19,6,13,
948,0,21,7,14,
949,0,22,7,15,
950,0,18,6,12,
951,0,20,6,14,
952,0,19,6,13,
953,0,19,7,12,
954,0,21,7,13,1
955,0,21,7,14,
956,0,21,7,14,
957,0,21,6,15,
958,0,23,7,16,
959,0,19,7,12,
960,0,20,7,13,
961,0,19,7,12,
962,0,18,6,12,
963,0,17,5,12,
964,0,18,7,11,
965,0,18,7,11,
966,0,19,6,13,
967,0,21,7,14,
968,0,20,6,14,
969,0,22,7,15,
970,0,22,7,15,
971,0,19,6,13,
972,0,19,6,13,
973,0,21,7,14,
974,0,19,6,13,
975,0,18,5,13,
976,0,21,7,14,
977,0,20,6,14,
978,0,22,7,15,
979,0,23,7,16,
980,0,18,6,12,
981,0,20,7,13,
982,0,20,7,13,
983,0,18,6,12,
984,0,21,7,13,1
985,0,20,6,14,
986,0,21,7,14,
987,0,22,7,15,
988,0,21,6,15,
989,0,21,7,14,
990,0,21,7,14,
991,0,18,5,13,
992,0,18,6,12,
993,0,18,6,12,
994,0,19,6,13,
995,0,21,7,14,
996,0,21,7,14,
997,0,18,6,12,
998,0,19,6,13,
999,0,20,7,13,
1000,0,19,6,13,
1001,0,19,6,13,
1002,0,19,6,13,
1003,0,21,7,14,
1004,0,23,7,16,
1005,0,19,6,13,
1006,0,19,6,13,
1007,0,20,7,13,
1008,0,20,6,14,
1009,0,22,8,14,
1010,0,18,6,12,
1011,0,20,7,13,
1012,0,20,7,13,
1013,0,21,7,14,
1014,0,20,7,12,1
1015,0,19,6,13,
1016,0,18,7,11,
1017,0,18,7,11,
1018,0,19,6,13,
1019,0,21,7,14,
1020,0,20,7,13,
1021,0,22,7,15,
1022,0,21,7,14,
1023,0,20,6,14,
1024,0,19,6,13,
1025,0,21,7,14,
1026,0,21,7,14,
1027,0,19,6,13,
1028,0,18,5,13,
1029,0,21,7,14,
1030,0,18,7,11,
1031,0,17,5,12,
1032,0,19,6,13,
1033,0,21,7,14,
1034,0,20,7,13,
1035,0,21,6,15,
1036,0,23,7,16,
1037,0,19,6,13,
1038,0,19,6,13,
1039,0,20,7,13,
1040,0,18,6,12,
1041,0,20,7,13,
1042,0,19,6,13,
1043,0,21,7,14,
1044,0,21,7,14,
1045,0,19,6,12,1
1046,0,20,7,13,
1047,0,20,7,13,
1048,0,20,6,14,
1049,0,22,7,15,
1050,0,19,6,13,
1051,0,20,6,14,
1052,0,19,6,13,
1053,0,21,7,14,
1054,0,18,6,12,
1055,0,19,6,13,
1056,0,19,7,12,
1057,0,20,6,14,
1058,0,22,7,15,
1059,0,19,6,13,
1060,0,18,6,12,
1061,0,19,6,13,
1062,0,21,7,14,
1063,0,21,6,15,
1064,0,20,7,13,
1065,0,18,6,12,
1066,0,19,6,13,
1067,0,21,7,14,
1068,0,19,7,12,
1069,0,19,6,13,
1070,0,20,7,13,
1071,0,20,6,14,
1072,0,22,7,15,
1073,0,19,7,12,
1074,0,19,5,14,
1075,0,19,6,12,1
1076,0,18,6,12,
1077,0,19,7,12,
1078,0,21,7,14,
1079,0,21,7,14,
1080,0,21,6,15,
1081,0,23,7,16,
1082,0,21,7,14,
1083,0,18,5,13,
1084,0,19,7,12,
1085,0,18,7,11,
1086,0,20,7,13,
1087,0,19,7,12,
1088,0,20,6,14,
1089,0,20,7,13,
1090,0,18,6,12,
1091,0,20,7,13,
1092,0,21,7,14,
1093,0,21,6,15,
1094,0,22,7,15,
1095,0,19,7,12,
1096,0,19,5,14,
1097,0,19,6,13,
1098,0,21,7,14,
1099,0,19,7,12,
1100,0,19,5,14,
1101,0,17,6,11,
1102,0,19,7,12,
1103,0,20,7,13,
1104,0,20,6,14,
1105,0,23,7,15,1
1106,0,22,7,15,
1107,0,22,7,15,
1108,0,19,6,13,
1109,0,17,4,13,
1110,0,14,3,11,
1111,0,17,4,13,
1112,0,16,3,13,
1113,0,17,4,13,
1114,0,16,4,12,
1115,0,19,6,13,
1116,0,16,6,10,
1117,0,15,3,12,
1118,0,15,3,12,
1119,0,19,4,15,
1120,0,15,3,12,
1121,0,16,4,12,
1122,0,16,3,13,
1123,0,18,4,14,
1124,0,17,3,14,
1125,0,15,4,11,
1126,0,16,3,13,
1127,0,17,3,14,
1128,0,17,4,13,
1129,0,18,4,14,
1130,0,15,3,12,
1131,0,16,4,12,
1132,0,15,4,11,
1133,0,15,3,12,
1134,0,15,3,12,
1135,0,19,4,15,
1136,0,18,3,14,1
1137,0,16,3,13,
1138,0,17,4,13,
1139,0,17,4,13,
1140,0,17,3,14,
1141,0,15,4,11,
1142,0,15,3,12,
1143,0,14,3,11,
1144,0,14,3,11,
1145,0,18,5,13,
1146,0,17,3,14,
1147,0,17,3,14,
1148,0,17,4,13,
1149,0,17,3,14,
1150,0,17,4,13,
1151,0,17,4,13,
1152,0,16,4,12,
1153,0,15,3,12,
1154,0,15,3,12,
1155,0,19,6,13,
1156,0,16,3,13,
1157,0,16,3,13,
1158,0,16,5,11,
1159,0,14,3,11,
1160,0,19,4,15,
1161,0,17,5,12,
1162,0,15,3,12,
1163,0,17,4,13,
1164,0,13,3,10,
1165,0,17,4,13,
1166,0,18,3,14,1
1167,0,16,3,13,
1168,0,16,4,12,
1169,0,16,3,13,
1170,0,15,3,12,
1171,0,19,4,15,
1172,0,17,3,14,
1173,0,15,3,12,
1174,0,18,4,14,
1175,0,16,3,13,
1176,0,16,3,13,
1177,0,18,4,14,
1178,0,14,3,11,
1179,0,17,4,13,
1180,0,16,3,13,
1181,0,16,3,13,
1182,0,19,4,15,
1183,0,15,3,12,
1184,0,16,3,13,
1185,0,16,5,11,
1186,0,16,4,12,
1187,0,14,4,10,
1188,0,13,3,10,
1189,0,13,4,9,
1190,0,14,4,10,
1191,0,13,3,10,
1192,0,16,4,12,
1193,0,13,3,10,
1194,0,14,4,10,
1195,0,16,4,12,
1196,0,15,3,12,
1197,0,15,3,11,1
1198,0,15,3,12,
1199,0,16,4,12,
1200,0,13,3,10,
1201,0,13,3,10,
1202,0,15,4,11,
1203,0,14,3,11,
1204,0,14,3,11,
1205,0,14,3,11,
1206,0,16,4,12,
1207,0,15,3,12,
1208,0,14,3,11,
1209,0,15,4,11,
1210,0,14,3,11,
1211,0,15,4,11,
1212,0,15,4,11,
1213,0,13,3,10,
1214,0,14,3,11,
1215,0,14,4,10,
1216,0,15,4,11,
1217,0,13,3,10,
1218,0,15,4,11,
1219,0,14,3,11,
1220,0,15,3,12,
1221,0,14,4,10,
1222,0,16,5,11,
1223,0,15,3,12,
1224,0,13,3,10,
1225,0,14,4,10,
1226,0,13,3,10,
1227,0,15,3,11,1
1228,0,12,3,9,
1229,0,16,4,12,
1230,0,15,3,12,
1231,0,15,3,12,
1232,0,15,5,10,
1233,0,14,3,11,
1234,0,14,4,10,
1235,0,13,3,10,
1236,0,14,3,11,
1237,0,12,3,9,
1238,0,15,4,11,
1239,0,14,3,11,
1240,0,14,3,11,
1241,0,12,3,9,
1242,0,16,4,12,
1243,0,14,3,11,
1244,0,14,3,11,
1245,0,15,4,11,
1246,0,15,5,10,
1247,0,15,4,11,
1248,0,15,4,11,
1249,0,14,3,11,
1250,0,12,3,9,
1251,0,18,5,13,
1252,0,13,3,10,
1253,0,16,4,12,
1254,0,14,4,10,
1255,0,15,3,12,
1256,0,14,3,11,
1257,0,15,3,11,1
1258,0,15,4,11,
1259,0,14,3,11,
1260,0,14,3,11,
1261,0,12,3,9,
1262,0,15,4,11,
1263,0,14,4,10,
1264,0,13,3,10,
1265,0,15,4,11,
1266,0,15,3,12,
1267,0,13,3,10,
1268,0,15,4,11,
1269,0,15,4,11,
1270,0,12,3,9,
1271,0,16,4,12,
1272,0,15,5,10,
1273,0,13,3,10,
1274,0,13,4,9,
1275,0,16,4,12,
1276,0,16,4,12,
1277,0,15,3,12,
1278,0,13,3,10,
1279,0,15,4,11,
1280,0,14,3,11,
1281,0,13,3,10,
1282,0,14,4,10,
1283,0,13,3,10,
1284,0,14,3,11,
1285,0,13,4,9,
1286,0,16,4,12,
1287,0,14,3,11,
1288,0,15,3,11,1
1289,0,15,4,11,
1290,0,13,3,10,
1291,0,13,3,10,
1292,0,15,4,11,
1293,0,14,3,11,
1294,0,12,3,9,
1295,0,17,5,12,
1296,0,14,3,11,
1297,0,15,4,11,
1298,0,14,4,10,
1299,0,14,3,11,
1300,0,15,3,12,
1301,0,13,3,10,
1302,0,15,4,11,
1303,0,12,3,9,
1304,0,16,4,12,
1305,0,13,3,10,
1306,0,13,3,10,
1307,0,13,4,9,
1308,0,15,3,12,
1309,0,13,3,10,
1310,0,14,3,11,
1311,0,15,4,11,
1312,0,15,4,11,
1313,0,15,4,11,
1314,0,13,3,10,
1315,0,16,4,12,
1316,0,15,3,12,
1317,0,16,3,13,
1318,0,14,3,10,1
1319,0,15,4,11,
1320,0,14,3,11,
1321,0,13,3,10,
1322,0,14,4,10,
1323,0,14,3,11,
1324,0,15,3,12,
1325,0,13,3,10,
1326,0,14,4,10,
1327,0,14,3,11,
1328,0,15,4,11,
1329,0,14,3,11,
1330,0,13,3,10,
1331,0,14,3,11,
1332,0,15,4,11,
1333,0,14,3,11,
1334,0,12,3,9,
1335,0,15,4,11,
1336,0,14,3,11,
1337,0,17,5,12,
1338,0,15,4,11,
1339,0,14,4,10,
1340,0,16,5,11,
1341,0,12,3,9,
1342,0,15,4,11,
1343,0,15,4,11,
1344,0,14,3,11,
1345,0,15,4,11,
1346,0,16,4,12,
1347,0,14,3,11,
1348,0,15,3,11,1
1349,0,16,4,12,
1350,0,13,3,10,
1351,0,15,4,11,
1352,0,16,4,12,
1353,0,15,3,12,
1354,0,13,3,10,
1355,0,13,3,10,
1356,0,16,4,12,
1357,0,15,3,12,
1358,0,15,5,10,
1359,0,13,3,10,
1360,0,14,3,11,
1361,0,12,3,9,
1362,0,15,4,11,
1363,0,13,3,10,
1364,0,13,3,10,
1365,0,16,4,12,
1366,0,15,3,12,
1367,0,16,5,11,
1368,0,15,4,11,
1369,0,14,3,11,
1370,0,12,3,9,
1371,0,14,4,10,
1372,0,13,3,10,
1373,0,13,3,10,
1374,0,13,4,9,
1375,0,15,4,11,
1376,0,15,4,11,
1377,0,14,3,11,
1378,0,14,4,10,
1379,0,15,4,10,1
1380,0,14,3,11,
1381,0,12,3,9,
1382,0,15,4,11,
1383,0,13,3,10,
1384,0,13,3,10,
1385,0,17,4,13,
1386,0,15,3,12,
1387,0,15,4,11,
1388,0,14,3,11,
1389,0,16,4,12,
1390,0,13,3,10,
1391,0,13,3,10,
1392,0,15,4,11,
1393,0,14,3,11,
1394,0,12,3,9,
1395,0,16,4,12,
1396,0,14,3,11,
1397,0,16,4,12,
1398,0,14,4,10,
1399,0,13,3,10,
1400,0,14,3,11,
1401,0,13,3,10,
1402,0,14,4,10,
1403,0,13,3,10,
1404,0,17,4,13,
1405,0,13,3,10,
1406,0,13,3,10,
1407,0,13,4,9,
1408,0,15,3,12,
1409,0,14,3,10,1
1410,0,14,3,11,
1411,0,15,4,11,
1412,0,13,3,10,
1413,0,13,3,10,
1414,0,14,4,10,
1415,0,14,3,11,
1416,0,12,3,9,
1417,0,17,4,13,
1418,0,14,3,11,
1419,0,14,3,11,
1420,0,16,4,12,
1421,0,13,3,10,
1422,0,13,3,10,
1423,0,14,4,10,
1424,0,15,4,11,
1425,0,14,3,11,
1426,0,14,3,11,
1427,0,13,4,9,
1428,0,15,4,11,
1429,0,15,4,11,
1430,0,15,3,12,
1431,0,15,4,11,
1432,0,15,3,12,
1433,0,13,3,10,
1434,0,14,4,10,
1435,0,14,3,11,
1436,0,12,3,9,
1437,0,15,4,11,
1438,0,13,4,9,
1439,0,16,3,12,1
1440,0,14,3,11,
1441,0,14,3,11,
1442,0,15,4,11,
1443,0,13,3,10,
1444,0,13,3,10,
1445,0,15,4,11,
1446,0,14,3,11,
1447,0,12,3,9,
1448,0,17,4,13,
1449,0,14,3,11,
1450,0,14,3,11,
1451,0,15,5,10,
1452,0,13,3,10,
1453,0,13,3,10,
1454,0,13,4,9,
1455,0,15,4,11,
1456,0,14,3,11,
1457,0,14,3,11,
1458,0,14,5,9,
1459,0,16,4,12,
1460,0,14,3,11,
1461,0,14,3,11,
1462,0,15,4,11,
1463,0,13,3,10,
1464,0,13,3,10,
1465,0,15,4,11,
1466,0,14,3,11,
1467,0,12,3,9,
1468,0,17,4,13,
1469,0,14,3,11,
1470,0,15,3,11,1
1471,0,14,4,10,
1472,0,13,3,10,
1473,0,13,3,10,
1474,0,12,3,9,
1475,0,15,4,11,
1476,0,13,3,10,
1477,0,13,3,10,
1478,0,16,5,11,
1479,0,15,3,12,
1480,0,15,4,11,
1481,0,15,3,12,
1482,0,14,4,10,
1483,0,13,3,10,
1484,0,15,4,11,
1485,0,12,3,9,
1486,0,15,4,11,
1487,0,13,3,10,
1488,0,17,5,12,
1489,0,14,3,11,
1490,0,14,3,11,
1491,0,15,4,11,
1492,0,13,3,10,
1493,0,13,3,10,
1494,0,16,5,11,
1495,0,14,3,11,
1496,0,15,4,11,
1497,0,15,3,12,
1498,0,13,4,9,
1499,0,16,4,12,
1500,0,15,3,11,1
1501,0,14,3,11,
1502,0,15,4,11,
1503,0,13,3,10,
1504,0,13,3,10,
1505,0,15,4,11,
1506,0,14,3,11,
1507,0,12,3,9,
1508,0,17,4,13,
1509,0,14,3,11,
1510,0,14,3,11,
1511,0,14,4,10,
1512,0,13,3,10,
1513,0,13,3,10,
1514,0,14,4,10,
1515,0,15,4,11,
1516,0,13,3,10,
1517,0,13,3,10,
1518,0,15,4,11,
1519,0,19,7,12,
1520,0,19,7,12,
1521,0,17,5,12,
1522,0,18,7,11,
1523,0,18,6,12,
1524,0,17,6,11,
1525,0,17,6,11,
1526,0,18,7,11,
1527,0,17,6,11,
1528,0,17,6,11,
1529,0,17,7,10,
1530,0,17,6,11,
1531,0,19,7,11,1
1532,0,18,6,12,
1533,0,16,7,9,
1534,0,17,6,11,
1535,0,17,7,10,
1536,0,17,6,11,
1537,0,17,7,10,
1538,0,17,7,10,
1539,0,17,7,10,
1540,0,18,7,11,
1541,0,17,6,11,
1542,0,17,6,11,
1543,0,17,7,10,
1544,0,19,7,12,
1545,0,17,6,11,
1546,0,17,6,11,
1547,0,18,7,11,
1548,0,18,6,12,
1549,0,18,7,11,
1550,0,18,7,11,
1551,0,18,7,11,
1552,0,18,7,11,
1553,0,17,6,11,
1554,0,19,7,12,
1555,0,18,6,12,
1556,0,19,7,12,
1557,0,18,7,11,
1558,0,18,6,12,
1559,0,18,7,11,
1560,0,18,7,11,
1561,0,19,6,12,1
1562,0,15,3,12,
1563,0,14,4,10,
1564,0,14,4,10,
1565,0,14,3,11,
1566,0,14,4,10,
1567,0,13,3,10,
1568,0,13,4,9,
1569,0,16,4,12,
1570,0,15,4,11,
1571,0,14,3,11,
1572,0,14,4,10,
1573,0,13,3,10,
1574,0,14,3,11,
1575,0,12,3,9,
1576,0,15,4,11,
1577,0,13,3,10,
1578,0,13,3,10,
1579,0,17,4,13,
1580,0,16,3,13,
1581,0,14,4,10,
1582,0,15,3,12,
1583,0,13,3,10,
1584,0,14,3,11,
1585,0,15,5,10,
1586,0,14,4,10,
1587,0,13,3,10,
1588,0,15,4,11,
1589,0,14,3,11,
1590,0,12,3,9,
1591,0,17,4,12,1
1592,0,14,4,10,
1593,0,14,4,10,
1594,0,14,3,11,
1595,0,12,3,9,
1596,0,15,4,11,
1597,0,13,3,10,
1598,0,13,3,10,
1599,0,16,4,12,
1600,0,15,3,12,
1601,0,14,4,10,
1602,0,15,4,11,
1603,0,14,3,11,
1604,0,13,3,10,
1605,0,14,4,10,
1606,0,13,3,10,
1607,0,13,3,10,
1608,0,12,3,9,
1609,0,15,4,11,
1610,0,16,4,12,
1611,0,14,3,11,
1612,0,14,3,11,
1613,0,12,3,9,
1614,0,16,4,12,
1615,0,13,3,10,
1616,0,14,3,11,
1617,0,15,4,11,
1618,0,15,3,12,
1619,0,15,3,12,
1620,0,15,3,12,
1621,0,14,4,10,
1622,0,14,3,10,1
1623,0,15,4,11,
1624,0,12,3,9,
1625,0,15,4,11,
1626,0,13,3,10,
1627,0,13,3,10,
1628,0,16,4,12,
1629,0,15,3,12,
1630,0,13,3,10,
1631,0,16,5,11,
1632,0,14,3,11,
1633,0,12,3,9,
1634,0,16,4,12,
1635,0,13,3,10,
1636,0,15,4,11,
1637,0,13,3,10,
1638,0,13,3,10,
1639,0,16,4,12,
1640,0,16,4,12,
1641,0,14,4,10,
1642,0,15,4,11,
1643,0,14,3,11,
1644,0,12,3,9,
1645,0,14,4,10,
1646,0,13,3,10,
1647,0,14,3,11,
1648,0,12,3,9,
1649,0,16,4,12,
1650,0,14,3,11,
1651,0,14,3,11,
1652,0,17,4,12,1
1653,0,13,3,10,
1654,0,13,3,10,
1655,0,15,4,11,
1656,0,14,3,11,
1657,0,12,3,9,
1658,0,14,4,10,
1659,0,14,3,11,
1660,0,14,3,11,
1661,0,13,3,10,
1662,0,14,4,10,
1663,0,14,3,11,
1664,0,12,3,9,
1665,0,16,4,12,
1666,0,14,4,10,
1667,0,13,3,10,
1668,0,17,4,13,
1669,0,16,3,13,
1670,0,14,3,11,
1671,0,14,3,11,
1672,0,16,4,12,
1673,0,13,3,10,
1674,0,13,3,10,
1675,0,16,4,12,
1676,0,15,3,12,
1677,0,13,3,10,
1678,0,13,3,10,
1679,0,16,4,12,
1680,0,15,3,12,
1681,0,15,4,11,
1682,0,16,3,12,1
1683,0,15,4,11,
1684,0,15,3,12,
1685,0,14,3,11,
1686,0,14,4,10,
1687,0,13,3,10,
1688,0,14,4,10,
1689,0,16,5,11,
1690,0,12,3,9,
1691,0,17,4,13,
1692,0,14,3,11,
1693,0,14,3,11,
1694,0,14,3,11,
1695,0,15,4,11,
1696,0,14,3,11,
1697,0,12,3,9,
1698,0,14,4,10,
1699,0,13,3,10,
1700,0,15,4,11,
1701,0,13,4,9,
1702,0,16,4,12,
1703,0,17,5,12,
1704,0,16,4,12,
1705,0,14,3,11,
1706,0,14,4,10,
1707,0,17,5,12,
1708,0,13,3,10,
1709,0,13,3,10,
1710,0,15,4,11,
1711,0,14,3,11,
1712,0,13,3,10,
1713,0,17,4,12,1
1714,0,12,3,9,
1715,0,17,4,13,
1716,0,14,3,11,
1717,0,14,3,11,
1718,0,14,4,10,
1719,0,14,4,10,
1720,0,13,3,10,
1721,0,13,4,9,
1722,0,16,5,11,
1723,0,13,3,10,
1724,0,13,3,10,
1725,0,15,4,11,
1726,0,15,3,12,
1727,0,14,4,10,
1728,0,15,4,11,
1729,0,14,3,11,
1730,0,12,3,9,
1731,0,15,4,11,
1732,0,14,4,10,
1733,0,13,3,10,
1734,0,14,4,10,
1735,0,15,4,11,
1736,0,13,3,10,
1737,0,14,4,10,
1738,0,14,3,11,
1739,0,15,3,12,
1740,0,14,3,11,
1741,0,15,4,11,
1742,0,15,4,11,
1743,0,16,4,11,1
1744,0,14,3,11,
1745,0,12,3,9,
1746,0,16,4,12,
1747,0,13,3,10,
1748,0,17,4,13,
1749,0,14,3,11,
1750,0,14,3,11,
1751,0,12,3,9,
1752,0,17,4,13,
1753,0,14,3,11,
1754,0,14,3,11,
1755,0,16,4,12,
1756,0,14,3,11,
1757,0,15,5,10,
1758,0,13,3,10,
1759,0,14,3,11,
1760,0,13,4,9,
1761,0,15,3,12,
1762,0,14,3,11,
1763,0,14,3,11,
1764,0,15,4,11,
1765,0,13,4,9,
1766,0,14,3,11,
1767,0,12,3,9,
1768,0,13,3,10,
1769,0,15,4,11,
1770,0,15,3,12,
1771,0,13,3,10,
1772,0,14,4,10,
1773,0,14,3,11,
1774,0,15,4,10,1
1775,0,14,3,11,
1776,0,13,4,9,
1777,0,15,3,12,
1778,0,14,3,11,
1779,0,14,3,11,
1780,0,15,4,11,
1781,0,13,3,10,
1782,0,15,4,11,
1783,0,14,3,11,
1784,0,14,3,11,
1785,0,13,4,9,
1786,0,15,3,12,
1787,0,13,3,10,
1788,0,15,4,11,
1789,0,15,4,11,
1790,0,16,5,11,
1791,0,13,3,10,
1792,0,15,5,10,
1793,0,14,3,11,
1794,0,13,4,9,
1795,0,17,4,13,
1796,0,14,4,10,
1797,0,15,3,12,
1798,0,14,3,11,
1799,0,15,4,11,
1800,0,13,3,10,
1801,0,15,4,11,
1802,0,14,3,11,
1803,0,14,3,11,
1804,0,15,3,11,1
1805,0,13,4,9,
1806,0,14,3,11,
1807,0,12,3,9,
1808,0,13,3,10,
1809,0,15,4,11,
1810,0,16,4,12,
1811,0,14,4,10,
1812,0,15,4,11,
1813,0,16,4,12,
1814,0,13,3,10,
1815,0,13,3,10,
1816,0,14,4,10,
1817,0,15,4,11,
1818,0,14,5,9,
1819,0,16,4,12,
1820,0,13,4,9,
1821,0,15,3,12,
1822,0,14,3,11,
1823,0,14,4,10,
1824,0,13,3,10,
1825,0,13,4,9,
1826,0,14,3,11,
1827,0,12,3,9,
1828,0,15,5,10,
1829,0,15,4,11,
1830,0,16,4,12,
1831,0,13,3,10,
1832,0,14,4,10,
1833,0,14,3,11,
1834,0,12,3,9,
1835,0,16,4,12,
1836,0,13,3,10,
1837,0,13,3,10,
1838,0,16,4,12,
1839,0,15,3,12,
1840,0,13,3,10,
1841,0,15,4,11,
1842,0,14,3,11,
1843,0,13,3,10,
1844,0,13,3,10,
1845,0,14,4,10,
1846,0,14,3,11,
1847,0,12,3,9,
1848,0,15,4,11,
1849,0,17,4,13,
1850,0,16,3,13,
1851,0,14,3,11,
1852,0,14,3,11,
1853,0,16,4,12,
1854,0,13,3,10,
1855,0,14,3,11,
1856,0,14,4,10,
1857,0,15,3,12,
1858,0,12,3,9,
1859,0,18,5,13,
1860,0,13,3,10,
1861,0,13,3,10,
1862,0,16,4,12,
1863,0,15,3,12,
1864,0,14,3,11,
1865,0,15,3,12,
1866,0,16,4,12,
1867,0,13,3,10,
1868,0,13,3,10,
1869,0,15,4,11,
1870,0,14,3,11,
1871,0,14,3,11,
1872,0,14,3,11,
1873,0,15,4,11,
1874,0,14,3,11,
1875,0,15,4,11,
1876,0,15,3,12,
1877,0,13,3,10,
1878,0,14,4,10,
1879,0,14,4,10,
1880,0,13,3,10,
1881,0,14,3,11,
1882,0,14,5,9,
1883,0,15,4,11,
1884,0,13,4,9,
1885,0,15,3,12,
1886,0,14,3,11,
1887,0,14,3,11,
1888,0,14,4,10,
1889,0,14,4,10,
1890,0,15,5,10,
1891,0,15,4,11,
1892,0,14,3,11,
1893,0,12,3,9,
1894,0,17,4,13,
1895,0,14,3,11,
1896,0,15,4,11,
1897,0,16,4,12,
1898,0,13,3,10,
1899,0,13,3,10,
1900,0,16,4,12,
1901,0,15,3,12,
1902,0,13,3,10,
1903,0,13,3,10,
1904,0,13,4,9,
1905,0,15,3,12,
1906,0,13,3,10,
1907,0,14,3,11,
1908,0,14,4,10,
1909,0,14,4,10,
1910,0,13,3,10,
1911,0,13,4,9,
1912,0,13,3,10,
1913,0,14,4,10,
1914,0,16,4,12,
1915,0,15,4,11,
1916,0,15,3,12,
1917,0,13,3,10,
1918,0,15,4,11,
1919,0,15,4,11,
1920,0,15,4,11,
1921,0,14,3,11,
1922,0,12,3,9,
1923,0,14,4,10,
1924,0,14,3,11,
1925,0,15,3,12,
1926,0,14,3,11,
1927,0,15,4,11,
1928,0,14,3,11,
1929,0,13,3,10,
1930,0,13,3,10,
1931,0,14,4,10,
1932,0,14,3,11,
1933,0,13,3,10,
1934,0,14,3,11,
1935,0,16,5,11,
1936,0,15,3,12,
1937,0,13,3,10,
1938,0,14,4,10,
1939,0,15,4,11,
1940,0,12,3,9,
1941,0,16,4,12,
1942,0,14,3,11,
1943,0,14,3,11,
1944,0,16,5,11,
1945,0,15,3,12,
1946,0,13,4,9,
1947,0,15,3,12,
1948,0,14,3,11,
1949,0,15,5,10,
1950,0,13,3,10,
1951,0,13,4,9,
1952,0,14,3,11,
1953,0,12,3,9,
1954,0,13,3,10,
1955,0,15,4,11,
1956,0,15,3,12,
1957,0,13,3,10,
1958,0,14,4,10,
1959,0,14,3,11,
1960,0,12,3,9,
1961,0,16,4,12,
1962,0,13,3,10,
1963,0,16,4,12,
1964,0,16,4,12,
1965,0,15,3,12,
1966,0,12,3,9,
1967,0,14,4,10,
1968,0,13,3,10,
1969,0,15,4,11,
1970,0,14,3,11,
1971,0,15,4,11,
1972,0,14,3,11,
1973,0,14,5,9,
1974,0,14,4,10,
1975,0,14,4,10,
1976,0,14,3,11,
1977,0,12,3,9,
1978,0,16,4,12,
1979,0,16,4,12,
1980,0,15,3,12,
1981,0,16,4,12,
1982,0,15,3,12,
1983,0,13,3,10,
1984,0,15,4,11,
1985,0,14,3,11,
1986,0,12,3,9,
1987,0,14,4,10,
1988,0,14,3,11,
1989,0,15,3,12,
1990,0,12,3,9,
1991,0,14,4,10,
1992,0,14,3,11,
1993,0,14,3,11,
1994,0,13,3,10,
1995,0,15,4,11,
1996,0,15,3,12,
1997,0,13,3,10,
1998,0,14,4,10,
1999,0,15,5,10,
2000,0,14,3,11,
2001,0,12,3,9,
2002,0,16,4,12,
2003,0,15,4,11,
2004,0,15,4,11,
2005,0,16,4,12,
2006,0,13,3,10,
2007,0,13,3,10,
2008,0,15,4,11,
2009,0,14,3,11,
2010,0,15,4,11,
2011,0,15,3,12,
2012,0,14,3,11,
2013,0,14,3,11,
2014,0,16,4,12,
2015,0,13,3,10,
2016,0,13,3,10,
2017,0,15,4,11,
2018,0,14,3,11,
2019,0,12,3,9,
2020,0,17,4,13,
2021,0,14,3,11,
2022,0,14,3,11,
2023,0,16,4,12,
2024,0,13,3,10,
2025,0,14,3,11,
2026,0,13,4,9,
2027,0,14,3,11,
2028,0,13,3,10,
2029,0,16,4,12,
2030,0,14,4,10,
2031,0,15,4,11,
2032,0,14,3,11,
2033,0,14,3,11,
2034,0,16,5,11,
2035,0,14,3,11,
2036,0,16,4,12,
2037,0,13,3,10,
2038,0,14,4,10,
2039,0,14,4,10,
2040,0,14,4,10,
2041,0,15,4,11,
2042,0,14,3,11,
2043,0,12,3,9,
2044,0,16,4,12,
2045,0,15,4,11,
2046,0,14,3,11,
2047,0,14,4,10,
2048,0,13,3,10,
2049,0,13,3,10,
2050,0,12,3,9,
2051,0,15,4,11,
2052,0,13,3,10,
2053,0,13,3,10,
2054,0,15,4,11,
2055,0,15,3,12,
2056,0,13,3,10,
2057,0,14,4,10,
2058,0,15,5,10,
2059,0,13,3,10,
2060,0,14,3,11,
2061,0,12,3,9,
2062,0,16,4,12,
2063,0,15,3,12,
2064,0,17,5,12,
2065,0,14,3,11,
2066,0,15,4,11,
2067,0,14,3,11,
2068,0,13,3,10,
2069,0,14,4,10,
2070,0,13,4,9,
2071,0,17,4,13,
2072,0,15,4,11,
2073,0,14,3,11,
2074,0,14,3,11,
2075,0,15,4,11,
2076,0,14,3,11,
2077,0,13,3,10,
2078,0,14,4,10,
2079,0,13,3,10,
2080,0,14,3,11,
2081,0,14,4,10,
2082,0,16,3,13,
2083,0,14,3,11,
2084,0,15,3,12,
2085,0,15,4,11,
2086,0,14,3,11,
2087,0,16,4,12,
2088,0,13,3,10,
2089,0,13,3,10,
2090,0,14,4,10,
2091,0,13,3,10,
2092,0,14,4,10,
2093,0,14,3,11,
2094,0,16,5,11,
2095,0,18,5,13,
2096,0,14,3,11,
2097,0,14,3,11,
2098,0,15,4,11,
2099,0,13,3,10,
2100,0,15,4,11,
2101,0,14,4,10,
2102,0,15,3,12,
2103,0,13,3,10,
2104,0,14,3,11,
2105,0,13,4,9,
2106,0,15,3,12,
2107,0,14,3,11,
2108,0,14,3,11,
2109,0,14,4,10,
2110,0,13,3,10,
2111,0,14,3,11,
2112,0,12,3,9,
2113,0,15,4,11,
2114,0,13,3,10,
2115,0,13,3,10,
2116,0,15,4,11,
2117,0,13,3,10,
2118,0,15,4,11,
2119,0,15,3,12,
2120,0,15,4,11,
2121,0,14,3,11,
2122,0,15,4,11,
2123,0,13,3,10,
2124,0,14,3,11,
2125,0,14,4,10,
2126,0,15,3,12,
2127,0,13,3,10,
2128,0,14,3,11,
2129,0,13,4,9,
2130,0,14,3,11,
2131,0,17,6,11,
2132,0,13,3,10,
2133,0,13,3,10,
2134,0,14,4,10,
2135,0,15,3,12,
2136,0,13,3,10,
2137,0,14,3,11,
2138,0,13,4,9,
2139,0,15,3,12,
2140,0,16,4,12,
2141,0,15,3,12,
2142,0,13,3,10,
2143,0,15,4,11,
2144,0,14,3,11,
2145,0,13,3,10,
2146,0,15,4,11,
2147,0,12,3,9,
2148,0,16,4,12,
2149,0,13,3,10,
2150,0,13,3,10,
2151,0,15,5,10,
2152,0,16,3,13,
2153,0,14,3,11,
2154,0,15,3,12,
2155,0,15,5,10,
2156,0,13,3,10,
2157,0,14,3,11,
2158,0,13,4,9,
2159,0,15,4,11,
2160,0,14,3,11,
2161,0,14,3,11,
2162,0,13,4,9,
2163,0,15,3,12,
2164,0,14,3,11,
2165,0,14,3,11,
2166,0,14,4,10,
2167,0,13,3,10,
2168,0,14,3,11,
2169,0,12,3,9,
2170,0,15,4,11,
2171,0,13,3,10,
2172,0,13,3,10,
2173,0,17,4,13,
2174,0,16,3,13,
2175,0,14,3,11,
2176,0,15,4,11,
2177,0,14,3,11,
2178,0,14,3,11,
2179,0,15,4,11,
2180,0,13,3,10,
2181,0,13,3,10,
2182,0,14,4,10,
2183,0,14,4,10,
2184,0,13,3,10,
2185,0,14,3,11,
2186,0,15,4,11,
2187,0,14,3,11,
2188,0,13,4,9,
2189,0,15,3,12,
2190,0,13,3,10,
2191,0,15,4,11,
2192,0,13,3,10,
2193,0,15,4,11,
2194,0,15,4,11,
2195,0,15,4,11,
2196,0,14,3,11,
2197,0,12,3,9,
2198,0,16,4,12,
2199,0,13,3,10,
2200,0,13,3,10,
2201,0,14,4,10,
2202,0,16,3,13,
2203,0,14,3,11,
2204,0,14,3,11,
2205,0,14,4,10,
2206,0,12,3,9,
2207,0,14,4,10,
2208,0,12,3,9,
2209,0,15,4,11,
2210,0,13,3,10,
2211,0,13,3,10,
2212,0,16,4,12,
2213,0,15,3,12,
2214,0,13,3,10,
2215,0,15,4,11,
2216,0,13,3,10,
2217,0,15,4,11,
2218,0,15,3,12,
2219,0,13,3,10,
2220,0,14,4,10,
2221,0,14,4,10,
2222,0,14,3,11,
2223,0,15,4,11,
2224,0,14,3,11,
2225,0,14,5,9,
2226,0,16,4,12,
2227,0,14,3,11,
2228,0,14,3,11,
2229,0,16,4,12,
2230,0,13,3,10,
2231,0,13,3,10,
2232,0,15,4,11,
2233,0,14,3,11,
2234,0,12,3,9,
2235,0,14,4,10,
2236,0,14,3,11,
2237,0,15,4,11,
2238,0,14,4,10,
2239,0,13,3,10,
2240,0,15,4,11,
2241,0,12,3,9,
2242,0,15,4,11,
2243,0,13,3,10,
2244,0,14,4,10,
2245,0,17,4,13,
2246,0,15,3,12,
2247,0,17,5,12,
2248,0,13,3,10,
2249,0,16,5,11,
2250,0,13,3,10,
2251,0,13,3,10,
2252,0,13,4,9,
2253,0,14,3,11,
2254,0,15,4,11,
2255,0,15,3,12,
2256,0,13,3,10,
2257,0,14,3,11,
2258,0,15,4,11,
2259,0,15,3,12,
2260,0,13,3,10,
2261,0,15,4,11,
2262,0,14,3,11,
2263,0,13,3,10,
2264,0,14,3,11,
2265,0,15,4,11,
2266,0,14,3,11,
2267,0,13,4,9,
2268,0,17,4,13,
2269,0,14,3,11,
2270,0,15,3,12,
2271,0,14,4,10,
2272,0,13,3,10,
2273,0,14,3,11,
2274,0,12,3,9,
2275,0,15,4,11,
2276,0,13,4,9,
2277,0,13,3,10,
2278,0,16,4,12,
2279,0,15,3,12,
2280,0,14,3,11,
2281,0,15,3,12,
2282,0,16,4,12,
2283,0,13,3,10,
2284,0,13,3,10,
2285,0,15,4,11,
2286,0,14,3,11,
2287,0,14,3,11,
2288,0,14,3,11,
2289,0,13,4,9,
2290,0,15,3,12,
2291,0,14,3,11,
2292,0,14,3,11,
2293,0,15,4,11,
2294,0,14,3,11,
2295,0,14,3,11,
2296,0,12,3,9,
2297,0,15,4,11,
2298,0,16,4,12,
2299,0,15,3,12,
2300,0,14,3,11,
2301,0,15,4,11,
2302,0,14,3,11,
2303,0,14,4,10,
2304,0,14,3,11,
2305,0,13,4,9,
2306,0,13,3,10,
2307,0,17,5,12,
2308,0,15,3,12,
2309,0,13,3,10,
2310,0,15,4,11,
2311,0,15,3,12,
2312,0,14,4,10,
2313,0,15,4,11,
2314,0,13,4,9,
2315,0,14,3,11,
2316,0,13,3,10,
2317,0,13,3,10,
2318,0,15,4,11,
2319,0,15,3,12,
2320,0,14,3,11,
2321,0,15,3,12,
2322,0,15,4,11,
2323,0,14,4,10,
2324,0,13,3,10,
2325,0,16,4,12,
2326,0,15,3,12,
2327,0,13,4,9,
2328,0,16,4,12,
2329,0,14,3,11,
2330,0,14,3,11,
2331,0,15,4,11,
2332,0,13,3,10,
2333,0,15,4,11,
2334,0,14,3,11,
2335,0,14,3,11,
2336,0,15,4,11,
2337,0,13,3,10,
2338,0,15,4,11,
2339,0,14,3,11,
2340,0,13,4,9,
2341,0,17,4,13,
2342,0,14,3,11,
2343,0,15,4,11,
2344,0,14,4,10,
2345,0,15,4,11,
2346,0,14,3,11,
2347,0,13,3,10,
2348,0,14,4,10,
2349,0,12,3,9,
2350,0,17,4,13,
2351,0,14,3,11,
2352,0,14,3,11,
2353,0,14,3,11,
2354,0,15,4,11,
2355,0,14,3,11,
2356,0,12,3,9,
2357,0,14,4,10,
2358,0,12,3,9,
2359,0,16,4,12,
2360,0,13,3,10,
2361,0,13,3,10,
2362,0,16,4,12,
2363,0,15,3,12,
2364,0,16,4,12,
2365,0,13,3,10,
2366,0,13,3,10,
2367,0,14,4,10,
2368,0,15,4,11,
2369,0,16,4,12,
2370,0,15,3,12,
2371,0,16,4,12,
2372,0,13,3,10,
2373,0,14,4,10,
2374,0,15,4,11,
2375,0,14,3,11,
2376,0,12,3,9,
2377,0,14,4,10,
2378,0,14,3,11,
2379,0,15,4,11,
2380,0,13,3,10,
2381,0,14,4,10,
2382,0,14,3,11,
2383,0,12,3,9,
2384,0,16,4,12,
2385,0,14,3,11,
2386,0,14,3,11,
2387,0,12,3,9,
2388,0,18,5,13,
2389,0,14,3,11,
2390,0,14,3,11,
2391,0,16,4,12,
2392,0,13,3,10,
2393,0,14,4,10,
2394,0,14,4,10,
2395,0,15,3,12,
2396,0,13,3,10,
2397,0,16,4,12,
2398,0,15,4,11,
2399,0,14,3,11,
2400,0,15,4,11,
2401,0,13,3,10,
2402,0,13,3,10,
2403,0,15,4,11,
2404,0,13,3,10,
2405,0,15,4,11,
2406,0,14,3,11,
2407,0,12,3,9,
2408,0,17,4,13,
2409,0,14,3,11,
2410,0,14,3,11,
2411,0,14,3,11,
2412,0,15,4,11,
2413,0,14,3,11,
2414,0,12,3,9,
2415,0,16,4,12,
2416,0,13,3,10,
2417,0,13,3,10,
2418,0,14,4,10,
2419,0,15,3,12,
2420,0,14,3,11,
2421,0,14,3,11,
2422,0,15,4,11,
2423,0,13,3,10,
2424,0,13,3,10,
2425,0,16,4,12,
2426,0,15,3,12,
2427,0,13,3,10,
2428,0,16,4,12,
2429,0,13,3,10,
2430,0,14,4,10,
2431,0,14,3,11,
2432,0,15,3,12,
2433,0,13,3,10,
2434,0,13,4,9,
2435,0,14,4,10,
2436,0,12,3,9,
2437,0,16,4,12,
2438,0,14,3,11,
2439,0,14,3,11,
2440,0,16,4,12,
2441,0,13,3,10,
2442,0,13,3,10,
2443,0,14,4,10,
2444,0,14,3,11,
2445,0,13,3,10,
2446,0,14,4,10,
2447,0,14,3,11,
2448,0,15,3,12,
2449,0,15,4,11,
2450,0,14,3,11,
2451,0,14,4,10,
2452,0,14,4,10,
2453,0,14,3,11,
2454,0,12,3,9,
2455,0,15,4,11,
2456,0,14,3,11,
2457,0,14,3,11,
2458,0,12,3,9,
2459,0,16,4,12,
2460,0,14,3,11,
2461,0,14,3,11,
2462,0,16,4,12,
2463,0,15,4,11,
2464,0,14,3,11,
2465,0,14,4,10,
2466,0,14,3,11,
2467,0,13,4,9,
2468,0,15,3,12,
2469,0,14,3,11,
2470,0,15,4,11,
2471,0,15,4,11,
2472,0,13,3,10,
2473,0,13,3,10,
2474,0,14,4,10,
2475,0,14,3,11,
2476,0,12,3,9,
2477,0,17,4,13,
2478,0,14,3,11,
2479,0,14,3,11,
2480,0,15,4,11,
2481,0,14,3,11,
2482,0,16,4,12,
2483,0,13,3,10,
2484,0,13,3,10,
2485,0,13,4,9,
2486,0,14,3,11,
2487,0,12,3,9,
2488,0,15,5,10,
2489,0,14,3,11,
2490,0,15,3,12,
2491,0,13,3,10,
2492,0,15,4,11,
2493,0,15,3,12,
2494,0,13,3,10,
2495,0,15,4,11,
2496,0,12,3,9,
2497,0,16,4,12,
2498,0,13,3,10,
2499,0,14,3,11,
2500,0,13,4,9,
2501,0,14,3,11,
2502,0,17,4,13,
2503,0,16,3,13,
2504,0,15,5,10,
2505,0,15,3,12,
2506,0,14,3,11,
2507,0,15,4,11,
2508,0,14,3,11,
2509,0,14,4,10,
2510,0,15,4,11,
2511,0,12,3,9,
2512,0,16,4,12,
2513,0,14,3,11,
2514,0,13,3,10,
2515,0,16,4,12,
2516,0,17,4,13,
2517,0,14,3,11,
2518,0,15,4,11,
2519,0,15,4,11,
2520,0,14,4,10,
2521,0,13,3,10,
2522,0,13,4,9,
2523,0,13,3,10,
2524,0,15,4,11,
2525,0,15,3,12,
2526,0,13,3,10,
2527,0,15,4,11,
2528,0,14,3,11,
2529,0,12,3,9,
2530,0,16,4,12,
2531,0,15,4,11,
2532,0,15,3,12,
2533,0,13,4,9,
2534,0,15,3,12,
2535,0,14,3,11,
2536,0,14,3,11,
2537,0,15,4,11,
2538,0,14,3,11,
2539,0,14,3,11,
2540,0,14,4,10,
2541,0,13,3,10,
2542,0,13,4,9,
2543,0,14,3,11,
2544,0,13,3,10,
2545,0,16,4,12,
2546,0,13,3,10,
2547,0,15,4,11,
2548,0,14,3,11,
2549,0,13,3,10,
2550,0,17,6,11,
2551,0,12,3,9,
2552,0,15,4,11,
2553,0,13,4,9,
2554,0,15,4,11,
2555,0,16,4,12,
2556,0,14,3,11,
2557,0,14,3,11,
2558,0,14,4,10,
2559,0,14,3,11,
2560,0,12,3,9,
2561,0,14,4,10,
2562,0,15,5,10,
2563,0,13,3,10,
2564,0,15,4,11,
2565,0,14,3,11,
2566,0,12,3,9,
2567,0,16,4,12,
2568,0,15,3,12,
2569,0,16,3,13,
2570,0,14,4,10,
2571,0,15,4,11,
2572,0,14,3,11,
2573,0,13,3,10,
2574,0,14,4,10,
2575,0,15,4,11,
2576,0,14,3,11,
2577,0,17,4,13,
2578,0,16,3,13,
2579,0,14,4,10,
2580,0,15,3,12,
2581,0,14,3,11,
2582,0,14,3,11,
2583,0,15,4,11,
2584,0,13,3,10,
2585,0,14,4,10,
2586,0,16,4,12,
2587,0,15,3,12,
2588,0,13,3,10,
2589,0,13,3,10,
2590,0,16,4,12,
2591,0,15,3,12,
2592,0,13,3,10,
2593,0,16,4,12,
2594,0,15,3,12,
2595,0,13,3,10,
2596,0,13,3,10,
2597,0,15,4,11,
2598,0,14,3,11,
2599,0,12,3,9,
2600,0,14,4,10,
2601,0,14,3,11,
2602,0,16,4,12,
2603,0,14,3,11,
2604,0,14,3,11,
2605,0,16,4,12,
2606,0,13,3,10,
2607,0,13,3,10,
2608,0,15,4,11,
2609,0,15,4,11,
2610,0,14,4,10,
2611,0,14,4,10,
2612,0,14,3,11,
2613,0,15,3,12,
2614,0,13,3,10,
2615,0,14,4,10,
2616,0,16,5,11,
2617,0,14,4,10,
2618,0,16,4,12,
2619,0,13,3,10,
2620,0,13,3,10,
2621,0,17,4,13,
2622,0,16,3,13,
2623,0,14,3,11,
2624,0,14,3,11,
2625,0,16,4,12,
2626,0,13,3,10,
2627,0,14,3,11,
2628,0,14,5,9,
2629,0,14,3,11,
2630,0,13,3,10,
2631,0,14,4,10,
2632,0,15,4,11,
2633,0,16,4,12,
2634,0,13,3,10,
2635,0,15,4,11,
2636,0,15,3,12,
2637,0,13,3,10,
2638,0,13,3,10,
2639,0,14,4,10,
2640,0,14,3,11,
2641,0,12,3,9,
2642,0,17,4,13,
2643,0,15,3,12,
2644,0,15,3,12,
2645,0,13,3,10,
2646,0,15,5,10,
2647,0,13,3,10,
2648,0,14,4,10,
2649,0,14,3,11,
2650,0,12,3,9,
2651,0,17,4,13,
2652,0,14,3,11,
2653,0,14,3,11,
2654,0,16,4,12,
2655,0,13,3,10,
2656,0,13,3,10,
2657,0,13,4,9,
2658,0,14,3,11,
2659,0,16,5,11,
2660,0,14,3,11,
2661,0,13,4,9,
2662,0,15,3,12,
2663,0,14,3,11,
2664,0,16,4,12,
2665,0,14,4,10,
2666,0,16,4,12,
2667,0,13,3,10,
2668,0,15,4,11,
2669,0,14,3,11,
2670,0,13,4,9,
2671,0,16,4,12,
2672,0,13,3,10,
2673,0,13,3,10,
2674,0,14,5,9,
2675,0,15,3,12,
2676,0,14,4,10,
2677,0,15,4,11,
2678,0,14,4,10,
2679,0,14,4,10,
2680,0,13,3,10,
2681,0,15,4,11,
2682,0,15,3,12,
2683,0,13,3,10,
2684,0,14,4,10,
2685,0,15,4,11,
2686,0,15,3,12,
2687,0,13,3,10,
2688,0,15,4,11,
2689,0,14,3,11,
2690,0,12,3,9,
2691,0,16,4,12,
2692,0,13,3,10,
2693,0,13,3,10,
2694,0,13,4,9,
2695,0,15,3,12,
2696,0,16,5,11,
2697,0,14,3,11,
2698,0,15,4,11,
2699,0,15,4,11,
2700,0,16,4,12,
2701,0,12,3,9,
2702,0,15,4,11,
2703,0,16,4,12,
2704,0,15,3,12,
2705,0,14,3,11,
2706,0,14,4,10,
2707,0,13,3,10,
2708,0,14,4,10,
2709,0,16,4,12,
2710,0,12,3,9,
2711,0,14,4,10,
2712,0,14,3,11,
2713,0,15,3,12,
2714,0,13,3,10,
2715,0,15,4,11,
2716,0,15,3,12,
2717,0,13,3,10,
2718,0,13,3,10,
2719,0,14,4,10,
2720,0,14,3,11,
2721,0,12,3,9,
2722,0,18,5,13,
2723,0,14,3,11,
2724,0,14,3,11,
2725,0,16,4,12,
2726,0,13,3,10,
2727,0,13,3,10,
2728,0,13,4,9,
2729,0,14,3,11,
2730,0,13,4,9,
2731,0,14,4,10,
2732,0,15,4,11,
2733,0,15,3,12,
2734,0,13,3,10,
2735,0,14,4,10,
2736,0,14,3,11,
2737,0,14,5,9,
2738,0,16,4,12,
2739,0,13,3,10,
2740,0,13,3,10,
2741,0,16,5,11,
2742,0,15,3,12,
2743,0,14,3,11,
2744,0,15,3,12,
2745,0,15,4,11,
2746,0,14,3,11,
2747,0,15,4,11,
2748,0,13,3,10,
2749,0,13,3,10,
2750,0,15,4,11,
2751,0,14,3,11,
2752,0,15,5,10,
2753,0,14,3,11,
2754,0,16,4,12,
2755,0,13,3,10,
2756,0,13,3,10,
2757,0,14,4,10,
2758,0,13,3,10,
2759,0,17,4,13,
2760,0,15,3,12,
2761,0,17,5,12,
2762,0,15,3,12,
2763,0,13,3,10,
2764,0,14,4,10,
2765,0,14,3,11,
2766,0,12,3,9,
2767,0,16,4,12,
2768,0,14,3,11,
2769,0,14,3,11,
2770,0,12,3,9,
2771,0,17,4,13,
2772,0,14,3,11,
2773,0,14,3,11,
2774,0,16,4,12,
2775,0,14,3,11,
2776,0,16,4,12,
2777,0,13,3,10,
2778,0,13,3,10,
2779,0,15,4,11,
2780,0,14,3,11,
2781,0,12,3,9,
2782,0,13,3,10,
2783,0,15,4,11,
2784,0,15,3,12,
2785,0,17,4,13,
2786,0,17,3,14,
2787,0,19,4,15,
2788,0,17,3,14,
2789,0,19,4,15,
2790,0,19,3,16,
2791,0,22,4,18,
2792,0,23,4,19,
2793,0,22,3,19,
2794,0,21,3,18,
2795,0,24,4,20,
2796,0,23,3,20,
2797,0,23,4,19,
2798,0,24,3,21,
2799,0,26,5,21,
2800,0,24,3,21,
2801,0,24,3,21,
2802,0,26,4,22,
2803,0,27,4,23,
2804,0,25,3,22,
2805,0,28,4,24,
2806,0,27,3,24,
2807,0,26,3,23,
2808,0,29,4,25,
2809,0,28,3,25,
2810,0,27,3,24,
2811,0,30,4,26,
2812,0,28,3,25,
2813,0,28,3,25,
2814,0,32,5,27,
2815,0,29,3,26,
2816,0,30,3,27,
2817,0,31,5,26,
2818,0,30,3,27,
2819,0,30,3,27,
2820,0,32,4,28,
2821,0,32,4,28,
2822,0,32,4,28,
2823,0,31,3,28,
2824,0,34,4,30,
2825,0,32,3,29,
2826,0,31,3,28,
2827,0,35,4,31,
2828,0,32,3,29,
2829,0,35,4,31,
2830,0,33,3,30,
2831,0,32,3,29,
2832,0,36,4,32,
2833,0,34,3,31,
2834,0,33,3,30,
2835,0,34,4,30,
2836,0,35,3,32,
2837,0,35,3,32,
2838,0,34,3,31,
2839,0,36,4,32,
2840,0,36,3,33,
2841,0,35,3,32,
2842,0,38,4,34,
2843,0,36,3,33,
2844,0,35,3,32,
2845,0,39,4,35,
2846,0,37,3,34,
2847,0,36,3,33,
2848,0,39,4,35,
2849,0,37,3,34,
2850,0,37,3,34,
2851,0,39,4,35,
2852,0,37,3,34,
2853,0,39,4,35,
2854,0,39,5,34,
2855,0,40,4,36,
2856,0,39,3,36,
2857,0,40,4,36,
2858,0,41,5,36,
2859,0,39,3,36,
2860,0,39,3,36,
2861,0,42,4,38,
2862,0,40,3,37,
2863,0,39,3,36,
2864,0,42,4,38,
2865,0,44,6,38,
2866,0,44,6,38,
2867,0,45,7,38,
2868,0,45,7,38,
2869,0,44,6,38,
2870,0,45,7,38,
2871,0,45,7,38,
2872,0,45,6,39,
2873,0,46,7,39,
2874,0,45,6,39,
2875,0,46,7,39,
2876,0,46,7,39,
2877,0,46,6,40,
2878,0,47,7,40,
2879,0,47,7,40,
2880,0,46,6,40,
2881,0,47,7,40,
2882,0,46,6,40,
2883,0,48,7,41,
2884,0,47,7,40,
2885,0,47,6,41,
2886,0,48,7,41,
2887,0,44,3,41,
2888,0,44,4,40,
2889,0,46,4,42,
2890,0,46,4,42,
2891,0,45,3,42,
2892,0,44,3,41,
2893,0,45,4,41,
2894,0,45,3,42,
2895,0,46,3,43,
2896,0,45,3,42,
2897,0,47,4,43,
2898,0,48,4,44,
2899,0,46,3,43,
2900,0,46,3,43,
2901,0,46,4,42,
2902,0,47,3,44,
2903,0,48,4,44,
2904,0,46,3,43,
2905,0,48,4,44,
2906,0,47,3,44,
2907,0,46,3,43,
2908,0,50,4,46,
2909,0,48,3,45,
2910,0,47,3,44,
2911,0,50,4,46,
2912,0,47,3,44,
2913,0,49,4,45,
2914,0,49,5,44,
2915,0,49,3,46,
2916,0,49,3,46,
2917,0,48,3,45,
2918,0,50,4,46,
2919,0,50,4,46,
2920,0,48,3,45,
2921,0,51,4,47,
2922,0,50,3,47,
2923,0,49,3,46,
2924,0,52,4,48,
2925,0,50,3,47,
2926,0,49,3,46,
2927,0,51,4,47,
2928,0,49,3,46,
2929,0,52,4,48,
2930,0,51,3,48,
2931,0,50,3,47,
2932,0,53,4,49,
2933,0,50,3,47,
2934,0,51,4,47,
2935,0,53,4,49,
2936,0,51,3,48,
2937,0,52,3,49,
2938,0,53,4,49,
2939,0,53,4,49,
2940,0,52,3,49,
2941,0,51,3,48,
2942,0,53,4,49,
2943,0,52,3,49,
2944,0,52,3,49,
2945,0,55,4,51,
2946,0,53,3,50,
2947,0,52,3,49,
2948,0,56,5,51,
2949,0,54,4,50,
2950,0,53,3,50,
2951,0,53,4,49,
2952,0,54,3,51,
2953,0,55,4,51,
2954,0,55,5,50,
2955,0,55,4,51,
2956,0,54,3,51,
2957,0,53,3,50,
2958,0,56,4,52,
2959,0,54,3,51,
2960,0,54,3,51,
2961,0,57,4,53,
2962,0,55,3,52,
2963,0,54,3,51,
2964,0,56,4,52,
2965,0,56,4,52,
2966,0,54,3,51,
2967,0,55,4,51,
2968,0,57,4,53,
2969,0,58,4,54,
2970,0,55,3,52,
2971,0,57,4,53,
2972,0,56,3,53,
2973,0,56,4,52,
2974,0,58,4,54,
2975,0,56,3,53,
2976,0,56,3,53,
2977,0,59,4,55,
2978,0,57,3,54,
2979,0,58,4,54,
2980,0,57,3,54,
2981,0,58,4,54,
2982,0,57,3,54,
2983,0,56,3,53,
2984,0,58,4,54,
2985,0,58,3,55,
2986,0,57,3,54,
2987,0,60,4,56,
2988,0,58,3,55,
2989,0,59,4,55,
2990,0,58,3,55,
2991,0,57,3,54,
2992,0,59,4,55,
2993,0,58,3,55,
2994,0,59,4,55,
2995,0,62,5,57,
2996,0,59,3,56,
2997,0,58,3,55,
2998,0,61,4,57,
2999,0,59,3,56,
3000,0,58,3,55,
3001,0,59,4,55,
3002,0,59,3,56,
3003,0,61,4,57,
3004,0,60,3,57,
3005,0,62,6,56,
3006,0,63,6,57,
3007,0,64,7,57,
3008,0,63,6,57,
3009,0,64,7,57,
3010,0,64,7,57,
3011,0,63,6,57,
3012,0,65,7,58,
3013,0,64,7,57,
3014,0,64,6,58,
3015,0,65,7,58,
3016,0,64,6,58,
3017,0,65,7,58,
3018,0,65,7,58,
3019,0,64,6,58,
3020,0,65,7,58,
3021,0,66,7,59,
3022,0,65,6,59,
3023,0,66,7,59,
3024,0,65,6,59,
3025,0,66,7,59,
3026,0,65,7,58,
3027,0,65,6,59,
3028,0,66,7,59,
3029,0,67,7,60,
3030,0,67,7,60,
3031,0,66,6,60,
3032,0,67,7,60,
3033,0,67,7,60,
3034,0,66,6,60,
3035,0,67,7,60,
3036,0,66,6,60,
3037,0,67,7,60,
3038,0,66,7,59,
3039,0,67,6,61,
3040,0,68,7,61,
3041,0,67,6,61,
3042,0,68,7,61,
3043,0,68,7,61,
3044,0,67,6,61,
3045,0,68,7,61,
3046,0,66,6,60,
3047,0,67,6,61,
3048,0,68,7,61,
3049,0,68,6,62,
3050,0,69,7,62,
3051,0,68,7,61,
3052,0,69,7,62,
3053,0,69,7,62,
3054,0,68,6,62,
3055,0,69,7,62,
3056,0,69,7,62,
3057,0,68,6,62,
3058,0,69,7,62,
3059,0,69,7,62,
3060,0,69,6,63,
3061,0,70,7,63,
3062,0,69,6,63,
3063,0,70,7,63,
3064,0,71,7,64,
3065,0,69,6,63,
3066,0,70,7,63,
3067,0,70,7,63,
3068,0,69,6,63,
3069,0,70,7,63,
3070,0,70,6,64,
3071,0,71,7,64,
3072,0,71,7,64,
3073,0,71,7,64,
3074,0,71,7,64,
3075,0,70,6,64,
3076,0,71,7,64,
3077,0,71,7,64,
3078,0,70,6,64,
3079,0,72,7,65,
3080,0,71,7,64,
3081,0,72,7,65,
3082,0,71,7,64,
3083,0,71,6,65,
3084,0,72,7,65,
3085,0,71,6,65,
3086,0,72,7,65,
3087,0,72,7,65,
3088,0,71,6,65,
3089,0,73,7,66,
3090,0,72,7,65,
3091,0,72,6,66,
3092,0,73,7,66,
3093,0,72,6,66,
3094,0,71,6,65,
3095,0,71,5,66,
3096,0,69,3,66,
3097,0,69,4,65,
3098,0,71,4,67,
3099,0,69,3,66,
3100,0,71,4,67,
3101,0,72,4,68,
3102,0,70,3,67,
3103,0,69,3,66,
3104,0,72,4,68,
3105,0,70,3,67,
3106,0,69,3,66,
3107,0,70,4,66,
3108,0,70,3,67,
3109,0,70,3,67,
3110,0,70,4,66,
3111,0,72,4,68,
3112,0,71,3,68,
3113,0,72,4,68,
3114,0,70,3,67,
3115,0,71,4,67,
3116,0,70,3,67,
3117,0,73,4,69,
3118,0,71,3,68,
3119,0,70,3,67,
3120,0,72,4,68,
3121,0,70,3,67,
3122,0,74,4,70,
3123,0,72,3,69,
3124,0,73,4,69,
3125,0,72,3,69,
3126,0,72,4,68,
3127,0,73,4,69,
3128,0,72,3,69,
3129,0,71,3,68,
3130,0,73,4,69,
3131,0,73,5,68,
3132,0,73,4,69,
3133,0,73,3,70,
3134,0,72,3,69,
3135,0,74,4,70,
3136,0,73,3,70,
3137,0,72,3,69,
3138,0,75,4,71,
3139,0,73,3,70,
3140,0,72,3,69,
3141,0,75,4,71,
3142,0,73,3,70,
3143,0,72,3,69,
3144,0,75,4,71,
3145,0,73,3,70,
3146,0,73,3,70,
3147,0,73,4,69,
3148,0,73,3,70,
3149,0,75,4,71,
3150,0,73,3,70,
3151,0,73,4,69,
3152,0,74,4,70,
3153,0,73,3,70,
3154,0,72,3,69,
3155,0,71,5,66,
3156,0,62,3,59,
3157,0,57,4,53,
3158,0,51,4,47,
3159,0,45,3,42,
3160,0,44,3,41,
3161,0,47,5,42,
3162,0,42,3,39,
3163,0,39,4,35,
3164,0,35,3,32,
3165,0,32,3,29,
3166,0,32,4,28,
3167,0,29,3,26,
3168,0,27,3,24,
3169,0,29,4,25,
3170,0,31,3,28,
3171,0,32,3,29,
3172,0,39,4,35,
3173,0,43,4,39,
3174,0,48,4,44,
3175,0,45,3,42,
3176,0,46,4,42,
3177,0,48,4,44,
3178,0,46,3,43,
3179,0,47,3,44,
3180,0,47,4,43,
3181,0,46,3,43,
3182,0,49,4,45,
3183,0,47,3,44,
3184,0,46,3,43,
3185,0,48,4,44,
3186,0,48,3,45,
3187,0,49,4,45,
3188,0,48,3,45,
3189,0,47,3,44,
3190,0,50,4,46,
3191,0,48,3,45,
3192,0,50,4,46,
3193,0,49,3,46,
3194,0,49,4,45,
3195,0,51,4,47,
3196,0,49,3,46,
3197,0,51,4,47,
3198,0,50,3,47,
3199,0,49,3,46,
3200,0,51,4,47,
3201,0,50,3,47,
3202,0,51,4,47,
3203,0,51,3,48,
3204,0,51,4,47,
3205,0,51,3,48,
3206,0,51,3,48,
3207,0,52,4,48,
3208,0,50,3,47,
3209,0,53,4,49,
3210,0,53,3,50,
3211,0,51,3,48,
3212,0,53,4,49,
3213,0,52,3,49,
3214,0,51,3,48,
3215,0,53,4,49,
3216,0,53,4,49,
3217,0,53,3,50,
3218,0,53,3,50,
3219,0,55,5,50,
3220,0,52,3,49,
3221,0,55,4,51,
3222,0,55,4,51,
3223,0,53,3,50,
3224,0,56,4,52,
3225,0,54,3,51,
3226,0,54,3,51,
3227,0,54,4,50,
3228,0,54,3,51,
3229,0,55,3,52,
3230,0,54,3,51,
3231,0,56,4,52,
3232,0,55,3,52,
3233,0,54,3,51,
3234,0,57,4,53,
3235,0,55,3,52,
3236,0,55,3,52,
3237,0,58,4,54,
3238,0,56,3,53,
3239,0,56,3,53,
3240,0,56,4,52,
3241,0,55,3,52,
3242,0,58,4,54,
3243,0,57,3,54,
3244,0,56,3,53,
3245,0,57,4,53,
3246,0,58,4,54,
3247,0,56,3,53,
3248,0,57,4,53,
3249,0,58,4,54,
3250,0,60,4,56,
3251,0,58,3,55,
3252,0,57,3,54,
3253,0,60,4,56,
3254,0,58,4,54,
3255,0,60,4,56,
3256,0,58,3,55,
3257,0,57,3,54,
3258,0,61,4,57,
3259,0,59,3,56,
3260,0,58,3,55,
3261,0,61,4,57,
3262,0,59,3,56,
3263,0,58,3,55,
3264,0,61,4,57,
3265,0,60,3,57,
3266,0,60,3,57,
3267,0,61,5,56,
3268,0,60,3,57,
3269,0,60,3,57,
3270,0,59,3,56,
3271,0,61,4,57,
3272,0,61,5,56,
3273,0,61,3,58,
3274,0,61,3,58,
3275,0,60,3,57,
3276,0,62,4,58,
3277,0,61,3,58,
3278,0,60,3,57,
3279,0,63,4,59,
3280,0,63,5,58,
3281,0,61,3,58,
3282,0,64,4,60,
3283,0,62,3,59,
3284,0,61,3,58,
3285,0,62,4,58,
3286,0,63,4,59,
3287,0,61,3,58,
3288,0,61,3,58,
3289,0,64,4,60,
3290,0,63,3,60,
3291,0,62,3,59,
3292,0,64,4,60,
3293,0,63,3,60,
3294,0,62,3,59,
3295,0,65,5,60,
3296,0,64,4,60,
3297,0,65,4,61,
3298,0,66,4,62,
3299,0,64,3,61,
3300,0,63,3,60,
3301,0,66,4,62,
3302,0,65,4,61,
3303,0,64,3,61,
3304,0,64,4,60,
3305,0,64,3,61,
3306,0,67,4,63,
3307,0,65,3,62,
3308,0,65,4,61,
3309,0,66,4,62,
3310,0,64,3,61,
3311,0,66,4,62,
3312,0,64,3,61,
3313,0,65,4,61,
3314,0,68,4,64,
3315,0,66,3,63,
3316,0,65,3,62,
3317,0,67,4,63,
3318,0,66,3,63,
3319,0,66,3,63,
3320,0,66,4,62,
3321,0,66,3,63,
3322,0,66,3,63,
3323,0,66,3,63,
3324,0,68,4,64,
3325,0,67,3,64,
3326,0,66,3,63,
3327,0,69,4,65,
3328,0,66,3,63,
3329,0,68,4,64,
3330,0,67,3,64,
3331,0,66,3,63,
3332,0,70,4,66,
3333,0,68,3,65,
3334,0,67,3,64,
3335,0,70,4,66,
3336,0,68,3,65,
3337,0,71,6,65,
3338,0,68,3,65,
3339,0,67,3,64,
3340,0,70,4,66,
3341,0,71,4,67,
3342,0,69,3,66,
3343,0,72,5,67,
3344,0,69,3,66,
3345,0,70,4,66,
3346,0,69,3,66,
3347,0,68,3,65,
3348,0,70,4,66,
3349,0,69,3,66,
3350,0,69,3,66,
3351,0,71,4,67,
3352,0,70,3,67,
3353,0,69,3,66,
3354,0,72,4,68,
3355,0,70,3,67,
3356,0,69,3,66,
3357,0,72,4,68,
3358,0,70,3,67,
3359,0,71,3,68,
3360,0,71,4,67,
3361,0,70,3,67,
3362,0,72,4,68,
3363,0,72,4,68,
3364,0,70,3,67,
3365,0,71,4,67,
3366,0,70,3,67,
3367,0,73,4,69,
3368,0,72,3,69,
3369,0,71,3,68,
3370,0,74,4,70,
3371,0,72,3,69,
3372,0,72,3,69,
3373,0,72,4,68,
3374,0,72,3,69,
3375,0,72,3,69,
3376,0,72,4,68,
3377,0,73,4,69,
3378,0,73,3,70,
3379,0,72,3,69,
3380,0,74,4,70,
3381,0,73,3,70,
3382,0,72,3,69,
3383,0,75,4,71,
3384,0,73,3,70,
3385,0,72,3,69,
3386,0,74,4,70,
3387,0,72,3,69,
3388,0,74,4,70,
3389,0,73,4,69,
3390,0,73,3,70,
3391,0,73,3,70,
3392,0,72,3,69,
3393,0,74,5,69,
3394,0,75,4,71,
3395,0,73,3,70,
3396,0,73,3,70,
3397,0,74,4,70,
3398,0,66,3,63,
3399,0,61,4,57,
3400,0,54,3,51,
3401,0,47,3,44,
3402,0,45,5,40,
3403,0,44,3,41,
3404,0,46,4,42,
3405,0,41,3,38,
3406,0,38,3,35,
3407,0,34,3,31,
3408,0,29,4,25,
3409,0,24,3,21,
3410,0,20,3,17,
3411,0,19,4,15,
3412,0,15,3,12,
3413,0,15,3,12,
3414,0,17,4,13,
3415,0,19,3,16,
3416,0,26,3,23,
3417,0,29,3,26,
3418,0,32,4,28,
3419,0,32,4,28,
3420,0,30,3,27,
3421,0,33,4,29,
3422,0,32,3,29,
3423,0,33,4,29,
3424,0,34,4,30,
3425,0,33,3,30,
3426,0,33,3,30,
3427,0,33,4,29,
3428,0,33,3,30,
3429,0,34,3,31,
3430,0,34,4,30,
3431,0,35,4,31,
3432,0,34,3,31,
3433,0,36,4,32,
3434,0,34,3,31,
3435,0,36,4,32,
3436,0,34,3,31,
3437,0,38,4,34,
3438,0,36,3,33,
3439,0,35,3,32,
3440,0,39,4,35,
3441,0,37,3,34,
3442,0,36,3,33,
3443,0,37,4,33,
3444,0,37,3,34,
3445,0,37,3,34,
3446,0,38,4,34,
3447,0,38,4,34,
3448,0,39,4,35,
3449,0,40,4,36,
3450,0,38,3,35,
3451,0,40,4,36,
3452,0,39,3,36,
3453,0,39,3,36,
3454,0,40,4,36,
3455,0,40,3,37,
3456,0,40,3,37,
3457,0,39,3,36,
3458,0,41,4,37,
3459,0,41,4,37,
3460,0,44,5,39,
3461,0,40,3,37,
3462,0,42,4,38,
3463,0,42,4,38,
3464,0,43,4,39,
3465,0,42,3,39,
3466,0,43,4,39,
3467,0,41,3,38,
3468,0,45,4,41,
3469,0,43,3,40,
3470,0,43,3,40,
3471,0,43,4,39,
3472,0,43,3,40,
3473,0,44,3,41,
3474,0,44,4,40,
3475,0,45,4,41,
3476,0,44,3,41,
3477,0,43,3,40,
3478,0,46,4,42,
3479,0,45,3,42,
3480,0,44,3,41,
3481,0,47,4,43,
3482,0,45,3,42,
3483,0,44,3,41,
3484,0,47,4,43,
3485,0,46,4,42,
3486,0,47,4,43,
3487,0,46,4,42,
3488,0,46,3,43,
3489,0,47,3,44,
3490,0,46,3,43,
3491,0,48,4,44,
3492,0,47,3,44,
3493,0,48,4,44,
3494,0,48,4,44,
3495,0,48,4,44,
3496,0,48,3,45,
3497,0,48,3,45,
3498,0,47,3,44,
3499,0,49,4,45,
3500,0,48,3,45,
3501,0,48,3,45,
3502,0,51,4,47,
3503,0,49,3,46,
3504,0,48,3,45,
3505,0,51,4,47,
3506,0,49,3,46,
3507,0,50,3,47,
3508,0,50,4,46,
3509,0,51,4,47,
3510,0,51,4,47,
3511,0,49,3,46,
3512,0,50,4,46,
3513,0,51,4,47,
3514,0,50,3,47,
3515,0,52,4,48,
3516,0,51,3,48,
3517,0,50,3,47,
3518,0,52,4,48,
3519,0,53,5,48,
3520,0,52,3,49,
3521,0,52,4,48,
3522,0,52,3,49,
3523,0,52,3,49,
3524,0,52,4,48,
3525,0,54,5,49,
3526,0,53,3,50,
3527,0,53,4,49,
3528,0,54,4,50,
3529,0,53,3,50,
3530,0,52,3,49,
3531,0,55,4,51,
3532,0,53,3,50,
3533,0,53,3,50,
3534,0,56,4,52,
3535,0,54,3,51,
3536,0,53,3,50,
3537,0,54,4,50,
3538,0,54,3,51,
3539,0,54,3,51,
3540,0,54,3,51,
3541,0,56,4,52,
3542,0,55,3,52,
3543,0,54,3,51,
3544,0,56,4,52,
3545,0,55,4,51,
3546,0,56,3,53,
3547,0,58,4,54,
3548,0,56,3,53,
3549,0,55,3,52,
3550,0,56,4,52,
3551,0,56,3,53,
3552,0,56,3,53,
3553,0,55,3,52,
3554,0,58,4,54,
3555,0,59,4,55,
3556,0,57,3,54,
3557,0,57,3,54,
3558,0,57,4,53,
3559,0,57,3,54,
3560,0,57,3,54,
3561,0,57,3,54,
3562,0,59,4,55,
3563,0,58,3,55,
3564,0,57,3,54,
3565,0,59,4,55,
3566,0,58,3,55,
3567,0,57,3,54,
3568,0,61,4,57,
3569,0,60,4,56,
3570,0,60,5,55,
3571,0,62,5,57,
3572,0,59,3,56,
3573,0,58,3,55,
3574,0,59,4,55,
3575,0,62,6,56,
3576,0,60,3,57,
3577,0,59,3,56,
3578,0,61,4,57,
3579,0,62,4,58,
3580,0,60,3,57,
3581,0,60,3,57,
3582,0,60,4,56,
3583,0,61,3,58,
3584,0,61,3,58,
3585,0,62,5,57,
3586,0,61,4,57,
3587,0,61,4,57,
3588,0,61,3,58,
3589,0,61,3,58,
3590,0,60,3,57,
3591,0,63,4,59,
3592,0,62,3,59,
3593,0,61,3,58,
3594,0,64,4,60,
3595,0,62,3,59,
3596,0,61,3,58,
3597,0,64,4,60,
3598,0,62,3,59,
3599,0,61,3,58,
3600,0,64,4,60,
3601,0,63,4,59,
3602,0,65,4,61,
3603,0,63,3,60,
3604,0,62,3,59,
3605,0,65,4,61,
3606,0,63,3,60,
3607,0,62,3,59,
3608,0,64,4,60,
3609,0,65,4,61,
3610,0,64,4,60,
3611,0,64,4,60,
3612,0,64,4,60,
3613,0,65,4,61,
3614,0,63,3,60,
3615,0,65,4,61,
3616,0,66,4,62,
3617,0,66,4,62,
3618,0,65,3,62,
3619,0,65,4,61,
3620,0,65,3,62,
3621,0,66,4,62,
3622,0,65,3,62,
3623,0,64,3,61,
3624,0,65,4,61,
3625,0,67,4,63,
3626,0,68,4,64,
3627,0,66,3,63,
3628,0,67,4,63,
3629,0,66,3,63,
3630,0,65,3,62,
3631,0,68,4,64,
3632,0,66,3,63,
3633,0,66,3,63,
3634,0,69,4,65,
3635,0,67,3,64,
3636,0,59,1,58,
3637,0,47,,47,
3638,0,35,,35,
3639,0,23,,23,
3640,0,10,,10,
