window-id,queue-size-CL,queue-size-LL,10.0.0.13:34112 -> 10.0.1.13:3000,10.0.1.13:3000 -> 10.0.0.13:34112,10.0.0.13:55056 -> 10.0.1.13:1000
0,0,32,10,22,
1,0,33,8,25,
2,0,32,8,24,
3,0,29,8,21,
4,0,28,8,20,
5,0,27,8,19,
6,0,25,7,18,
7,0,26,8,18,
8,0,25,8,17,
9,0,25,8,17,
10,0,25,9,16,
11,0,24,8,16,
12,0,27,8,19,
13,0,26,8,18,
14,0,25,7,18,
15,0,27,10,17,
16,0,26,9,17,
17,0,25,8,17,
18,0,26,8,18,
19,0,25,8,17,
20,0,25,8,17,
21,0,26,8,18,
22,0,27,9,18,
23,0,24,7,17,
24,0,25,8,17,
25,0,27,11,16,
26,0,23,7,16,
27,0,27,10,17,
28,0,27,11,16,
29,0,24,8,16,
30,0,24,6,18,
31,0,22,6,16,
32,0,26,7,19,
33,0,23,6,17,
34,0,25,7,18,
35,0,23,7,16,
36,0,22,6,16,
37,0,22,7,15,
38,0,22,6,16,
39,0,24,7,17,
40,0,22,6,16,
41,0,22,6,16,
42,0,24,6,18,
43,0,25,7,18,
44,0,24,6,18,
45,0,23,7,16,
46,0,23,6,17,
47,0,22,6,16,
48,0,24,7,17,
49,0,23,6,17,
50,0,23,7,16,
51,0,23,6,17,
52,0,24,7,17,
53,0,23,6,17,
54,0,23,7,16,
55,0,25,7,18,
56,0,23,6,17,
57,0,23,7,16,
58,0,22,6,16,
59,0,22,7,15,
60,0,22,6,16,
61,0,25,7,18,
62,0,23,6,17,
63,0,23,7,16,
64,0,23,7,16,
65,0,24,7,17,
66,0,23,6,17,
67,0,25,7,18,
68,0,25,9,16,
69,0,24,6,18,
70,0,23,6,17,
71,0,24,7,17,
72,0,23,6,17,
73,0,23,7,16,
74,0,23,6,17,
75,0,22,6,16,
76,0,25,7,18,
77,0,24,6,18,
78,0,24,7,17,
79,0,22,6,16,
80,0,22,6,16,
81,0,22,7,15,
82,0,22,6,16,
83,0,23,7,16,
84,0,23,6,17,
85,0,24,7,17,
86,0,23,7,16,
87,0,23,6,17,
88,0,22,6,16,
89,0,26,7,19,
90,0,24,6,18,
91,0,23,6,17,
92,0,23,7,16,
93,0,22,7,15,
94,0,22,6,16,
95,0,21,6,15,
96,0,24,7,17,
97,0,22,6,16,
98,0,25,8,17,
99,0,22,6,16,
100,0,24,7,17,
101,0,24,7,17,
102,0,24,8,16,
103,0,22,6,16,
104,0,21,6,15,
105,0,23,7,16,
106,0,22,6,16,
107,0,22,7,15,
108,0,24,5,19,
109,0,25,7,18,
110,0,24,7,17,
111,0,24,6,18,
112,0,23,6,17,
113,0,24,8,16,
114,0,21,6,15,
115,0,23,7,16,
116,0,22,6,16,
117,0,21,6,15,
118,0,25,7,18,
119,0,23,6,17,
120,0,24,7,17,
121,0,23,6,17,
122,0,23,7,16,
123,0,23,6,17,
124,0,23,7,16,
125,0,24,7,17,
126,0,25,7,18,
127,0,24,6,18,
128,0,23,7,16,
129,0,24,7,17,
130,0,23,7,16,
131,0,23,6,17,
132,0,25,7,18,
133,0,24,7,17,
134,0,23,6,17,
135,0,24,6,18,
136,0,22,6,16,
137,0,26,7,19,
138,0,24,6,18,
139,0,24,7,17,
140,0,22,6,16,
141,0,23,7,16,
142,0,22,6,16,
143,0,24,7,17,
144,0,22,7,15,
145,0,23,6,17,
146,0,24,6,18,
147,0,24,6,18,
148,0,22,6,16,
149,0,24,7,17,
150,0,22,6,16,
151,0,23,7,16,
152,0,24,6,18,
153,0,23,6,17,
154,0,24,7,17,
155,0,26,7,19,
156,0,23,6,17,
157,0,24,7,17,
158,0,22,6,16,
159,0,23,6,17,
160,0,23,7,16,
161,0,23,6,17,
162,0,22,6,16,
163,0,25,7,18,
164,0,26,7,19,
165,0,24,6,18,
166,0,23,6,17,
167,0,23,6,17,
168,0,22,7,15,
169,0,22,6,16,
170,0,21,6,15,
171,0,24,7,17,
172,0,23,6,17,
173,0,23,7,16,
174,0,23,6,17,
175,0,22,6,16,
176,0,23,7,16,
177,0,23,6,17,
178,0,22,6,16,
179,0,25,7,18,
180,0,23,6,17,
181,0,25,7,18,
182,0,22,6,16,
183,0,24,7,17,
184,0,22,6,16,
185,0,24,7,17,
186,0,24,8,16,
187,0,24,7,17,
188,0,23,7,16,
189,0,22,6,16,
190,0,23,6,17,
191,0,24,7,17,
192,0,23,7,16,
193,0,24,6,18,
194,0,24,6,18,
195,0,25,7,18,
196,0,23,6,17,
197,0,25,7,18,
198,0,23,6,17,
199,0,23,7,16,
200,0,23,6,17,
201,0,22,6,16,
202,0,25,8,17,
203,0,24,6,18,
204,0,24,8,16,
205,0,25,7,18,
206,0,24,6,18,
207,0,24,7,17,
208,0,23,6,17,
209,0,22,6,16,
210,0,24,7,17,
211,0,23,6,17,
212,0,24,7,17,
213,0,22,6,16,
214,0,25,7,18,
215,0,24,7,17,
216,0,24,6,18,
217,0,23,7,16,
218,0,24,7,17,
219,0,26,7,19,
220,0,23,6,17,
221,0,24,7,17,
222,0,23,6,17,
223,0,23,7,16,
224,0,22,6,16,
225,0,23,6,17,
226,0,25,7,18,
227,0,23,6,17,
228,0,23,6,17,
229,0,24,7,17,
230,0,23,6,17,
231,0,21,6,15,
232,0,22,7,15,
233,0,23,7,16,
234,0,22,6,16,
235,0,22,7,15,
236,0,24,7,17,
237,0,22,6,16,
238,0,25,7,18,
239,0,23,6,17,
240,0,22,6,16,
241,0,25,7,18,
242,0,23,6,17,
243,0,23,7,16,
244,0,24,7,17,
245,0,24,7,17,
246,0,25,7,18,
247,0,23,6,17,
248,0,23,7,16,
249,0,22,7,15,
250,0,27,7,20,
251,0,24,6,18,
252,0,24,6,18,
253,0,25,7,18,
254,0,22,6,16,
255,0,23,7,16,
256,0,23,6,17,
257,0,26,7,19,
258,0,23,6,17,
259,0,26,7,19,
260,0,24,6,18,
261,0,22,6,16,
262,0,24,7,17,
263,0,24,7,17,
264,0,23,6,17,
265,0,27,8,19,
266,0,23,6,17,
267,0,25,7,18,
268,0,24,6,18,
269,0,23,6,17,
270,0,23,7,16,
271,0,22,6,16,
272,0,26,7,19,
273,0,22,7,15,
274,0,24,7,17,
275,0,24,7,17,
276,0,23,6,17,
277,0,25,7,18,
278,0,24,7,17,
279,0,26,7,19,
280,0,25,7,18,
281,0,23,6,17,
282,0,26,7,19,
283,0,23,6,17,
284,0,23,7,16,
285,0,23,6,17,
286,0,23,6,17,
287,0,24,7,17,
288,0,23,6,17,
289,0,22,6,16,
290,0,23,7,16,
291,0,22,6,16,
292,0,22,7,15,
293,0,23,6,17,
294,0,22,6,16,
295,0,25,7,18,
296,0,25,6,19,
297,0,23,6,17,
298,0,25,6,19,
299,0,23,6,17,
300,0,24,7,17,
301,0,22,6,16,
302,0,24,9,15,
303,0,8,3,5,
308,0,10,2,8,
309,0,24,8,16,
310,0,24,8,16,
311,0,22,6,16,
312,0,23,7,16,
313,0,23,7,16,
314,0,23,6,17,
315,0,21,6,15,
316,0,22,7,15,
317,0,22,6,16,
318,0,22,7,15,
319,0,24,7,17,
320,0,22,6,16,
321,0,25,7,18,
322,0,23,6,17,
323,0,22,6,16,
324,0,25,7,18,
325,0,24,7,17,
326,0,23,7,16,
327,0,25,7,18,
328,0,23,6,17,
329,0,22,6,16,
330,0,22,7,15,
331,0,24,7,17,
332,0,25,7,18,
333,0,24,6,18,
334,0,23,7,16,
335,0,24,6,18,
336,0,24,7,17,
337,0,22,6,16,
338,0,24,7,17,
339,0,22,6,16,
340,0,23,6,17,
341,0,23,7,16,
342,0,23,6,17,
343,0,23,6,17,
344,0,23,7,16,
345,0,24,6,18,
346,0,23,6,17,
347,0,21,6,15,
348,0,22,7,15,
349,0,22,6,16,
350,0,22,7,15,
351,0,24,7,17,
352,0,25,7,18,
353,0,24,7,17,
354,0,23,7,16,
355,0,23,6,17,
356,0,22,6,16,
357,0,23,7,16,
358,0,22,6,16,
359,0,23,6,17,
360,0,22,7,15,
361,0,23,6,17,
362,0,23,6,17,
363,0,24,7,17,
364,0,24,7,17,
365,0,23,6,17,
366,0,23,7,16,
367,0,23,6,17,
368,0,23,7,16,
369,0,24,7,17,
370,0,23,6,17,
371,0,24,7,17,
372,0,21,6,15,
373,0,25,7,18,
374,0,24,6,18,
375,0,24,6,18,
376,0,24,7,17,
377,0,25,7,18,
378,0,23,6,17,
379,0,24,7,17,
380,0,23,6,17,
381,0,24,7,17,
382,0,22,6,16,
383,0,24,7,17,
384,0,24,6,18,
385,0,25,7,18,
386,0,25,7,18,
387,0,22,6,16,
388,0,24,7,17,
389,0,23,6,17,
390,0,22,6,16,
391,0,24,7,17,
392,0,23,6,17,
393,0,26,7,19,
394,0,22,6,16,
395,0,25,7,18,
396,0,23,7,16,
397,0,23,6,17,
398,0,24,6,18,
399,0,26,7,19,
400,0,24,6,18,
401,0,26,7,19,
402,0,23,6,17,
403,0,25,7,18,
404,0,23,7,16,
405,0,23,6,17,
406,0,23,6,17,
407,0,22,6,16,
408,0,25,7,18,
409,0,23,6,17,
410,0,22,6,16,
411,0,25,7,18,
412,0,23,7,16,
413,0,22,6,16,
414,0,22,6,16,
415,0,22,6,16,
416,0,22,7,15,
417,0,24,7,17,
418,0,24,6,18,
419,0,23,6,17,
420,0,23,7,16,
421,0,24,6,18,
422,0,22,6,16,
423,0,21,6,15,
424,0,25,8,17,
425,0,24,6,18,
426,0,23,7,16,
427,0,23,6,17,
428,0,23,6,17,
429,0,23,7,16,
430,0,24,7,17,
431,0,22,6,16,
432,0,25,7,18,
433,0,24,6,18,
434,0,24,7,17,
435,0,23,7,16,
436,0,21,6,15,
437,0,25,7,18,
438,0,21,5,16,
439,0,24,8,16,
440,0,25,7,18,
441,0,24,6,18,
442,0,22,6,16,
443,0,25,7,18,
444,0,22,6,16,
445,0,24,7,17,
446,0,23,7,16,
447,0,25,7,18,
448,0,23,6,17,
449,0,22,6,16,
450,0,24,7,17,
451,0,23,6,17,
452,0,23,7,16,
453,0,23,6,17,
454,0,22,6,16,
455,0,24,7,17,
456,0,23,6,17,
457,0,24,7,17,
458,0,24,7,17,
459,0,23,6,17,
460,0,23,7,16,
461,0,23,6,17,
462,0,22,6,16,
463,0,24,7,17,
464,0,22,6,16,
465,0,26,7,19,
466,0,24,6,18,
467,0,23,6,17,
468,0,23,7,16,
469,0,21,6,15,
470,0,24,7,17,
471,0,22,6,16,
472,0,22,7,15,
473,0,23,6,17,
474,0,22,6,16,
475,0,24,7,17,
476,0,23,6,17,
477,0,24,7,17,
478,0,24,7,17,
479,0,23,6,17,
480,0,22,6,16,
481,0,24,7,17,
482,0,25,7,18,
483,0,22,6,16,
484,0,24,7,17,
485,0,22,6,16,
486,0,23,7,16,
487,0,24,6,18,
488,0,23,6,17,
489,0,26,9,17,
490,0,22,6,16,
491,0,21,6,15,
492,0,23,8,15,
493,0,23,7,16,
494,0,22,6,16,
495,0,22,7,15,
496,0,23,6,17,
497,0,22,6,16,
498,0,25,7,18,
499,0,23,6,17,
500,0,22,6,16,
501,0,24,7,17,
502,0,23,7,16,
503,0,25,7,18,
504,0,23,6,17,
505,0,23,7,16,
506,0,22,6,16,
507,0,24,8,16,
508,0,21,6,15,
509,0,22,7,15,
510,0,22,6,16,
511,0,21,6,15,
512,0,24,7,17,
513,0,24,6,18,
514,0,25,7,18,
515,0,25,7,18,
516,0,22,6,16,
517,0,26,7,19,
518,0,24,6,18,
519,0,23,6,17,
520,0,23,7,16,
521,0,21,6,15,
522,0,24,7,17,
523,0,22,7,15,
524,0,24,6,18,
525,0,23,6,17,
526,0,26,7,19,
527,0,23,6,17,
528,0,24,7,17,
529,0,22,6,16,
530,0,24,7,17,
531,0,23,6,17,
532,0,22,7,15,
533,0,23,6,17,
534,0,24,7,17,
535,0,22,6,16,
536,0,22,6,16,
537,0,25,8,17,
538,0,24,6,18,
539,0,22,6,16,
540,0,24,7,17,
541,0,22,6,16,
542,0,24,7,17,
543,0,24,6,18,
544,0,23,6,17,
545,0,25,7,18,
546,0,23,6,17,
547,0,24,6,18,
548,0,22,6,16,
549,0,24,7,17,
550,0,25,7,18,
551,0,23,6,17,
552,0,23,7,16,
553,0,25,7,18,
554,0,26,7,19,
555,0,24,6,18,
556,0,22,6,16,
557,0,25,7,18,
558,0,23,6,17,
559,0,24,7,17,
560,0,24,6,18,
561,0,23,6,17,
562,0,24,7,17,
563,0,23,6,17,
564,0,22,6,16,
565,0,24,7,17,
566,0,22,6,16,
567,0,23,7,16,
568,0,22,7,15,
569,0,23,6,17,
570,0,22,6,16,
571,0,24,7,17,
572,0,24,6,18,
573,0,24,6,18,
574,0,23,7,16,
575,0,27,9,18,
576,0,29,12,17,
577,0,28,11,17,
578,0,31,13,18,
579,0,29,13,16,
580,0,29,13,16,
581,0,28,12,16,
582,0,30,13,17,
583,0,30,13,17,
584,0,30,13,17,
585,0,29,11,18,
586,0,29,12,17,
587,0,30,12,18,
588,0,30,13,17,
589,0,27,11,16,
590,0,28,12,16,
591,0,31,13,18,
592,0,30,12,18,
593,0,30,13,17,
594,0,30,12,18,
595,0,31,12,19,
596,0,29,11,18,
597,0,31,13,18,
598,0,28,12,16,
599,0,29,13,16,
600,0,29,13,16,
601,0,29,11,18,
602,0,30,12,18,
603,0,28,12,16,
604,0,30,13,17,
605,0,29,12,17,
606,0,30,13,17,
607,0,27,11,16,
608,0,30,13,17,
609,0,30,13,17,
610,0,29,13,16,
611,0,28,12,16,
612,0,28,12,16,
613,0,31,14,17,
614,0,29,13,16,
615,0,28,11,17,
616,0,30,13,17,
617,0,30,13,17,
618,0,28,12,16,
619,0,29,13,16,
620,0,32,13,19,
621,0,29,12,17,
622,0,29,13,16,
623,0,30,14,16,
624,0,29,12,17,
625,0,29,12,17,
626,0,22,6,16,
627,0,23,7,16,
628,0,25,7,18,
629,0,22,6,16,
630,0,21,6,15,
631,0,23,7,16,
632,0,22,6,16,
633,0,22,6,16,
634,0,25,7,18,
635,0,23,6,17,
636,0,23,6,17,
637,0,23,7,16,
638,0,23,6,17,
639,0,25,7,18,
640,0,25,6,19,
641,0,23,6,17,
642,0,24,7,17,
643,0,22,6,16,
644,0,21,6,15,
645,0,23,8,15,
646,0,22,6,16,
647,0,23,7,16,
648,0,23,6,17,
649,0,24,7,17,
650,0,22,6,16,
651,0,23,7,16,
652,0,23,6,17,
653,0,22,6,16,
654,0,23,7,16,
655,0,24,6,18,
656,0,24,7,17,
657,0,23,7,16,
658,0,23,7,16,
659,0,23,7,16,
660,0,22,6,16,
661,0,21,6,15,
662,0,25,7,18,
663,0,23,6,17,
664,0,23,6,17,
665,0,23,7,16,
666,0,23,6,17,
667,0,23,6,17,
668,0,23,7,16,
669,0,23,6,17,
670,0,26,7,19,
671,0,24,6,18,
672,0,23,6,17,
673,0,22,6,16,
674,0,22,7,15,
675,0,25,7,18,
676,0,24,7,17,
677,0,23,6,17,
678,0,22,6,16,
679,0,25,7,18,
680,0,23,6,17,
681,0,23,7,16,
682,0,25,7,18,
683,0,23,6,17,
684,0,23,7,16,
685,0,22,6,16,
686,0,22,7,15,
687,0,22,6,16,
688,0,22,7,15,
689,0,25,7,18,
690,0,26,7,19,
691,0,23,7,16,
692,0,24,6,18,
693,0,23,6,17,
694,0,25,7,18,
695,0,22,6,16,
696,0,25,7,18,
697,0,26,7,19,
698,0,25,6,19,
699,0,25,7,18,
700,0,24,7,17,
701,0,22,6,16,
702,0,21,6,15,
703,0,23,7,16,
704,0,21,6,15,
705,0,23,7,16,
706,0,23,6,17,
707,0,22,6,16,
708,0,24,7,17,
709,0,23,6,17,
710,0,23,7,16,
711,0,23,6,17,
712,0,22,6,16,
713,0,25,7,18,
714,0,25,6,19,
715,0,24,6,18,
716,0,24,7,17,
717,0,23,6,17,
718,0,23,6,17,
719,0,24,7,17,
720,0,25,6,19,
721,0,24,7,17,
722,0,24,6,18,
723,0,25,7,18,
724,0,23,6,17,
725,0,23,7,16,
726,0,24,6,18,
727,0,23,6,17,
728,0,23,7,16,
729,0,21,6,15,
730,0,23,7,16,
731,0,22,7,15,
732,0,23,6,17,
733,0,25,6,19,
734,0,24,7,17,
735,0,22,6,16,
736,0,22,7,15,
737,0,23,7,16,
738,0,21,6,15,
739,0,22,7,15,
740,0,23,6,17,
741,0,22,6,16,
742,0,25,7,18,
743,0,23,6,17,
744,0,23,7,16,
745,0,23,6,17,
746,0,22,6,16,
747,0,25,7,18,
748,0,23,6,17,
749,0,24,7,17,
750,0,29,12,17,
751,0,29,12,17,
752,0,29,11,18,
753,0,31,13,18,
754,0,30,14,16,
755,0,29,13,16,
756,0,28,12,16,
757,0,27,9,18,
758,0,24,7,17,
759,0,22,6,16,
760,0,22,6,16,
761,0,24,7,17,
762,0,23,6,17,
763,0,23,7,16,
764,0,24,6,18,
765,0,25,7,18,
766,0,24,7,17,
767,0,24,7,17,
768,0,23,7,16,
769,0,23,6,17,
770,0,23,6,17,
771,0,23,7,16,
772,0,23,6,17,
773,0,22,6,16,
774,0,25,7,18,
775,0,23,6,17,
776,0,24,7,17,
777,0,22,6,16,
778,0,21,6,15,
779,0,24,7,17,
780,0,22,6,16,
781,0,22,7,15,
782,0,22,6,16,
783,0,24,7,17,
784,0,24,6,18,
785,0,24,7,17,
786,0,24,6,18,
787,0,23,6,17,
788,0,26,7,19,
789,0,24,7,17,
790,0,23,7,16,
791,0,23,6,17,
792,0,24,8,16,
793,0,24,7,17,
794,0,26,7,19,
795,0,23,6,17,
796,0,22,6,16,
797,0,22,6,16,
798,0,24,7,17,
799,0,24,6,18,
800,0,25,8,17,
801,0,22,6,16,
802,0,24,7,17,
803,0,23,6,17,
804,0,22,6,16,
805,0,25,7,18,
806,0,23,6,17,
807,0,24,7,17,
808,0,23,6,17,
809,0,24,7,17,
810,0,23,7,16,
811,0,24,7,17,
812,0,25,7,18,
813,0,22,6,16,
814,0,24,7,17,
815,0,23,6,17,
816,0,22,7,15,
817,0,22,6,16,
818,0,28,7,21,
819,0,24,6,18,
820,0,23,7,16,
821,0,24,7,17,
822,0,23,6,17,
823,0,25,6,19,
824,0,23,6,17,
825,0,23,7,16,
826,0,21,6,15,
827,0,22,7,15,
828,0,22,6,16,
829,0,22,7,15,
830,0,24,7,17,
831,0,23,6,17,
832,0,23,7,16,
833,0,23,6,17,
834,0,22,6,16,
835,0,24,7,17,
836,0,23,6,17,
837,0,23,7,16,
838,0,24,6,18,
839,0,23,6,17,
840,0,25,8,17,
841,0,23,6,17,
842,0,23,7,16,
843,0,23,6,17,
844,0,25,7,18,
845,0,23,7,16,
846,0,23,6,17,
847,0,24,6,18,
848,0,25,7,18,
849,0,24,6,18,
850,0,23,6,17,
851,0,24,7,17,
852,0,23,7,16,
853,0,22,6,16,
854,0,23,7,16,
855,0,21,5,16,
856,0,24,7,17,
857,0,22,6,16,
858,0,23,7,16,
859,0,23,6,17,
860,0,22,6,16,
861,0,23,7,16,
862,0,23,6,17,
863,0,23,7,16,
864,0,24,6,18,
865,0,23,6,17,
866,0,23,7,16,
867,0,22,6,16,
868,0,21,6,15,
869,0,23,7,16,
870,0,24,7,17,
871,0,24,7,17,
872,0,22,6,16,
873,0,21,6,15,
874,0,24,7,17,
875,0,22,6,16,
876,0,27,7,20,
877,0,24,6,18,
878,0,28,11,17,
879,0,30,13,17,
880,0,27,11,16,
881,0,29,13,16,
882,0,30,13,17,
883,0,30,14,16,
884,0,29,13,16,
885,0,29,13,16,
886,0,30,12,18,
887,0,30,13,17,
888,0,29,12,17,
889,0,29,12,17,
890,0,29,11,18,
891,0,24,8,16,
892,0,25,9,16,
893,0,27,10,17,
894,0,30,13,17,
895,0,28,12,16,
896,0,31,13,18,
897,0,31,13,18,
898,0,27,11,16,
899,0,29,13,16,
900,0,27,12,15,
901,0,30,13,17,
902,0,30,12,18,
903,0,31,13,18,
904,0,28,12,16,
905,0,28,12,16,
906,0,30,13,17,
907,0,27,10,17,
908,0,25,10,15,
909,0,28,11,17,
910,0,27,11,16,
911,0,29,12,17,
912,0,28,11,17,
913,0,24,7,17,
914,0,29,11,17,1
915,0,24,7,17,
916,0,24,7,17,
917,0,26,8,18,
918,0,23,6,17,
919,0,23,6,17,
920,0,23,7,16,
921,0,23,6,17,
922,0,24,7,16,1
923,0,25,7,18,
924,0,24,6,18,
925,0,23,6,17,
926,0,21,6,15,
927,0,24,7,17,
928,0,22,6,16,
929,0,23,7,15,1
930,0,23,6,17,
931,0,24,7,17,
932,0,23,6,17,
933,0,22,6,16,
934,0,24,7,17,
935,0,23,7,16,
936,0,23,6,17,
937,0,21,6,15,
938,0,26,7,19,
939,0,24,7,17,
940,0,23,7,16,
941,0,25,6,19,
942,0,27,8,19,
943,0,24,6,18,
944,0,23,6,17,
945,0,25,7,17,1
946,0,23,6,17,
947,0,22,7,15,
948,0,23,7,16,
949,0,23,7,16,
950,0,26,7,19,
951,0,24,6,18,
952,0,24,6,18,
953,0,22,6,16,
954,0,25,7,18,
955,0,24,6,18,
956,0,24,7,17,
957,0,22,6,16,
958,0,21,6,15,
959,0,23,7,16,
960,0,25,7,17,1
961,0,22,6,16,
962,0,21,6,15,
963,0,25,7,18,
964,0,24,6,18,
965,0,26,7,19,
966,0,25,7,18,
967,0,23,6,17,
968,0,25,7,18,
969,0,23,6,17,
970,0,23,7,16,
971,0,26,7,19,
972,0,25,8,17,
973,0,24,6,18,
974,0,24,8,16,
975,0,21,6,15,
976,0,24,7,17,
977,0,22,7,15,
978,0,24,6,18,
979,0,22,6,16,
980,0,23,7,16,
981,0,25,7,18,
982,0,23,6,17,
983,0,21,6,15,
984,0,24,7,17,
985,0,22,6,16,
986,0,23,7,16,
987,0,23,6,17,
988,0,22,6,16,
989,0,24,7,17,
990,0,25,7,17,1
991,0,23,7,16,
992,0,25,7,18,
993,0,24,7,17,
994,0,23,7,16,
995,0,22,6,16,
996,0,24,7,17,
997,0,24,6,18,
998,0,24,7,17,
999,0,22,6,16,
1000,0,22,7,15,
1001,0,23,6,17,
1002,0,22,6,16,
1003,0,22,7,15,
1004,0,23,6,17,
1005,0,24,6,18,
1006,0,24,6,18,
1007,0,22,6,16,
1008,0,24,7,17,
1009,0,22,6,16,
1010,0,26,7,19,
1011,0,24,6,18,
1012,0,24,7,17,
1013,0,24,6,18,
1014,0,23,6,17,
1015,0,23,7,16,
1016,0,23,6,17,
1017,0,23,7,16,
1018,0,24,7,17,
1019,0,25,6,19,
1020,0,26,7,18,1
1021,0,24,7,17,
1022,0,23,6,17,
1023,0,24,6,18,
1024,0,22,6,16,
1025,0,24,7,17,
1026,0,25,7,18,
1027,0,25,7,18,
1028,0,22,6,16,
1029,0,25,6,19,
1030,0,25,8,17,
1031,0,24,6,18,
1032,0,23,6,17,
1033,0,28,10,18,
1034,0,24,7,17,
1035,0,28,10,18,
1036,0,26,9,17,
1037,0,23,8,15,
1038,0,26,7,19,
1039,0,24,7,17,
1040,0,26,7,19,
1041,0,24,6,18,
1042,0,24,7,17,
1043,0,22,6,16,
1044,0,22,7,15,
1045,0,23,6,17,
1046,0,23,6,17,
1047,0,23,6,17,
1048,0,23,7,16,
1049,0,25,7,18,
1050,0,24,6,18,
1051,0,26,7,18,1
1052,0,23,6,17,
1053,0,24,7,17,
1054,0,23,7,16,
1055,0,24,7,17,
1056,0,24,6,18,
1057,0,26,7,19,
1058,0,23,6,17,
1059,0,25,7,18,
1060,0,26,8,18,
1061,0,24,6,18,
1062,0,24,7,17,
1063,0,22,7,15,
1064,0,24,7,17,
1065,0,24,6,18,
1066,0,23,6,17,
1067,0,24,7,17,
1068,0,23,6,17,
1069,0,24,6,18,
1070,0,23,7,16,
1071,0,23,6,17,
1072,0,22,6,16,
1073,0,25,7,18,
1074,0,23,6,17,
1075,0,24,7,17,
1076,0,22,6,16,
1077,0,21,6,15,
1078,0,22,7,15,
1079,0,22,6,16,
1080,0,21,6,15,
1081,0,24,7,16,1
1082,0,24,7,17,
1083,0,25,7,18,
1084,0,23,6,17,
1085,0,24,6,18,
1086,0,26,7,19,
1087,0,24,6,18,
1088,0,25,7,18,
1089,0,23,6,17,
1090,0,23,7,16,
1091,0,22,6,16,
1092,0,22,7,15,
1093,0,23,7,16,
1094,0,24,7,17,
1095,0,26,8,18,
1096,0,24,7,17,
1097,0,22,6,16,
1098,0,23,7,16,
1099,0,22,6,16,
1100,0,23,6,17,
1101,0,24,7,17,
1102,0,24,6,18,
1103,0,23,7,16,
1104,0,25,7,18,
1105,0,23,6,17,
1106,0,22,6,16,
1107,0,25,7,18,
1108,0,23,6,17,
1109,0,24,7,17,
1110,0,22,6,16,
1111,0,23,7,15,1
1112,0,21,6,15,
1113,0,25,7,18,
1114,0,23,6,17,
1115,0,25,7,18,
1116,0,22,6,16,
1117,0,23,7,16,
1118,0,22,7,15,
1119,0,22,6,16,
1120,0,25,7,18,
1121,0,25,9,16,
1122,0,26,8,18,
1123,0,24,6,18,
1124,0,24,7,17,
1125,0,22,6,16,
1126,0,25,8,17,
1127,0,23,7,16,
1128,0,24,7,17,
1129,0,22,7,15,
1130,0,22,6,16,
1131,0,21,6,15,
1132,0,26,7,19,
1133,0,24,6,18,
1134,0,22,6,16,
1135,0,24,7,17,
1136,0,23,6,17,
1137,0,24,7,17,
1138,0,24,6,18,
1139,0,23,7,16,
1140,0,23,6,17,
1141,0,25,6,19,
1142,0,24,6,17,1
1143,0,22,6,16,
1144,0,25,7,18,
1145,0,23,6,17,
1146,0,24,7,17,
1147,0,22,6,16,
1148,0,23,7,16,
1149,0,23,7,16,
1150,0,22,6,16,
1151,0,24,7,17,
1152,0,23,6,17,
1153,0,23,6,17,
1154,0,24,7,17,
1155,0,23,7,16,
1156,0,24,7,17,
1157,0,24,7,17,
1158,0,23,7,16,
1159,0,24,6,18,
1160,0,26,7,19,
1161,0,24,6,18,
1162,0,22,6,16,
1163,0,21,6,15,
1164,0,23,7,16,
1165,0,22,6,16,
1166,0,22,7,15,
1167,0,23,6,17,
1168,0,22,6,16,
1169,0,25,7,18,
1170,0,23,6,17,
1171,0,22,6,16,
1172,0,24,7,16,1
1173,0,26,8,18,
1174,0,23,7,16,
1175,0,23,6,17,
1176,0,22,6,16,
1177,0,25,7,18,
1178,0,24,6,18,
1179,0,24,7,17,
1180,0,22,6,16,
1181,0,23,7,16,
1182,0,22,6,16,
1183,0,22,7,15,
1184,0,24,7,17,
1185,0,22,6,16,
1186,0,24,7,17,
1187,0,25,6,19,
1188,0,23,6,17,
1189,0,25,7,18,
1190,0,23,6,17,
1191,0,22,7,15,
1192,0,22,6,16,
1193,0,22,6,16,
1194,0,23,6,17,
1195,0,24,7,17,
1196,0,23,6,17,
1197,0,22,6,16,
1198,0,24,7,17,
1199,0,23,6,17,
1200,0,23,7,16,
1201,0,23,6,17,
1202,0,22,6,15,1
1203,0,23,7,16,
1204,0,22,6,16,
1205,0,26,7,19,
1206,0,24,6,18,
1207,0,23,6,17,
1208,0,25,7,18,
1209,0,23,6,17,
1210,0,25,7,18,
1211,0,25,8,17,
1212,0,25,8,17,
1213,0,25,7,18,
1214,0,24,7,17,
1215,0,25,7,18,
1216,0,24,6,18,
1217,0,24,7,17,
1218,0,25,7,18,
1219,0,24,7,17,
1220,0,24,7,17,
1221,0,22,6,16,
1222,0,23,7,16,
1223,0,21,6,15,
1224,0,23,7,16,
1225,0,22,5,17,
1226,0,25,7,18,
1227,0,24,6,18,
1228,0,24,7,17,
1229,0,22,6,16,
1230,0,21,6,15,
1231,0,23,7,16,
1232,0,22,6,16,
1233,0,27,7,19,1
1234,0,25,7,18,
1235,0,24,6,18,
1236,0,23,7,16,
1237,0,23,5,18,
1238,0,23,7,16,
1239,0,21,6,15,
1240,0,23,8,15,
1241,0,22,7,15,
1242,0,22,6,16,
1243,0,24,7,17,
1244,0,25,6,19,
1245,0,13,3,10,
1246,0,16,6,10,
1247,0,22,7,15,
1248,0,23,6,17,
1249,0,24,6,18,
1250,0,22,6,16,
1251,0,24,7,17,
1252,0,23,6,17,
1253,0,22,6,16,
1254,0,24,7,17,
1255,0,23,6,17,
1256,0,25,7,18,
1257,0,22,6,16,
1258,0,25,7,18,
1259,0,23,6,17,
1260,0,23,6,17,
1261,0,22,7,15,
1262,0,22,6,16,
1263,0,26,7,18,1
1264,0,22,6,16,
1265,0,23,8,15,
1266,0,25,7,18,
1267,0,23,6,17,
1268,0,22,6,16,
1269,0,24,7,17,
1270,0,24,6,18,
1271,0,23,7,16,
1272,0,23,6,17,
1273,0,22,6,16,
1274,0,25,6,19,
1275,0,24,7,17,
1276,0,24,7,17,
1277,0,24,7,17,
1278,0,23,6,17,
1279,0,22,6,16,
1280,0,23,7,16,
1281,0,22,6,16,
1282,0,22,6,16,
1283,0,24,7,17,
1284,0,22,6,16,
1285,0,23,6,17,
1286,0,24,8,16,
1287,0,23,6,17,
1288,0,22,6,16,
1289,0,24,6,18,
1290,0,24,7,17,
1291,0,22,6,16,
1292,0,21,6,15,
1293,0,22,7,15,
1294,0,23,6,16,1
1295,0,24,7,17,
1296,0,22,6,16,
1297,0,24,7,17,
1298,0,23,6,17,
1299,0,23,7,16,
1300,0,23,6,17,
1301,0,26,7,19,
1302,0,24,7,17,
1303,0,26,7,19,
1304,0,28,7,21,
1305,0,29,7,22,
1306,0,28,7,21,
1307,0,30,6,24,
1308,0,32,7,25,
1309,0,31,6,25,
1310,0,34,7,27,
1311,0,34,7,27,
1312,0,34,7,27,
1313,0,35,6,29,
1314,0,35,6,29,
1315,0,37,7,30,
1316,0,36,6,30,
1317,0,39,7,32,
1318,0,38,6,32,
1319,0,39,7,32,
1320,0,40,7,33,
1321,0,40,6,34,
1322,0,40,7,33,
1323,0,41,6,35,
1324,0,41,6,34,1
1325,0,43,7,36,
1326,0,44,7,37,
1327,0,43,6,37,
1328,0,42,6,36,
1329,0,44,7,37,
1330,0,44,6,38,
1331,0,44,7,37,
1332,0,45,6,39,
1333,0,46,7,39,
1334,0,45,6,39,
1335,0,48,7,41,
1336,0,47,7,40,
1337,0,46,6,40,
1338,0,48,7,41,
1339,0,47,6,41,
1340,0,49,8,41,
1341,0,48,6,42,
1342,0,48,6,42,
1343,0,52,10,42,
1344,0,53,9,44,
1345,0,52,8,44,
1346,0,49,6,43,
1347,0,50,7,43,
1348,0,53,7,46,
1349,0,51,6,45,
1350,0,51,7,44,
1351,0,52,6,46,
1352,0,53,7,46,
1353,0,54,7,47,
1354,0,54,6,47,1
1355,0,54,7,47,
1356,0,54,7,47,
1357,0,53,6,47,
1358,0,54,7,47,
1359,0,54,6,48,
1360,0,55,7,48,
1361,0,55,6,49,
1362,0,55,6,49,
1363,0,55,7,48,
1364,0,56,6,50,
1365,0,55,6,49,
1366,0,56,7,49,
1367,0,58,7,51,
1368,0,57,7,50,
1369,0,57,6,51,
1370,0,58,7,51,
1371,0,57,6,51,
1372,0,59,7,52,
1373,0,58,6,52,
1374,0,59,7,52,
1375,0,59,6,53,
1376,0,58,6,52,
1377,0,59,7,52,
1378,0,61,7,54,
1379,0,60,6,54,
1380,0,59,6,53,
1381,0,61,7,54,
1382,0,61,6,55,
1383,0,61,7,54,
1384,0,61,6,55,
1385,0,62,7,54,1
1386,0,64,8,56,
1387,0,61,6,55,
1388,0,64,7,57,
1389,0,62,6,56,
1390,0,62,6,56,
1391,0,65,7,58,
1392,0,63,6,57,
1393,0,64,8,56,
1394,0,64,6,58,
1395,0,63,6,57,
1396,0,65,8,57,
1397,0,66,7,59,
1398,0,65,6,59,
1399,0,64,6,58,
1400,0,66,7,59,
1401,0,66,8,58,
1402,0,66,6,60,
1403,0,65,6,59,
1404,0,67,7,60,
1405,0,65,6,59,
1406,0,66,7,59,
1407,0,67,6,61,
1408,0,67,7,60,
1409,0,67,6,61,
1410,0,67,7,60,
1411,0,68,6,62,
1412,0,67,6,61,
1413,0,69,7,62,
1414,0,68,6,62,
1415,0,70,8,61,1
1416,0,68,6,62,
1417,0,70,7,63,
1418,0,69,6,63,
1419,0,69,7,62,
1420,0,69,6,63,
1421,0,69,6,63,
1422,0,71,7,64,
1423,0,72,7,65,
1424,0,70,7,63,
1425,0,71,6,65,
1426,0,71,6,65,
1427,0,72,8,64,
1428,0,71,6,65,
1429,0,70,6,64,
1430,0,73,7,66,
1431,0,71,6,65,
1432,0,74,7,67,
1433,0,73,7,66,
1434,0,74,7,67,
1435,0,73,6,67,
1436,0,72,6,66,
1437,0,74,7,67,
1438,0,73,6,67,
1439,0,74,8,66,
1440,0,74,6,68,
1441,0,73,6,67,
1442,0,75,7,68,
1443,0,74,6,68,
1444,0,73,6,67,
1445,0,77,7,69,1
1446,0,76,7,69,
1447,0,76,7,69,
1448,0,74,6,68,
1449,0,76,7,69,
1450,0,75,6,69,
1451,0,78,7,71,
1452,0,76,6,70,
1453,0,75,6,69,
1454,0,78,7,71,
1455,0,77,7,70,
1456,0,76,6,70,
1457,0,80,8,72,
1458,0,77,6,71,
1459,0,77,7,70,
1460,0,77,6,71,
1461,0,77,6,71,
1462,0,79,7,72,
1463,0,77,6,71,
1464,0,79,7,72,
1465,0,77,6,71,
1466,0,78,7,71,
1467,0,79,6,73,
1468,0,78,6,72,
1469,0,80,7,73,
1470,0,78,6,72,
1471,0,81,7,74,
1472,0,80,6,74,
1473,0,79,6,73,
1474,0,81,7,74,
1475,0,80,6,74,
1476,0,81,7,73,1
1477,0,81,7,74,
1478,0,80,6,74,
1479,0,83,7,76,
1480,0,81,6,75,
1481,0,80,6,74,
1482,0,83,7,76,
1483,0,81,6,75,
1484,0,83,8,75,
1485,0,81,6,75,
1486,0,83,7,76,
1487,0,83,7,76,
1488,0,82,6,76,
1489,0,82,7,75,
1490,0,82,6,76,
1491,0,81,6,75,
1492,0,83,7,76,
1493,0,82,7,75,
1494,0,82,6,76,
1495,0,75,6,69,
1496,0,64,7,57,
1497,0,54,6,48,
1498,0,55,7,48,
1499,0,47,6,41,
1500,0,43,6,37,
1501,0,39,7,32,
1502,0,38,6,32,
1503,0,43,7,36,
1504,0,47,6,41,
1505,0,56,7,49,
1506,0,57,7,49,1
1507,0,55,6,49,
1508,0,55,6,49,
1509,0,57,7,50,
1510,0,55,6,49,
1511,0,57,7,50,
1512,0,57,6,51,
1513,0,56,6,50,
1514,0,59,7,52,
1515,0,57,6,51,
1516,0,60,7,53,
1517,0,59,6,53,
1518,0,58,6,52,
1519,0,61,7,54,
1520,0,60,6,54,
1521,0,61,7,54,
1522,0,60,7,53,
1523,0,62,7,55,
1524,0,60,6,54,
1525,0,63,7,56,
1526,0,61,6,55,
1527,0,61,6,55,
1528,0,64,7,57,
1529,0,62,6,56,
1530,0,63,7,56,
1531,0,63,6,57,
1532,0,62,6,56,
1533,0,64,7,57,
1534,0,64,6,58,
1535,0,63,6,57,
1536,0,66,7,58,1
1537,0,65,7,58,
1538,0,65,7,58,
1539,0,65,6,59,
1540,0,64,6,58,
1541,0,67,7,60,
1542,0,66,6,60,
1543,0,66,7,59,
1544,0,66,6,60,
1545,0,67,6,61,
1546,0,67,7,60,
1547,0,67,6,61,
1548,0,67,7,60,
1549,0,69,7,62,
1550,0,67,6,61,
1551,0,68,7,61,
1552,0,68,7,61,
1553,0,69,6,63,
1554,0,69,6,63,
1555,0,69,7,62,
1556,0,70,7,63,
1557,0,71,7,64,
1558,0,69,6,63,
1559,0,70,7,63,
1560,0,70,6,64,
1561,0,71,7,64,
1562,0,72,7,65,
1563,0,71,6,65,
1564,0,71,7,64,
1565,0,73,7,66,
1566,0,71,6,65,
1567,0,74,7,66,1
1568,0,72,7,65,
1569,0,73,6,67,
1570,0,72,6,66,
1571,0,74,7,67,
1572,0,72,6,66,
1573,0,76,7,69,
1574,0,74,6,68,
1575,0,75,8,67,
1576,0,74,7,67,
1577,0,74,7,67,
1578,0,75,7,68,
1579,0,75,7,68,
1580,0,76,7,69,
1581,0,74,6,68,
1582,0,76,7,69,
1583,0,76,6,70,
1584,0,76,7,69,
1585,0,75,6,69,
1586,0,77,7,70,
1587,0,77,6,71,
1588,0,77,7,70,
1589,0,77,6,71,
1590,0,77,6,71,
1591,0,77,7,70,
1592,0,78,6,72,
1593,0,77,6,71,
1594,0,79,7,72,
1595,0,78,6,72,
1596,0,79,7,72,
1597,0,80,7,72,1
1598,0,78,6,72,
1599,0,81,7,74,
1600,0,79,6,73,
1601,0,79,6,73,
1602,0,81,7,74,
1603,0,79,6,73,
1604,0,80,7,73,
1605,0,80,6,74,
1606,0,84,8,76,
1607,0,81,7,74,
1608,0,80,6,74,
1609,0,82,7,75,
1610,0,81,6,75,
1611,0,82,7,75,
1612,0,82,6,76,
1613,0,81,6,75,
1614,0,83,7,76,
1615,0,82,6,76,
1616,0,82,7,75,
1617,0,82,6,76,
1618,0,82,6,76,
1619,0,82,7,75,
1620,0,82,6,76,
1621,0,77,6,71,
1622,0,66,7,59,
1623,0,54,7,47,
1624,0,53,6,47,
1625,0,49,7,42,
1626,0,39,6,33,
1627,0,33,7,25,1
1628,0,26,7,19,
1629,0,22,6,16,
1630,0,32,7,25,
1631,0,39,6,33,
1632,0,40,7,33,
1633,0,40,6,34,
1634,0,40,6,34,
1635,0,43,7,36,
1636,0,42,6,36,
1637,0,44,7,37,
1638,0,44,7,37,
1639,0,44,6,38,
1640,0,44,7,37,
1641,0,45,6,39,
1642,0,44,6,38,
1643,0,46,7,39,
1644,0,48,7,41,
1645,0,46,6,40,
1646,0,46,6,40,
1647,0,48,7,41,
1648,0,48,6,42,
1649,0,48,7,41,
1650,0,49,6,43,
1651,0,48,6,42,
1652,0,50,7,43,
1653,0,51,7,44,
1654,0,49,6,43,
1655,0,52,7,45,
1656,0,51,6,45,
1657,0,51,7,44,
1658,0,52,6,45,1
1659,0,53,7,46,
1660,0,52,6,46,
1661,0,55,7,48,
1662,0,53,6,47,
1663,0,53,6,47,
1664,0,55,7,48,
1665,0,54,6,48,
1666,0,60,11,49,
1667,0,61,13,48,
1668,0,61,13,48,
1669,0,63,13,50,
1670,0,63,13,50,
1671,0,62,13,49,
1672,0,62,12,50,
1673,0,64,13,51,
1674,0,63,12,51,
1675,0,63,12,51,
1676,0,64,12,52,
1677,0,65,13,52,
1678,0,65,13,52,
1679,0,64,12,52,
1680,0,66,13,53,
1681,0,67,13,54,
1682,0,66,13,53,
1683,0,65,12,53,
1684,0,67,13,54,
1685,0,68,13,55,
1686,0,67,13,54,
1687,0,67,12,55,
1688,0,68,12,55,1
1689,0,68,13,55,
1690,0,67,12,55,
1691,0,70,13,57,
1692,0,69,13,56,
1693,0,69,13,56,
1694,0,68,12,56,
1695,0,71,13,58,
1696,0,71,13,58,
1697,0,70,13,57,
1698,0,70,12,58,
1699,0,72,13,59,
1700,0,71,13,58,
1701,0,71,12,59,
1702,0,66,6,60,
1703,0,66,7,59,
1704,0,66,7,59,
1705,0,67,7,60,
1706,0,67,6,61,
1707,0,66,6,60,
1708,0,68,7,61,
1709,0,66,6,60,
1710,0,69,7,62,
1711,0,68,6,62,
1712,0,68,7,61,
1713,0,68,6,62,
1714,0,68,6,62,
1715,0,71,7,64,
1716,0,69,6,63,
1717,0,68,6,62,
1718,0,71,7,63,1
1719,0,71,7,64,
1720,0,70,7,63,
1721,0,70,6,64,
1722,0,70,6,64,
1723,0,72,7,65,
1724,0,71,6,65,
1725,0,70,6,64,
1726,0,73,7,66,
1727,0,74,8,66,
1728,0,72,7,65,
1729,0,72,7,65,
1730,0,73,6,67,
1731,0,72,6,66,
1732,0,74,7,67,
1733,0,73,6,67,
1734,0,72,6,66,
1735,0,75,7,68,
1736,0,74,6,68,
1737,0,74,7,67,
1738,0,74,6,68,
1739,0,74,6,68,
1740,0,76,7,69,
1741,0,75,6,69,
1742,0,76,7,69,
1743,0,74,6,68,
1744,0,78,7,71,
1745,0,76,6,70,
1746,0,76,7,69,
1747,0,77,7,70,
1748,0,76,6,70,
1749,0,78,7,70,1
1750,0,77,7,70,
1751,0,77,6,71,
1752,0,76,6,70,
1753,0,80,7,73,
1754,0,78,6,72,
1755,0,77,6,71,
1756,0,79,7,72,
1757,0,81,8,73,
1758,0,81,7,74,
1759,0,79,6,73,
1760,0,80,7,73,
1761,0,78,6,72,
1762,0,82,7,75,
1763,0,80,6,74,
1764,0,81,7,74,
1765,0,79,6,73,
1766,0,80,7,73,
1767,0,81,7,74,
1768,0,81,6,75,
1769,0,80,6,74,
1770,0,82,7,75,
1771,0,81,6,75,
1772,0,81,6,75,
1773,0,83,7,76,
1774,0,81,6,75,
1775,0,83,7,76,
1776,0,82,7,75,
1777,0,82,6,76,
1778,0,82,7,75,
1779,0,83,6,76,1
1780,0,81,6,75,
1781,0,84,7,77,
1782,0,80,6,74,
1783,0,68,6,62,
1784,0,57,7,50,
1785,0,53,6,47,
1786,0,50,7,43,
1787,0,42,5,37,
1788,0,34,7,27,
1789,0,26,7,19,
1790,0,23,6,17,
1791,0,29,6,23,
1792,0,39,7,32,
1793,0,41,7,34,
1794,0,39,6,33,
1795,0,41,7,34,
1796,0,43,7,36,
1797,0,42,6,36,
1798,0,42,7,35,
1799,0,44,7,37,
1800,0,43,6,37,
1801,0,44,7,37,
1802,0,45,7,38,
1803,0,44,6,38,
1804,0,46,7,39,
1805,0,47,7,40,
1806,0,46,7,39,
1807,0,47,6,41,
1808,0,45,6,39,
1809,0,51,8,42,1
1810,0,47,6,41,
1811,0,50,7,43,
1812,0,48,6,42,
1813,0,49,7,42,
1814,0,50,6,44,
1815,0,50,7,43,
1816,0,52,7,45,
1817,0,50,6,44,
1818,0,53,7,46,
1819,0,51,6,45,
1820,0,53,7,46,
1821,0,53,8,45,
1822,0,54,6,48,
1823,0,54,8,46,
1824,0,57,10,47,
1825,0,54,7,47,
1826,0,54,6,48,
1827,0,54,6,48,
1828,0,57,7,50,
1829,0,55,7,48,
1830,0,57,7,50,
1831,0,55,6,49,
1832,0,57,7,50,
1833,0,57,6,51,
1834,0,57,7,50,
1835,0,56,6,50,
1836,0,60,8,52,
1837,0,58,6,52,
1838,0,57,6,51,
1839,0,60,7,53,
1840,0,58,6,52,
1841,0,59,7,52,
1842,0,60,6,54,
1843,0,60,7,53,
1844,0,61,7,54,
1845,0,59,6,53,
1846,0,63,7,56,
1847,0,60,6,54,
1848,0,58,9,49,
1849,0,60,10,50,
1850,0,59,10,49,
1851,0,60,11,49,
1852,0,61,10,51,
1853,0,66,11,55,
1854,0,65,9,56,
1855,0,67,11,56,
1856,0,69,11,58,
1857,0,71,13,58,
1858,0,70,12,58,
1859,0,72,13,59,
1860,0,70,12,58,
1861,0,71,13,58,
1862,0,72,13,59,
1863,0,72,13,59,
1864,0,72,13,59,
1865,0,72,13,59,
1866,0,73,13,60,
1867,0,68,7,61,
1868,0,66,6,60,
1869,0,68,7,61,
1870,0,68,7,61,
1871,0,69,7,62,
1872,0,67,6,61,
1873,0,69,7,62,
1874,0,67,6,61,
1875,0,69,7,62,
1876,0,69,6,63,
1877,0,69,6,63,
1878,0,72,7,65,
1879,0,69,6,63,
1880,0,72,7,65,
1881,0,72,7,65,
1882,0,71,7,64,
1883,0,70,6,64,
1884,0,72,7,65,
1885,0,71,6,65,
1886,0,72,7,65,
1887,0,71,6,65,
1888,0,73,7,66,
1889,0,72,6,66,
1890,0,72,7,65,
1891,0,73,6,67,
1892,0,72,6,66,
1893,0,74,7,67,
1894,0,73,6,67,
1895,0,73,6,67,
1896,0,75,7,68,
1897,0,75,7,68,
1898,0,74,7,67,
1899,0,74,6,68,
1900,0,74,6,68,
1901,0,77,8,69,
1902,0,74,6,68,
1903,0,75,7,68,
1904,0,76,6,70,
1905,0,75,6,69,
1906,0,76,7,69,
1907,0,76,6,70,
1908,0,75,6,69,
1909,0,78,7,71,
1910,0,76,6,70,
1911,0,77,7,70,
1912,0,77,7,70,
1913,0,78,6,72,
1914,0,78,6,72,
1915,0,78,7,71,
1916,0,78,6,72,
1917,0,77,6,71,
1918,0,80,7,73,
1919,0,79,6,73,
1920,0,79,7,72,
1921,0,79,6,73,
1922,0,78,6,72,
1923,0,82,7,75,
1924,0,80,6,74,
1925,0,79,6,73,
1926,0,81,7,74,
1927,0,79,6,73,
1928,0,83,7,76,
1929,0,81,6,75,
1930,0,81,7,74,
1931,0,82,7,75,
1932,0,81,7,74,
1933,0,83,7,76,
1934,0,81,6,75,
1935,0,83,7,76,
1936,0,81,6,75,
1937,0,84,7,77,
1938,0,82,6,76,
1939,0,87,12,75,
1940,0,88,13,75,
1941,0,88,12,76,
1942,0,88,12,76,
1943,0,87,13,74,
1944,0,75,12,63,
1945,0,64,13,51,
1946,0,63,13,50,
1947,0,59,13,46,
1948,0,51,11,40,
1949,0,48,12,36,
1950,0,48,13,35,
1951,0,51,13,38,
1952,0,58,13,45,
1953,0,60,12,48,
1954,0,60,12,48,
1955,0,62,13,49,
1956,0,63,13,50,
1957,0,62,13,49,
1958,0,62,13,49,
1959,0,63,12,51,
1960,0,64,13,51,
1961,0,64,13,51,
1962,0,63,12,51,
1963,0,65,13,52,
1964,0,62,10,52,
1965,0,63,11,52,
1966,0,66,13,53,
1967,0,66,13,53,
1968,0,65,12,53,
1969,0,67,13,54,
1970,0,65,11,54,
1971,0,67,12,55,
1972,0,67,13,54,
1973,0,67,13,54,
1974,0,67,13,54,
1975,0,69,13,56,
1976,0,68,13,55,
1977,0,68,13,55,
1978,0,70,13,57,
1979,0,70,13,57,
1980,0,68,12,56,
1981,0,68,12,56,
1982,0,71,13,58,
1983,0,71,13,58,
1984,0,70,13,57,
1985,0,70,12,58,
1986,0,71,13,58,
1987,0,71,12,59,
1988,0,70,12,58,
1989,0,73,13,60,
1990,0,72,12,60,
1991,0,72,12,60,
1992,0,71,12,59,
1993,0,73,13,60,
1994,0,74,13,61,
1995,0,74,13,61,
1996,0,73,13,60,
1997,0,74,13,61,
1998,0,75,13,62,
1999,0,74,12,62,
2000,0,75,13,62,
2001,0,74,12,62,
2002,0,76,13,63,
2003,0,76,13,63,
2004,0,75,12,63,
2005,0,76,13,63,
2006,0,76,13,63,
2007,0,77,13,64,
2008,0,76,12,64,
2009,0,78,13,65,
2010,0,76,12,64,
2011,0,78,13,65,
2012,0,78,13,65,
2013,0,79,13,66,
2014,0,78,13,65,
2015,0,78,13,65,
2016,0,79,13,66,
2017,0,80,13,67,
2018,0,80,13,67,
2019,0,78,12,66,
2020,0,79,13,66,
2021,0,81,13,68,
2022,0,81,13,68,
2023,0,80,13,67,
2024,0,80,13,67,
2025,0,80,12,68,
2026,0,82,13,69,
2027,0,82,13,69,
2028,0,81,13,68,
2029,0,81,13,68,
2030,0,79,10,69,
2031,0,76,7,69,
2032,0,77,7,70,
2033,0,79,7,72,
2034,0,76,6,70,
2035,0,78,7,71,
2036,0,76,6,70,
2037,0,78,7,71,
2038,0,76,6,70,
2039,0,79,7,72,
2040,0,78,6,72,
2041,0,79,7,72,
2042,0,77,6,71,
2043,0,79,7,72,
2044,0,78,6,72,
2045,0,81,7,74,
2046,0,79,6,73,
2047,0,79,7,72,
2048,0,79,6,73,
2049,0,80,7,73,
2050,0,80,6,74,
2051,0,81,7,74,
2052,0,81,7,74,
2053,0,83,8,75,
2054,0,80,6,74,
2055,0,83,7,76,
2056,0,81,6,75,
2057,0,80,6,74,
2058,0,83,7,76,
2059,0,81,6,75,
2060,0,84,8,76,
2061,0,83,7,76,
2062,0,82,7,75,
2063,0,81,6,75,
2064,0,83,7,76,
2065,0,83,8,75,
2066,0,84,7,77,
2067,0,82,6,76,
2068,0,82,7,75,
2069,0,75,6,69,
2070,0,62,6,56,
2071,0,55,7,48,
2072,0,53,6,47,
2073,0,48,7,41,
2074,0,37,6,31,
2075,0,30,6,24,
2076,0,24,6,18,
2077,0,26,7,19,
2078,0,33,6,27,
2079,0,39,7,32,
2080,0,39,6,33,
2081,0,42,7,35,
2082,0,40,6,34,
2083,0,42,7,35,
2084,0,44,7,37,
2085,0,43,6,37,
2086,0,42,6,36,
2087,0,45,7,38,
2088,0,44,6,38,
2089,0,45,7,38,
2090,0,46,8,38,
2091,0,46,6,40,
2092,0,45,6,39,
2093,0,48,7,41,
2094,0,47,6,41,
2095,0,46,6,40,
2096,0,48,7,41,
2097,0,49,7,42,
2098,0,48,6,42,
2099,0,49,7,42,
2100,0,50,6,44,
2101,0,50,7,43,
2102,0,50,6,44,
2103,0,51,6,45,
2104,0,51,7,44,
2105,0,52,6,46,
2106,0,51,6,45,
2107,0,53,7,46,
2108,0,52,6,46,
2109,0,55,7,48,
2110,0,53,6,47,
2111,0,53,6,47,
2112,0,55,7,48,
2113,0,54,6,48,
2114,0,55,7,48,
2115,0,56,7,49,
2116,0,54,6,48,
2117,0,57,7,50,
2118,0,55,6,49,
2119,0,58,7,51,
2120,0,58,7,51,
2121,0,57,7,50,
2122,0,58,7,51,
2123,0,59,7,52,
2124,0,59,7,52,
2125,0,57,6,51,
2126,0,60,7,53,
2127,0,58,6,52,
2128,0,60,7,53,
2129,0,59,6,53,
2130,0,62,8,54,
2131,0,59,6,53,
2132,0,61,7,54,
2133,0,61,6,55,
2134,0,60,6,54,
2135,0,63,7,56,
2136,0,61,6,55,
2137,0,64,7,57,
2138,0,62,6,56,
2139,0,62,6,56,
2140,0,63,7,56,
2141,0,63,6,57,
2142,0,62,6,56,
2143,0,64,7,57,
2144,0,65,7,58,
2145,0,66,7,59,
2146,0,65,6,59,
2147,0,64,6,58,
2148,0,67,7,60,
2149,0,65,6,59,
2150,0,66,7,59,
2151,0,68,8,60,
2152,0,65,6,59,
2153,0,67,7,60,
2154,0,67,6,61,
2155,0,68,7,61,
2156,0,66,6,60,
2157,0,70,7,63,
2158,0,68,6,62,
2159,0,67,6,61,
2160,0,68,7,61,
2161,0,70,7,63,
2162,0,69,6,63,
2163,0,69,7,62,
2164,0,69,6,63,
2165,0,69,6,63,
2166,0,72,7,65,
2167,0,70,6,64,
2168,0,69,6,63,
2169,0,72,7,65,
2170,0,70,6,64,
2171,0,71,7,64,
2172,0,71,7,64,
2173,0,71,6,65,
2174,0,71,6,65,
2175,0,74,7,67,
2176,0,72,6,66,
2177,0,73,7,66,
2178,0,72,6,66,
2179,0,73,7,66,
2180,0,73,6,67,
2181,0,75,8,67,
2182,0,73,6,67,
2183,0,75,7,68,
2184,0,75,7,68,
2185,0,73,6,67,
2186,0,74,7,67,
2187,0,75,7,68,
2188,0,77,7,70,
2189,0,75,7,68,
2190,0,75,6,69,
2191,0,75,6,69,
2192,0,77,7,70,
2193,0,76,6,70,
2194,0,76,7,69,
2195,0,77,7,70,
2196,0,77,7,70,
2197,0,78,7,71,
2198,0,77,6,71,
2199,0,77,7,70,
2200,0,78,6,72,
2201,0,77,6,71,
2202,0,80,7,73,
2203,0,78,6,72,
2204,0,79,8,71,
2205,0,80,7,73,
2206,0,78,6,72,
2207,0,80,7,73,
2208,0,79,6,73,
2209,0,79,7,72,
2210,0,80,6,74,
2211,0,81,7,74,
2212,0,81,8,73,
2213,0,80,6,74,
2214,0,81,7,74,
2215,0,80,6,74,
2216,0,82,7,75,
2217,0,81,7,74,
2218,0,81,6,75,
2219,0,82,7,75,
2220,0,82,6,76,
2221,0,82,7,75,
2222,0,82,6,76,
2223,0,81,6,75,
2224,0,83,7,76,
2225,0,82,6,76,
2226,0,82,7,75,
2227,0,82,6,76,
2228,0,81,6,75,
2229,0,84,7,77,
2230,0,77,6,71,
2231,0,65,6,59,
2232,0,54,7,47,
2233,0,54,7,47,
2234,0,48,7,41,
2235,0,38,5,33,
2236,0,31,7,24,
2237,0,24,6,18,
2238,0,24,7,17,
2239,0,31,6,25,
2240,0,40,7,33,
2241,0,40,6,34,
2242,0,40,7,33,
2243,0,42,7,35,
2244,0,40,6,34,
2245,0,42,7,35,
2246,0,44,7,37,
2247,0,43,6,37,
2248,0,44,7,37,
2249,0,43,6,37,
2250,0,46,7,39,
2251,0,45,6,39,
2252,0,46,7,39,
2253,0,46,6,40,
2254,0,45,6,39,
2255,0,48,7,41,
2256,0,47,6,41,
2257,0,47,6,41,
2258,0,49,7,42,
2259,0,48,6,42,
2260,0,49,7,42,
2261,0,49,6,43,
2262,0,50,7,43,
2263,0,50,6,44,
2264,0,52,7,45,
2265,0,52,7,45,
2266,0,50,6,44,
2267,0,53,7,46,
2268,0,51,6,45,
2269,0,55,7,48,
2270,0,53,6,47,
2271,0,53,7,46,
2272,0,54,6,48,
2273,0,53,6,47,
2274,0,56,7,49,
2275,0,55,6,49,
2276,0,54,6,48,
2277,0,56,7,49,
2278,0,56,6,50,
2279,0,56,7,49,
2280,0,56,7,49,
2281,0,57,6,51,
2282,0,56,6,50,
2283,0,59,7,52,
2284,0,58,6,52,
2285,0,57,6,51,
2286,0,59,7,52,
2287,0,59,6,53,
2288,0,59,7,52,
2289,0,59,6,53,
2290,0,59,6,53,
2291,0,61,7,54,
2292,0,60,6,54,
2293,0,60,6,54,
2294,0,62,7,55,
2295,0,62,7,55,
2296,0,61,6,55,
2297,0,62,7,55,
2298,0,62,6,56,
2299,0,62,7,55,
2300,0,64,7,57,
2301,0,63,6,57,
2302,0,66,9,57,
2303,0,64,7,57,
2304,0,63,6,57,
2305,0,65,7,58,
2306,0,65,7,58,
2307,0,66,8,58,
2308,0,68,7,61,
2309,0,65,6,59,
2310,0,64,6,58,
2311,0,68,7,61,
2312,0,66,7,59,
2313,0,66,6,60,
2314,0,65,6,59,
2315,0,68,7,61,
2316,0,66,6,60,
2317,0,69,7,62,
2318,0,67,6,61,
2319,0,67,6,61,
2320,0,69,7,62,
2321,0,68,6,62,
2322,0,68,7,61,
2323,0,69,6,63,
2324,0,68,6,62,
2325,0,70,8,62,
2326,0,71,7,64,
2327,0,70,6,64,
2328,0,69,6,63,
2329,0,72,7,65,
2330,0,70,6,64,
2331,0,71,7,64,
2332,0,71,6,65,
2333,0,71,7,64,
2334,0,71,7,64,
2335,0,72,7,65,
2336,0,72,7,65,
2337,0,72,6,66,
2338,0,72,6,66,
2339,0,73,7,66,
2340,0,73,7,66,
2341,0,73,6,67,
2342,0,72,6,66,
2343,0,75,7,68,
2344,0,74,6,68,
2345,0,74,7,67,
2346,0,74,6,68,
2347,0,74,6,68,
2348,0,75,7,68,
2349,0,75,6,69,
2350,0,74,6,68,
2351,0,76,7,69,
2352,0,75,6,69,
2353,0,78,7,71,
2354,0,76,6,70,
2355,0,77,7,70,
2356,0,75,6,69,
2357,0,78,7,71,
2358,0,76,6,70,
2359,0,77,7,70,
2360,0,77,6,71,
2361,0,78,7,71,
2362,0,78,6,72,
2363,0,80,7,73,
2364,0,78,6,72,
2365,0,77,6,71,
2366,0,81,8,73,
2367,0,80,7,73,
2368,0,79,6,73,
2369,0,79,7,72,
2370,0,79,6,73,
2371,0,81,7,74,
2372,0,80,6,74,
2373,0,80,7,73,
2374,0,81,7,74,
2375,0,79,6,73,
2376,0,82,7,75,
2377,0,81,6,75,
2378,0,81,7,74,
2379,0,81,6,75,
2380,0,80,6,74,
2381,0,83,7,76,
2382,0,82,6,76,
2383,0,82,7,75,
2384,0,82,6,76,
2385,0,82,7,75,
2386,0,83,7,76,
2387,0,81,6,75,
2388,0,84,7,77,
2389,0,82,6,76,
2390,0,82,7,75,
2391,0,77,7,70,
2392,0,64,6,58,
2393,0,55,8,47,
2394,0,53,7,46,
2395,0,48,6,42,
2396,0,39,7,32,
2397,0,30,6,24,
2398,0,26,7,19,
2399,0,26,7,19,
2400,0,33,6,27,
2401,0,40,8,32,
2402,0,40,7,33,
2403,0,43,8,35,
2404,0,40,6,34,
2405,0,44,7,37,
2406,0,42,6,36,
2407,0,42,6,36,
2408,0,44,7,37,
2409,0,44,6,38,
2410,0,44,7,37,
2411,0,45,6,39,
2412,0,45,7,38,
2413,0,46,6,40,
2414,0,46,6,40,
2415,0,47,7,40,
2416,0,47,6,41,
2417,0,47,7,40,
2418,0,48,6,42,
2419,0,47,6,41,
2420,0,50,7,43,
2421,0,49,6,43,
2422,0,50,7,43,
2423,0,50,6,44,
2424,0,49,6,43,
2425,0,52,7,45,
2426,0,50,6,44,
2427,0,53,7,46,
2428,0,52,6,46,
2429,0,51,6,45,
2430,0,54,7,47,
2431,0,55,8,47,
2432,0,52,6,46,
2433,0,56,7,49,
2434,0,54,6,48,
2435,0,54,7,47,
2436,0,55,6,49,
2437,0,55,6,49,
2438,0,57,7,50,
2439,0,56,6,50,
2440,0,56,7,49,
2441,0,57,6,51,
2442,0,56,6,50,
2443,0,58,7,51,
2444,0,60,7,53,
2445,0,61,9,52,
2446,0,57,6,51,
2447,0,60,8,52,
2448,0,60,7,53,
2449,0,59,6,53,
2450,0,59,7,52,
2451,0,61,7,54,
2452,0,59,6,53,
2453,0,62,7,55,
2454,0,61,6,55,
2455,0,60,6,54,
2456,0,62,7,55,
2457,0,62,6,56,
2458,0,62,7,55,
2459,0,62,7,55,
2460,0,62,6,56,
2461,0,63,7,56,
2462,0,64,7,57,
2463,0,64,7,57,
2464,0,63,6,57,
2465,0,65,7,58,
2466,0,64,6,58,
2467,0,64,7,57,
2468,0,65,6,59,
2469,0,64,6,58,
2470,0,66,7,59,
2471,0,65,6,59,
2472,0,65,6,59,
2473,0,67,7,60,
2474,0,65,6,59,
2475,0,67,7,60,
2476,0,67,6,61,
2477,0,67,7,60,
2478,0,68,7,61,
2479,0,67,6,61,
2480,0,70,7,63,
2481,0,68,6,62,
2482,0,67,6,61,
2483,0,70,7,63,
2484,0,71,7,64,
2485,0,69,7,62,
2486,0,69,6,63,
2487,0,71,7,64,
2488,0,69,6,63,
2489,0,72,7,65,
2490,0,70,6,64,
2491,0,70,6,64,
2492,0,71,7,64,
2493,0,72,7,65,
2494,0,71,6,65,
2495,0,71,7,64,
2496,0,72,6,66,
2497,0,71,6,65,
2498,0,74,7,67,
2499,0,72,6,66,
2500,0,72,6,66,
2501,0,74,7,67,
2502,0,72,6,66,
2503,0,75,7,68,
2504,0,74,6,68,
2505,0,74,7,67,
2506,0,74,6,68,
2507,0,76,7,69,
2508,0,75,7,68,
2509,0,75,6,69,
2510,0,74,6,68,
2511,0,76,7,69,
2512,0,75,6,69,
2513,0,76,7,69,
2514,0,76,6,70,
2515,0,75,6,69,
2516,0,78,7,71,
2517,0,77,6,71,
2518,0,79,7,72,
2519,0,76,6,70,
2520,0,79,7,72,
2521,0,77,6,71,
2522,0,78,7,71,
2523,0,78,7,71,
2524,0,79,7,72,
2525,0,78,6,72,
2526,0,77,6,71,
2527,0,80,7,73,
2528,0,78,6,72,
2529,0,80,7,73,
2530,0,79,6,73,
2531,0,78,6,72,
2532,0,81,7,74,
2533,0,79,6,73,
2534,0,82,7,75,
2535,0,80,6,74,
2536,0,80,6,74,
2537,0,84,8,76,
2538,0,81,6,75,
2539,0,82,8,74,
2540,0,82,7,75,
2541,0,81,6,75,
2542,0,83,7,76,
2543,0,82,6,76,
2544,0,81,6,75,
2545,0,83,7,76,
2546,0,83,7,76,
2547,0,81,6,75,
2548,0,84,7,77,
2549,0,83,7,76,
2550,0,82,7,75,
2551,0,83,8,75,
2552,0,71,6,65,
2553,0,58,6,52,
2554,0,54,7,47,
2555,0,51,6,45,
2556,0,46,7,39,
2557,0,35,6,29,
2558,0,27,6,21,
2559,0,23,7,16,
2560,0,27,6,21,
2561,0,37,6,31,
2562,0,41,7,34,
2563,0,40,6,34,
2564,0,40,6,34,
2565,0,42,7,35,
2566,0,41,6,35,
2567,0,43,7,36,
2568,0,44,7,37,
2569,0,44,7,37,
2570,0,43,6,37,
2571,0,45,7,38,
2572,0,45,6,39,
2573,0,44,6,38,
2574,0,47,7,40,
2575,0,49,8,41,
2576,0,46,6,40,
2577,0,47,7,40,
2578,0,49,8,41,
2579,0,48,6,42,
2580,0,48,7,41,
2581,0,50,7,43,
2582,0,49,6,43,
2583,0,51,7,44,
2584,0,50,7,43,
2585,0,51,6,45,
2586,0,50,6,44,
2587,0,52,7,45,
2588,0,51,6,45,
2589,0,54,7,47,
2590,0,52,6,46,
2591,0,52,6,46,
2592,0,54,7,47,
2593,0,53,6,47,
2594,0,55,7,48,
2595,0,54,6,48,
2596,0,57,7,50,
2597,0,55,6,49,
2598,0,56,7,49,
2599,0,55,6,49,
2600,0,56,7,49,
2601,0,58,7,51,
2602,0,57,6,51,
2603,0,57,7,50,
2604,0,57,6,51,
2605,0,59,7,52,
2606,0,60,7,53,
2607,0,58,6,52,
2608,0,59,7,52,
2609,0,60,7,53,
2610,0,60,7,53,
2611,0,62,8,54,
2612,0,60,6,54,
2613,0,61,7,54,
2614,0,61,7,54,
2615,0,62,8,54,
2616,0,61,6,55,
2617,0,60,6,54,
2618,0,63,7,56,
2619,0,62,6,56,
2620,0,62,7,55,
2621,0,63,6,57,
2622,0,62,6,56,
2623,0,64,7,57,
2624,0,62,6,56,
2625,0,65,7,58,
2626,0,64,6,58,
2627,0,63,6,57,
2628,0,64,7,57,
2629,0,66,7,59,
2630,0,65,7,58,
2631,0,67,7,60,
2632,0,66,6,60,
2633,0,66,7,59,
2634,0,66,6,60,
2635,0,66,7,59,
2636,0,70,7,63,
2637,0,66,6,60,
2638,0,67,7,60,
2639,0,67,7,60,
2640,0,70,7,63,
2641,0,68,6,62,
2642,0,67,6,61,
2643,0,68,7,61,
2644,0,70,7,63,
2645,0,69,6,63,
2646,0,71,7,64,
2647,0,69,6,63,
2648,0,70,7,63,
2649,0,70,6,64,
2650,0,69,6,63,
2651,0,72,7,65,
2652,0,71,6,65,
2653,0,71,7,64,
2654,0,71,6,65,
2655,0,71,7,64,
2656,0,72,6,66,
2657,0,72,6,66,
2658,0,72,7,65,
2659,0,72,6,66,
2660,0,73,7,66,
2661,0,74,7,67,
2662,0,72,6,66,
2663,0,74,7,67,
2664,0,74,6,68,
2665,0,74,7,67,
2666,0,75,8,67,
2667,0,75,7,68,
2668,0,73,6,67,
2669,0,77,8,69,
2670,0,74,6,68,
2671,0,77,7,70,
2672,0,75,6,69,
2673,0,76,7,69,
2674,0,76,7,69,
2675,0,77,7,70,
2676,0,75,6,69,
2677,0,77,7,70,
2678,0,77,6,71,
2679,0,78,7,71,
2680,0,76,6,70,
2681,0,78,7,71,
2682,0,78,7,71,
2683,0,78,6,72,
2684,0,77,6,71,
2685,0,78,7,71,
2686,0,80,7,73,
2687,0,79,6,73,
2688,0,79,7,72,
2689,0,79,6,73,
2690,0,78,6,72,
2691,0,79,7,72,
2692,0,80,7,73,
2693,0,82,7,75,
2694,0,80,6,74,
2695,0,80,7,73,
2696,0,82,7,75,
2697,0,80,6,74,
2698,0,82,7,75,
2699,0,81,7,74,
2700,0,83,7,76,
2701,0,82,6,76,
2702,0,81,6,75,
2703,0,83,7,76,
2704,0,81,6,75,
2705,0,83,7,76,
2706,0,84,7,77,
2707,0,82,6,76,
2708,0,81,6,75,
2709,0,83,7,76,
2710,0,81,6,75,
2711,0,83,7,76,
2712,0,75,6,69,
2713,0,63,7,56,
2714,0,53,6,47,
2715,0,52,6,46,
2716,0,49,7,42,
2717,0,38,5,33,
2718,0,30,7,23,
2719,0,24,7,17,
2720,0,25,7,18,
2721,0,35,7,28,
2722,0,38,6,32,
2723,0,42,7,35,
2724,0,41,6,35,
2725,0,40,6,34,
2726,0,43,7,36,
2727,0,42,6,36,
2728,0,43,7,36,
2729,0,43,7,36,
2730,0,44,6,38,
2731,0,43,6,37,
2732,0,47,7,40,
2733,0,45,6,39,
2734,0,46,7,39,
2735,0,46,7,39,
2736,0,52,12,40,
2737,0,54,13,41,
2738,0,54,14,40,
2739,0,54,12,42,
2740,0,53,12,41,
2741,0,56,13,43,
2742,0,55,13,42,
2743,0,56,13,43,
2744,0,57,13,44,
2745,0,57,13,44,
2746,0,56,12,44,
2747,0,57,13,44,
2748,0,59,13,46,
2749,0,58,13,45,
2750,0,58,13,45,
2751,0,58,12,46,
2752,0,59,12,47,
2753,0,60,13,47,
2754,0,60,13,47,
2755,0,60,12,48,
2756,0,59,12,47,
2757,0,59,11,48,
2758,0,61,13,48,
2759,0,64,14,50,
2760,0,63,13,50,
2761,0,62,13,49,
2762,0,62,12,50,
2763,0,63,12,51,
2764,0,64,13,51,
2765,0,63,13,50,
2766,0,65,12,53,
2767,0,63,12,51,
2768,0,64,13,51,
2769,0,66,13,53,
2770,0,65,13,52,
2771,0,65,13,52,
2772,0,66,13,53,
2773,0,67,13,54,
2774,0,66,12,54,
2775,0,67,13,54,
2776,0,67,12,55,
2777,0,68,13,55,
2778,0,67,13,54,
2779,0,67,12,55,
2780,0,69,13,56,
2781,0,69,13,56,
2782,0,70,13,57,
2783,0,69,13,56,
2784,0,69,12,57,
2785,0,70,13,57,
2786,0,71,13,58,
2787,0,69,12,57,
2788,0,71,13,58,
2789,0,71,13,58,
2790,0,71,13,58,
2791,0,71,13,58,
2792,0,71,13,58,
2793,0,73,13,60,
2794,0,73,13,60,
2795,0,72,13,59,
2796,0,72,12,60,
2797,0,74,13,61,
2798,0,73,13,60,
2799,0,72,12,60,
2800,0,74,13,61,
2801,0,75,13,62,
2802,0,75,13,62,
2803,0,74,13,61,
2804,0,75,12,63,
2805,0,76,13,63,
2806,0,76,13,63,
2807,0,74,12,62,
2808,0,77,13,64,
2809,0,77,13,64,
2810,0,76,13,63,
2811,0,76,13,63,
2812,0,77,13,64,
2813,0,78,13,65,
2814,0,77,13,64,
2815,0,78,13,65,
2816,0,77,12,65,
2817,0,79,13,66,
2818,0,78,13,65,
2819,0,78,13,65,
2820,0,79,13,66,
2821,0,79,13,66,
2822,0,79,13,66,
2823,0,78,12,66,
2824,0,80,13,67,
2825,0,81,13,68,
2826,0,80,13,67,
2827,0,79,12,67,
2828,0,79,12,67,
2829,0,80,13,67,
2830,0,81,13,68,
2831,0,81,13,68,
2832,0,82,13,69,
2833,0,82,13,69,
2834,0,82,13,69,
2835,0,82,12,70,
2836,0,83,13,70,
2837,0,82,12,70,
2838,0,81,12,69,
2839,0,84,13,71,
2840,0,84,13,71,
2841,0,82,12,70,
2842,0,83,13,70,
2843,0,84,13,71,
2844,0,85,13,72,
2845,0,84,13,71,
2846,0,84,13,71,
2847,0,84,12,72,
2848,0,81,8,73,
2849,0,79,7,72,
2850,0,80,7,73,
2851,0,78,6,72,
2852,0,80,7,73,
2853,0,80,6,74,
2854,0,81,8,73,
2855,0,81,7,74,
2856,0,79,6,73,
2857,0,82,7,75,
2858,0,81,7,74,
2859,0,81,7,74,
2860,0,83,7,76,
2861,0,80,6,74,
2862,0,83,7,76,
2863,0,81,6,75,
2864,0,84,7,77,
2865,0,82,6,76,
2866,0,82,7,75,
2867,0,82,6,76,
2868,0,81,6,75,
2869,0,84,7,77,
2870,0,82,6,76,
2871,0,83,7,76,
2872,0,82,7,75,
2873,0,75,7,68,
2874,0,62,6,56,
2875,0,53,7,46,
2876,0,52,6,46,
2877,0,46,6,40,
2878,0,36,6,30,
2879,0,31,8,23,
2880,0,24,6,18,
2881,0,25,8,17,
2882,0,38,7,31,
2883,0,39,6,33,
2884,0,39,6,33,
2885,0,43,7,36,
2886,0,41,6,35,
2887,0,42,7,35,
2888,0,42,6,36,
2889,0,42,6,36,
2890,0,43,7,36,
2891,0,45,7,38,
2892,0,44,6,38,
2893,0,44,6,38,
2894,0,46,7,39,
2895,0,49,8,41,
2896,0,47,8,39,
2897,0,47,7,40,
2898,0,48,7,41,
2899,0,46,6,40,
2900,0,50,7,43,
2901,0,48,6,42,
2902,0,48,6,42,
2903,0,50,7,43,
2904,0,50,6,44,
2905,0,51,8,43,
2906,0,50,6,44,
2907,0,51,7,44,
2908,0,52,7,45,
2909,0,52,6,46,
2910,0,52,7,45,
2911,0,52,6,46,
2912,0,54,7,47,
2913,0,54,7,47,
2914,0,53,7,46,
2915,0,56,7,49,
2916,0,54,6,48,
2917,0,54,6,48,
2918,0,55,7,48,
2919,0,56,7,49,
2920,0,56,6,50,
2921,0,56,7,49,
2922,0,58,7,51,
2923,0,57,7,50,
2924,0,57,7,50,
2925,0,57,7,50,
2926,0,60,7,53,
2927,0,58,6,52,
2928,0,58,7,51,
2929,0,59,6,53,
2930,0,58,6,52,
2931,0,59,7,52,
2932,0,61,7,54,
2933,0,60,6,54,
2934,0,59,6,53,
2935,0,60,7,53,
2936,0,62,7,55,
2937,0,63,7,56,
2938,0,61,6,55,
2939,0,63,7,56,
2940,0,62,7,55,
2941,0,64,7,57,
2942,0,63,7,56,
2943,0,64,7,57,
2944,0,62,6,56,
2945,0,64,7,57,
2946,0,64,6,58,
2947,0,64,7,57,
2948,0,64,6,58,
2949,0,63,6,57,
2950,0,67,7,60,
2951,0,65,7,58,
2952,0,65,6,59,
2953,0,65,6,59,
2954,0,67,7,60,
2955,0,65,6,59,
2956,0,67,7,60,
2957,0,67,6,61,
2958,0,66,6,60,
2959,0,68,7,61,
2960,0,67,6,61,
2961,0,69,7,62,
2962,0,68,7,61,
2963,0,68,6,62,
2964,0,67,6,61,
2965,0,70,7,63,
2966,0,71,7,64,
2967,0,69,6,63,
2968,0,68,6,62,
2969,0,70,6,64,
2970,0,71,7,64,
2971,0,70,6,64,
2972,0,71,8,63,
2973,0,71,6,65,
2974,0,70,6,64,
2975,0,73,7,66,
2976,0,71,6,65,
2977,0,71,6,65,
2978,0,73,7,66,
2979,0,74,7,67,
2980,0,72,6,66,
2981,0,73,7,66,
2982,0,72,6,66,
2983,0,74,7,67,
2984,0,78,11,67,
2985,0,81,13,68,
2986,0,80,13,67,
2987,0,80,12,68,
2988,0,81,13,68,
2989,0,80,13,67,
2990,0,79,11,68,
2991,0,80,12,68,
2992,0,82,13,69,
2993,0,81,13,68,
2994,0,81,12,69,
2995,0,82,12,70,
2996,0,83,13,70,
2997,0,81,12,69,
2998,0,82,12,70,
2999,0,84,13,71,
3000,0,83,13,70,
3001,0,82,12,70,
3002,0,83,13,70,
3003,0,84,13,71,
3004,0,84,13,71,
3005,0,84,13,71,
3006,0,84,12,72,
3007,0,85,13,72,
3008,0,86,13,73,
3009,0,84,12,72,
3010,0,86,13,73,
3011,0,85,13,72,
3012,0,84,12,72,
3013,0,86,13,73,
3014,0,87,13,74,
3015,0,86,12,74,
3016,0,84,11,73,
3017,0,86,12,74,
3018,0,88,13,75,
3019,0,86,11,75,
3020,0,86,12,74,
3021,0,88,13,75,
3022,0,87,13,74,
3023,0,88,13,75,
3024,0,87,12,75,
3025,0,88,12,76,
3026,0,88,13,75,
3027,0,87,12,75,
3028,0,89,12,77,
3029,0,89,12,77,
3030,0,84,9,75,
3031,0,83,7,76,
3032,0,84,7,77,
3033,0,82,6,76,
3034,0,83,8,75,
3035,0,80,6,74,
3036,0,68,6,62,
3037,0,58,7,51,
3038,0,53,6,47,
3039,0,49,6,43,
3040,0,43,6,37,
3041,0,38,6,32,
3042,0,38,7,31,
3043,0,42,7,35,
3044,0,47,6,41,
3045,0,55,7,48,
3046,0,55,6,49,
3047,0,56,6,50,
3048,0,56,7,49,
3049,0,56,6,50,
3050,0,56,6,50,
3051,0,58,7,51,
3052,0,56,6,50,
3053,0,59,7,52,
3054,0,58,7,51,
3055,0,58,6,52,
3056,0,58,6,52,
3057,0,59,7,52,
3058,0,60,7,53,
3059,0,59,7,52,
3060,0,61,7,54,
3061,0,59,6,53,
3062,0,61,7,54,
3063,0,62,8,54,
3064,0,61,6,55,
3065,0,60,6,54,
3066,0,62,7,55,
3067,0,62,6,56,
3068,0,61,6,55,
3069,0,62,7,55,
3070,0,64,7,57,
3071,0,62,6,56,
3072,0,63,7,56,
3073,0,63,6,57,
3074,0,66,7,59,
3075,0,64,6,58,
3076,0,64,7,57,
3077,0,65,6,59,
3078,0,64,6,58,
3079,0,66,7,59,
3080,0,65,6,59,
3081,0,66,7,59,
3082,0,66,6,60,
3083,0,66,6,60,
3084,0,66,7,59,
3085,0,67,6,61,
3086,0,66,6,60,
3087,0,68,7,61,
3088,0,70,7,63,
3089,0,68,6,62,
3090,0,69,7,62,
3091,0,69,7,62,
3092,0,69,6,63,
3093,0,68,6,62,
3094,0,69,7,62,
3095,0,69,6,63,
3096,0,69,6,63,
3097,0,71,7,64,
3098,0,69,6,63,
3099,0,72,7,65,
3100,0,71,6,65,
3101,0,70,6,64,
3102,0,73,7,66,
3103,0,71,7,64,
3104,0,73,7,66,
3105,0,71,6,65,
3106,0,73,7,66,
3107,0,71,6,65,
3108,0,72,7,65,
3109,0,73,6,67,
3110,0,72,6,66,
3111,0,74,7,67,
3112,0,73,7,66,
3113,0,73,6,67,
3114,0,75,7,68,
3115,0,73,6,67,
3116,0,76,7,69,
3117,0,75,6,69,
3118,0,75,7,68,
3119,0,74,6,68,
3120,0,77,7,70,
3121,0,77,9,68,
3122,0,77,7,70,
3123,0,77,7,70,
3124,0,75,6,69,
3125,0,76,7,69,
3126,0,77,6,71,
3127,0,77,7,70,
3128,0,77,7,70,
3129,0,79,7,72,
3130,0,77,6,71,
3131,0,77,6,71,
3132,0,79,7,72,
3133,0,78,6,72,
3134,0,80,8,72,
3135,0,78,6,72,
3136,0,81,7,74,
3137,0,79,6,73,
3138,0,78,6,72,
3139,0,80,7,73,
3140,0,80,6,74,
3141,0,80,7,73,
3142,0,80,6,74,
3143,0,79,6,73,
3144,0,81,7,74,
3145,0,81,6,75,
3146,0,80,6,74,
3147,0,82,7,75,
3148,0,80,6,74,
3149,0,81,7,74,
3150,0,83,7,76,
3151,0,82,7,75,
3152,0,82,7,75,
3153,0,82,6,76,
3154,0,81,6,75,
3155,0,83,7,76,
3156,0,84,7,77,
3157,0,81,6,75,
3158,0,82,7,75,
3159,0,84,7,77,
3160,0,82,6,76,
3161,0,72,6,66,
3162,0,60,7,53,
3163,0,52,6,46,
3164,0,53,7,46,
3165,0,47,7,40,
3166,0,36,6,30,
3167,0,28,7,21,
3168,0,24,6,18,
3169,0,26,7,19,
3170,0,37,6,31,
3171,0,39,7,32,
3172,0,40,6,34,
3173,0,40,6,34,
3174,0,42,7,35,
3175,0,42,6,36,
3176,0,42,7,35,
3177,0,43,6,37,
3178,0,43,7,36,
3179,0,44,6,38,
3180,0,45,7,38,
3181,0,44,6,38,
3182,0,47,7,40,
3183,0,46,6,40,
3184,0,46,7,39,
3185,0,47,6,41,
3186,0,47,7,40,
3187,0,48,6,42,
3188,0,47,6,41,
3189,0,49,7,42,
3190,0,49,7,42,
3191,0,49,6,43,
3192,0,50,7,43,
3193,0,50,6,44,
3194,0,50,7,43,
3195,0,50,6,44,
3196,0,53,7,46,
3197,0,52,6,46,
3198,0,52,7,45,
3199,0,52,6,46,
3200,0,53,7,46,
3201,0,53,6,47,
3202,0,53,6,47,
3203,0,56,7,49,
3204,0,54,6,48,
3205,0,56,7,49,
3206,0,55,7,48,
3207,0,55,6,49,
3208,0,56,7,49,
3209,0,56,6,50,
3210,0,56,6,50,
3211,0,59,7,52,
3212,0,57,7,50,
3213,0,57,6,51,
3214,0,58,7,51,
3215,0,58,6,52,
3216,0,60,8,52,
3217,0,59,7,52,
3218,0,61,7,54,
3219,0,61,7,54,
3220,0,60,6,54,
3221,0,62,8,54,
3222,0,60,7,53,
3223,0,60,6,54,
3224,0,61,6,55,
3225,0,63,7,56,
3226,0,61,6,55,
3227,0,62,7,55,
3228,0,62,6,56,
3229,0,62,7,55,
3230,0,63,6,57,
3231,0,63,6,57,
3232,0,66,8,58,
3233,0,63,6,57,
3234,0,65,7,58,
3235,0,64,7,57,
3236,0,64,6,58,
3237,0,63,6,57,
3238,0,66,7,59,
3239,0,65,6,59,
3240,0,67,7,60,
3241,0,66,6,60,
3242,0,66,7,59,
3243,0,69,8,61,
3244,0,66,6,60,
3245,0,67,7,60,
3246,0,67,6,61,
3247,0,66,6,60,
3248,0,68,7,61,
3249,0,67,6,61,
3250,0,69,7,62,
3251,0,68,6,62,
3252,0,68,7,61,
3253,0,70,7,63,
3254,0,68,6,62,
3255,0,69,7,62,
3256,0,71,7,64,
3257,0,69,6,63,
3258,0,72,7,65,
3259,0,70,6,64,
3260,0,69,6,63,
3261,0,72,7,65,
3262,0,70,6,64,
3263,0,73,7,66,
3264,0,71,7,64,
3265,0,72,7,65,
3266,0,72,6,66,
3267,0,73,7,66,
3268,0,72,6,66,
3269,0,74,7,67,
3270,0,73,6,67,
3271,0,74,7,67,
3272,0,73,7,66,
3273,0,74,6,68,
3274,0,74,6,68,
3275,0,74,7,67,
3276,0,74,6,68,
3277,0,74,7,67,
3278,0,76,7,69,
3279,0,74,6,68,
3280,0,75,7,68,
3281,0,77,7,70,
3282,0,76,6,70,
3283,0,75,6,69,
3284,0,77,7,70,
3285,0,75,6,69,
3286,0,77,7,70,
3287,0,79,7,72,
3288,0,77,6,71,
3289,0,76,6,70,
3290,0,78,7,71,
3291,0,77,6,71,
3292,0,80,7,73,
3293,0,78,6,72,
3294,0,80,7,73,
3295,0,78,7,71,
3296,0,80,7,73,
3297,0,79,6,73,
3298,0,81,7,74,
3299,0,79,6,73,
3300,0,79,7,72,
3301,0,80,6,74,
3302,0,81,7,74,
3303,0,82,8,74,
3304,0,80,6,74,
3305,0,81,7,74,
3306,0,81,7,74,
3307,0,82,7,75,
3308,0,80,6,74,
3309,0,82,7,75,
3310,0,81,6,75,
3311,0,84,7,77,
3312,0,82,6,76,
3313,0,81,6,75,
3314,0,84,7,77,
3315,0,82,7,75,
3316,0,82,6,76,
3317,0,81,6,75,
3318,0,83,7,76,
3319,0,82,6,76,
3320,0,82,7,75,
3321,0,72,6,66,
3322,0,60,6,54,
3323,0,54,7,47,
3324,0,51,6,45,
3325,0,47,7,40,
3326,0,36,5,31,
3327,0,30,7,23,
3328,0,23,6,17,
3329,0,25,7,18,
3330,0,39,7,32,
3331,0,38,6,32,
3332,0,41,7,34,
3333,0,42,7,35,
3334,0,41,7,34,
3335,0,41,6,35,
3336,0,44,7,37,
3337,0,43,6,37,
3338,0,42,6,36,
3339,0,45,7,38,
3340,0,45,7,38,
3341,0,45,6,39,
3342,0,45,7,38,
3343,0,46,6,40,
3344,0,45,6,39,
3345,0,49,7,42,
3346,0,47,6,41,
3347,0,46,6,40,
3348,0,50,8,42,
3349,0,48,6,42,
3350,0,49,7,42,
3351,0,49,6,43,
3352,0,49,6,43,
3353,0,51,7,44,
3354,0,50,6,44,
3355,0,52,6,46,
3356,0,52,7,45,
3357,0,51,6,45,
3358,0,53,7,46,
3359,0,52,6,46,
3360,0,54,7,47,
3361,0,52,6,46,
3362,0,54,7,47,
3363,0,56,8,48,
3364,0,53,6,47,
3365,0,56,7,49,
3366,0,57,7,50,
3367,0,55,6,49,
3368,0,57,7,50,
3369,0,55,6,49,
3370,0,57,7,50,
3371,0,58,7,51,
3372,0,57,6,51,
3373,0,58,7,51,
3374,0,59,7,52,
3375,0,58,6,52,
3376,0,58,7,51,
3377,0,58,6,52,
3378,0,58,6,52,
3379,0,60,7,53,
3380,0,59,6,53,
3381,0,60,7,53,
3382,0,60,6,54,
3383,0,60,6,54,
3384,0,61,7,54,
3385,0,61,6,55,
3386,0,62,7,55,
3387,0,61,6,55,
3388,0,63,7,56,
3389,0,62,6,56,
3390,0,62,7,55,
3391,0,63,6,57,
3392,0,63,6,57,
3393,0,65,8,57,
3394,0,71,13,58,
3395,0,69,12,57,
3396,0,70,12,58,
3397,0,70,13,57,
3398,0,71,13,58,
3399,0,70,12,58,
3400,0,71,13,58,
3401,0,72,13,59,
3402,0,72,13,59,
3403,0,73,13,60,
3404,0,72,12,60,
3405,0,73,13,60,
3406,0,72,12,60,
3407,0,73,13,60,
3408,0,73,12,61,
3409,0,74,13,61,
3410,0,74,13,61,
3411,0,73,12,61,
3412,0,75,13,62,
3413,0,76,13,63,
3414,0,75,13,62,
3415,0,75,12,63,
3416,0,75,12,63,
3417,0,76,13,63,
3418,0,75,11,64,
3419,0,71,7,64,
3420,0,70,6,64,
3421,0,71,7,64,
3422,0,71,6,65,
3423,0,71,6,65,
3424,0,71,7,64,
3425,0,71,6,65,
3426,0,71,6,65,
3427,0,72,7,65,
3428,0,74,7,67,
3429,0,72,6,66,
3430,0,73,7,66,
3431,0,74,7,67,
3432,0,73,6,67,
3433,0,73,7,66,
3434,0,75,7,68,
3435,0,73,6,67,
3436,0,75,7,68,
3437,0,74,6,68,
3438,0,74,7,67,
3439,0,75,6,69,
3440,0,74,6,68,
3441,0,77,7,70,
3442,0,75,6,69,
3443,0,75,6,69,
3444,0,77,7,70,
3445,0,76,6,70,
3446,0,76,7,69,
3447,0,76,6,70,
3448,0,76,6,70,
3449,0,78,7,71,
3450,0,77,6,71,
3451,0,76,6,70,
3452,0,79,7,72,
3453,0,77,6,71,
3454,0,78,7,71,
3455,0,78,7,71,
3456,0,78,6,72,
3457,0,78,6,72,
3458,0,80,7,73,
3459,0,79,6,73,
3460,0,78,6,72,
3461,0,80,8,72,
3462,0,80,6,74,
3463,0,80,7,73,
3464,0,80,6,74,
3465,0,79,6,73,
3466,0,81,7,74,
3467,0,81,6,75,
3468,0,81,7,74,
3469,0,81,6,75,
3470,0,83,7,76,
3471,0,81,6,75,
3472,0,82,7,75,
3473,0,83,7,76,
3474,0,81,6,75,
3475,0,84,7,77,
3476,0,82,6,76,
3477,0,82,7,75,
3478,0,82,6,76,
3479,0,82,6,76,
3480,0,83,7,76,
3481,0,84,7,77,
3482,0,75,6,69,
3483,0,63,7,56,
3484,0,54,8,46,
3485,0,53,7,46,
3486,0,48,7,41,
3487,0,39,7,32,
3488,0,29,6,23,
3489,0,25,6,19,
3490,0,26,7,19,
3491,0,33,6,27,
3492,0,40,7,33,
3493,0,40,7,33,
3494,0,39,6,33,
3495,0,42,7,35,
3496,0,41,6,35,
3497,0,44,7,37,
3498,0,43,6,37,
3499,0,42,6,36,
3500,0,45,7,38,
3501,0,45,8,37,
3502,0,45,6,39,
3503,0,44,6,38,
3504,0,47,7,40,
3505,0,46,6,40,
3506,0,46,7,39,
3507,0,47,6,41,
3508,0,47,6,41,
3509,0,48,7,41,
3510,0,48,6,42,
3511,0,48,6,42,
3512,0,50,7,43,
3513,0,48,6,42,
3514,0,51,7,44,
3515,0,51,8,43,
3516,0,51,6,45,
3517,0,51,6,45,
3518,0,51,7,44,
3519,0,54,8,46,
3520,0,52,7,45,
3521,0,54,7,47,
3522,0,53,7,46,
3523,0,53,6,47,
3524,0,55,7,48,
3525,0,53,6,47,
3526,0,56,7,49,
3527,0,54,6,48,
3528,0,56,7,49,
3529,0,54,6,48,
3530,0,56,7,49,
3531,0,56,7,49,
3532,0,56,6,50,
3533,0,56,6,50,
3534,0,58,7,51,
3535,0,57,6,51,
3536,0,57,6,51,
3537,0,60,8,52,
3538,0,58,6,52,
3539,0,59,7,52,
3540,0,59,6,53,
3541,0,58,6,52,
3542,0,62,8,54,
3543,0,60,6,54,
3544,0,60,7,53,
3545,0,60,6,54,
3546,0,65,8,57,
3547,0,61,6,55,
3548,0,62,7,55,
3549,0,61,6,55,
3550,0,63,7,56,
3551,0,61,6,55,
3552,0,63,7,56,
3553,0,63,6,57,
3554,0,62,6,56,
3555,0,65,7,58,
3556,0,64,6,58,
3557,0,63,6,57,
3558,0,65,7,58,
3559,0,64,6,58,
3560,0,67,7,60,
3561,0,65,6,59,
3562,0,66,8,58,
3563,0,67,7,60,
3564,0,66,6,60,
3565,0,66,7,59,
3566,0,67,7,60,
3567,0,66,6,60,
3568,0,69,7,62,
3569,0,67,6,61,
3570,0,67,7,60,
3571,0,68,6,62,
3572,0,67,6,61,
3573,0,70,7,63,
3574,0,68,6,62,
3575,0,71,8,63,
3576,0,68,6,62,
3577,0,69,7,62,
3578,0,69,7,62,
3579,0,69,6,63,
3580,0,71,7,64,
3581,0,69,6,63,
3582,0,72,8,64,
3583,0,72,7,65,
3584,0,70,6,64,
3585,0,73,7,66,
3586,0,71,6,65,
3587,0,72,7,65,
3588,0,73,7,66,
3589,0,71,6,65,
3590,0,73,7,66,
3591,0,73,6,67,
3592,0,74,7,67,
3593,0,75,7,68,
3594,0,73,6,67,
3595,0,74,7,67,
3596,0,74,6,68,
3597,0,73,6,67,
3598,0,75,8,67,
3599,0,75,7,68,
3600,0,75,6,69,
3601,0,74,6,68,
3602,0,77,7,70,
3603,0,75,6,69,
3604,0,76,7,69,
3605,0,75,6,69,
3606,0,76,7,69,
3607,0,77,7,70,
3608,0,77,7,70,
3609,0,77,7,70,
3610,0,77,6,71,
3611,0,77,6,71,
3612,0,77,7,70,
3613,0,79,7,72,
3614,0,77,6,71,
3615,0,79,7,72,
3616,0,78,6,72,
3617,0,78,7,71,
3618,0,79,6,73,
3619,0,78,6,72,
3620,0,81,7,74,
3621,0,79,6,73,
3622,0,78,6,72,
3623,0,81,7,74,
3624,0,80,6,74,
3625,0,81,7,74,
3626,0,80,7,73,
3627,0,81,7,74,
3628,0,80,6,74,
3629,0,83,7,76,
3630,0,81,6,75,
3631,0,80,6,74,
3632,0,82,7,75,
3633,0,82,6,76,
3634,0,82,7,75,
3635,0,81,6,75,
3636,0,65,1,64,
3637,0,41,,41,
3638,0,18,,18,
