window-id,queue-size-CL,queue-size-LL,10.0.0.13:36989 -> 10.0.1.13:3000,10.0.1.13:3000 -> 10.0.0.13:36989,10.0.0.13:44118 -> 10.0.1.13:1000
0,0,30,10,20,
1,0,42,8,34,
2,0,42,12,30,
3,0,39,13,26,
4,0,33,11,22,
5,0,32,13,19,
6,0,31,13,18,
7,0,31,12,19,
8,0,31,13,18,
9,0,30,13,17,
10,0,28,12,16,
11,0,30,13,17,
12,0,31,13,18,
13,0,30,13,17,
14,0,29,12,17,
15,0,30,13,17,
16,0,31,13,18,
17,0,30,13,17,
18,0,28,11,17,
19,0,29,13,16,
20,0,29,12,17,
21,0,29,12,17,
22,0,30,13,17,
23,0,28,12,16,
24,0,30,13,17,
25,0,28,12,16,
26,0,28,12,16,
27,0,29,12,17,
28,0,30,13,17,
29,0,29,13,16,
30,0,28,12,16,
31,0,30,13,17,
32,0,30,13,17,
33,0,27,11,16,
34,0,31,14,17,
35,0,29,12,17,
36,0,28,13,15,
37,0,28,13,15,
38,0,28,12,16,
39,0,30,13,17,
40,0,28,12,16,
41,0,27,12,15,
42,0,30,14,16,
43,0,31,12,19,
44,0,30,13,17,
45,0,29,13,16,
46,0,29,13,16,
47,0,29,12,17,
48,0,30,13,17,
49,0,31,13,18,
50,0,28,11,17,
51,0,30,13,17,
52,0,28,12,16,
53,0,31,13,18,
54,0,31,12,19,
55,0,29,13,16,
56,0,31,13,18,
57,0,29,12,17,
58,0,30,13,17,
59,0,29,12,17,
60,0,28,12,16,
61,0,29,13,16,
62,0,30,13,17,
63,0,29,13,16,
64,0,28,12,16,
65,0,30,14,16,
66,0,30,13,17,
67,0,30,13,17,
68,0,29,13,16,
69,0,27,11,16,
70,0,30,13,17,
71,0,30,13,17,
72,0,29,13,16,
73,0,29,13,16,
74,0,29,12,17,
75,0,29,12,17,
76,0,30,13,17,
77,0,29,13,16,
78,0,28,12,16,
79,0,31,13,18,
80,0,27,12,15,
81,0,28,13,15,
82,0,27,12,15,
83,0,28,13,15,
84,0,30,13,17,
85,0,27,12,15,
86,0,28,13,15,
87,0,28,12,16,
88,0,29,13,16,
89,0,29,14,15,
90,0,28,12,16,
91,0,27,12,15,
92,0,29,13,16,
93,0,29,13,16,
94,0,29,13,16,
95,0,30,12,18,
96,0,31,13,18,
97,0,30,12,18,
98,0,29,12,17,
99,0,30,12,18,
100,0,29,12,17,
101,0,29,13,16,
102,0,32,13,19,
103,0,28,11,17,
104,0,30,13,17,
105,0,30,12,18,
106,0,31,13,18,
107,0,30,13,17,
108,0,27,12,15,
109,0,29,13,16,
110,0,29,13,16,
111,0,30,13,17,
112,0,30,13,17,
113,0,28,12,16,
114,0,30,13,17,
115,0,30,13,17,
116,0,29,12,17,
117,0,31,12,19,
118,0,29,11,18,
119,0,31,13,18,
120,0,28,12,16,
121,0,29,13,16,
122,0,28,12,16,
123,0,29,13,16,
124,0,30,13,17,
125,0,28,12,16,
126,0,29,13,16,
127,0,29,12,17,
128,0,30,13,17,
129,0,29,13,16,
130,0,28,12,16,
131,0,29,13,16,
132,0,30,13,17,
133,0,29,12,17,
134,0,25,9,16,
135,0,24,6,18,
136,0,23,7,16,
137,0,23,6,17,
138,0,24,6,18,
139,0,21,6,15,
140,0,25,7,18,
141,0,23,7,16,
142,0,23,6,17,
143,0,22,6,16,
144,0,23,6,17,
145,0,24,7,17,
146,0,23,6,17,
147,0,24,7,17,
148,0,24,6,18,
149,0,23,6,17,
150,0,24,7,17,
151,0,22,6,16,
152,0,23,7,16,
153,0,24,6,18,
154,0,23,7,16,
155,0,25,7,18,
156,0,23,6,17,
157,0,23,6,17,
158,0,23,7,16,
159,0,21,6,15,
160,0,25,7,18,
161,0,22,6,16,
162,0,23,6,17,
163,0,26,7,19,
164,0,24,7,17,
165,0,25,8,17,
166,0,22,6,16,
167,0,21,6,15,
168,0,25,7,18,
169,0,25,7,18,
170,0,24,7,17,
171,0,22,6,16,
172,0,25,7,18,
173,0,23,6,17,
174,0,23,7,16,
175,0,24,6,18,
176,0,23,6,17,
177,0,23,7,16,
178,0,22,6,16,
179,0,25,7,18,
180,0,25,7,18,
181,0,25,6,19,
182,0,23,6,17,
183,0,23,7,16,
184,0,23,5,18,
185,0,23,7,16,
186,0,22,6,16,
187,0,23,6,17,
188,0,24,7,17,
189,0,24,6,18,
190,0,25,7,18,
191,0,24,6,18,
192,0,24,7,17,
193,0,24,6,18,
194,0,24,7,17,
195,0,25,7,18,
196,0,24,7,17,
197,0,24,7,17,
198,0,24,7,17,
199,0,25,7,18,
200,0,23,6,17,
201,0,22,6,16,
202,0,25,7,18,
203,0,23,7,16,
204,0,24,8,16,
205,0,23,5,18,
206,0,25,7,18,
207,0,23,6,17,
208,0,24,6,18,
209,0,22,6,16,
210,0,25,7,18,
211,0,23,6,17,
212,0,24,7,17,
213,0,22,6,16,
214,0,21,6,15,
215,0,22,7,15,
216,0,24,7,17,
217,0,23,7,16,
218,0,22,7,15,
219,0,23,6,17,
220,0,24,6,18,
221,0,22,6,16,
222,0,24,7,17,
223,0,23,6,17,
224,0,24,7,17,
225,0,24,8,16,
226,0,25,7,18,
227,0,24,7,17,
228,0,23,7,16,
229,0,25,7,18,
230,0,23,6,17,
231,0,24,7,17,
232,0,23,6,17,
233,0,24,6,18,
234,0,23,6,17,
235,0,26,7,19,
236,0,23,6,17,
237,0,23,7,16,
238,0,24,6,18,
239,0,23,6,17,
240,0,23,7,16,
241,0,22,6,16,
242,0,22,7,15,
243,0,22,6,16,
244,0,22,6,16,
245,0,22,7,15,
246,0,23,6,17,
247,0,22,6,16,
248,0,23,7,16,
249,0,23,7,16,
250,0,23,6,17,
251,0,23,7,16,
252,0,25,7,18,
253,0,24,6,18,
254,0,24,7,17,
255,0,23,6,17,
256,0,24,7,17,
257,0,23,6,17,
258,0,22,6,16,
259,0,22,7,15,
260,0,23,6,17,
261,0,22,6,16,
262,0,25,7,18,
263,0,23,6,17,
264,0,22,6,16,
265,0,24,7,17,
266,0,23,6,17,
267,0,23,7,16,
268,0,24,6,18,
269,0,23,6,17,
270,0,23,7,16,
271,0,22,6,16,
272,0,21,6,15,
273,0,23,7,16,
274,0,21,6,15,
275,0,22,7,15,
276,0,23,7,16,
277,0,23,6,17,
278,0,26,7,19,
279,0,23,6,17,
280,0,26,7,19,
281,0,23,5,18,
282,0,23,7,16,
283,0,22,6,16,
284,0,24,7,17,
285,0,21,6,15,
286,0,23,7,16,
287,0,23,6,17,
288,0,22,6,16,
289,0,24,7,17,
290,0,23,6,17,
291,0,23,6,17,
292,0,23,7,16,
293,0,21,6,15,
294,0,24,7,17,
295,0,22,6,16,
296,0,22,7,15,
297,0,23,6,17,
298,0,22,6,16,
299,0,25,7,18,
300,0,23,6,17,
301,0,22,6,16,
302,0,23,7,16,
303,0,23,7,16,
304,0,23,6,17,
305,0,21,6,15,
306,0,23,7,16,
307,0,21,6,15,
308,0,26,8,18,
309,0,24,6,18,
310,0,24,6,18,
311,0,23,6,17,
312,0,23,7,16,
313,0,23,6,17,
314,0,22,6,16,
315,0,25,8,17,
316,0,27,9,18,
317,0,25,6,19,
318,0,24,6,18,
319,0,23,7,16,
320,0,23,6,17,
321,0,24,7,17,
322,0,22,6,16,
323,0,24,7,17,
324,0,22,6,16,
325,0,24,7,17,
326,0,25,7,18,
327,0,23,6,17,
328,0,24,6,18,
329,0,22,6,16,
330,0,25,7,18,
331,0,25,7,18,
332,0,24,6,18,
333,0,22,6,16,
334,0,21,6,15,
335,0,23,7,16,
336,0,22,6,16,
337,0,24,7,17,
338,0,21,6,15,
339,0,22,7,15,
340,0,22,7,15,
341,0,23,6,17,
342,0,23,7,16,
343,0,23,6,17,
344,0,22,6,16,
345,0,25,7,18,
346,0,23,6,17,
347,0,23,7,16,
348,0,24,6,18,
349,0,26,8,18,
350,0,23,7,16,
351,0,23,7,16,
352,0,26,7,19,
353,0,22,6,16,
354,0,23,6,17,
355,0,23,6,17,
356,0,23,7,16,
357,0,24,7,17,
358,0,22,6,16,
359,0,24,7,17,
360,0,22,6,16,
361,0,23,6,17,
362,0,23,7,16,
363,0,23,6,17,
364,0,23,6,17,
365,0,23,7,16,
366,0,24,6,18,
367,0,24,6,18,
368,0,25,7,18,
369,0,23,6,17,
370,0,24,7,17,
371,0,25,7,18,
372,0,24,6,18,
373,0,23,6,17,
374,0,24,7,17,
375,0,22,6,16,
376,0,24,7,17,
377,0,23,6,17,
378,0,22,7,15,
379,0,23,6,17,
380,0,23,6,17,
381,0,23,7,16,
382,0,23,6,17,
383,0,22,6,16,
384,0,24,7,17,
385,0,22,6,16,
386,0,25,7,18,
387,0,24,6,18,
388,0,24,7,17,
389,0,23,7,16,
390,0,21,6,15,
391,0,23,7,16,
392,0,21,6,15,
393,0,25,7,18,
394,0,23,6,17,
395,0,22,6,16,
396,0,24,7,17,
397,0,22,6,16,
398,0,24,7,17,
399,0,23,7,16,
400,0,22,7,15,
401,0,23,6,17,
402,0,24,6,18,
403,0,23,6,17,
404,0,23,7,16,
405,0,23,6,17,
406,0,24,7,17,
407,0,26,8,18,
408,0,22,7,15,
409,0,22,7,15,
410,0,22,6,16,
411,0,26,8,18,
412,0,26,7,19,
413,0,23,6,17,
414,0,26,7,19,
415,0,23,6,17,
416,0,24,7,17,
417,0,23,6,17,
418,0,23,6,17,
419,0,21,6,15,
420,0,25,7,18,
421,0,23,6,17,
422,0,22,6,16,
423,0,24,7,17,
424,0,22,6,16,
425,0,24,7,17,
426,0,23,6,17,
427,0,23,7,16,
428,0,23,6,17,
429,0,26,7,19,
430,0,23,7,16,
431,0,25,6,19,
432,0,23,6,17,
433,0,25,7,18,
434,0,23,6,17,
435,0,22,6,16,
436,0,21,6,15,
437,0,24,7,17,
438,0,22,6,16,
439,0,21,6,15,
440,0,24,7,17,
441,0,23,6,17,
442,0,23,7,16,
443,0,23,6,17,
444,0,24,7,17,
445,0,24,6,18,
446,0,23,6,17,
447,0,22,6,16,
448,0,24,7,17,
449,0,21,6,15,
450,0,23,7,16,
451,0,23,6,17,
452,0,22,6,16,
453,0,24,7,17,
454,0,22,6,16,
455,0,25,7,18,
456,0,23,6,17,
457,0,22,6,16,
458,0,26,7,19,
459,0,24,6,18,
460,0,25,8,17,
461,0,22,6,16,
462,0,21,6,15,
463,0,23,7,16,
464,0,22,6,16,
465,0,21,6,15,
466,0,24,7,17,
467,0,23,6,17,
468,0,24,7,17,
469,0,23,6,17,
470,0,23,6,17,
471,0,24,7,17,
472,0,23,6,17,
473,0,25,7,18,
474,0,22,6,16,
475,0,26,7,19,
476,0,24,6,18,
477,0,24,6,18,
478,0,24,7,17,
479,0,22,6,16,
480,0,23,7,16,
481,0,22,6,16,
482,0,24,7,17,
483,0,23,6,17,
484,0,22,6,16,
485,0,24,7,17,
486,0,23,6,17,
487,0,23,7,16,
488,0,23,6,17,
489,0,22,6,16,
490,0,25,7,18,
491,0,23,6,17,
492,0,24,7,17,
493,0,24,6,18,
494,0,23,6,17,
495,0,23,7,16,
496,0,23,6,17,
497,0,22,6,16,
498,0,24,7,17,
499,0,22,6,16,
500,0,26,8,18,
501,0,24,6,18,
502,0,23,6,17,
503,0,22,6,16,
504,0,22,6,16,
505,0,21,7,14,
506,0,24,7,17,
507,0,24,6,18,
508,0,23,6,17,
509,0,25,7,18,
510,0,24,7,17,
511,0,24,6,18,
512,0,24,6,18,
513,0,25,7,18,
514,0,26,8,18,
515,0,25,7,18,
516,0,23,6,17,
517,0,24,7,17,
518,0,23,7,16,
519,0,22,6,16,
520,0,22,6,16,
521,0,23,7,16,
522,0,24,7,17,
523,0,23,6,17,
524,0,22,6,16,
525,0,24,7,17,
526,0,23,6,17,
527,0,23,7,16,
528,0,24,6,18,
529,0,23,7,16,
530,0,22,6,16,
531,0,21,6,15,
532,0,23,7,16,
533,0,22,7,15,
534,0,24,7,17,
535,0,24,7,17,
536,0,23,6,17,
537,0,24,6,18,
538,0,25,7,18,
539,0,24,6,18,
540,0,23,6,17,
541,0,23,7,16,
542,0,24,7,17,
543,0,22,6,16,
544,0,24,6,18,
545,0,24,6,18,
546,0,23,7,16,
547,0,24,6,18,
548,0,23,6,17,
549,0,24,8,16,
550,0,22,7,15,
551,0,21,6,15,
552,0,25,7,18,
553,0,23,6,17,
554,0,23,7,16,
555,0,23,6,17,
556,0,21,6,15,
557,0,23,7,16,
558,0,22,6,16,
559,0,22,6,16,
560,0,22,7,15,
561,0,25,6,19,
562,0,23,6,17,
563,0,25,7,18,
564,0,22,6,16,
565,0,23,7,16,
566,0,23,6,17,
567,0,22,6,16,
568,0,23,6,17,
569,0,24,7,17,
570,0,23,6,17,
571,0,24,7,17,
572,0,22,6,16,
573,0,21,6,15,
574,0,24,7,17,
575,0,24,6,18,
576,0,23,6,17,
577,0,22,6,16,
578,0,24,7,17,
579,0,23,7,16,
580,0,23,6,17,
581,0,22,6,16,
582,0,23,7,16,
583,0,23,6,17,
584,0,27,8,19,
585,0,23,6,17,
586,0,22,6,16,
587,0,25,7,18,
588,0,25,9,16,
589,0,23,6,17,
590,0,25,7,18,
591,0,23,7,16,
592,0,25,7,18,
593,0,23,6,17,
594,0,26,7,19,
595,0,23,5,18,
596,0,23,7,16,
597,0,14,5,9,
598,0,22,6,16,
599,0,23,7,16,
600,0,24,7,17,
601,0,24,6,18,
602,0,22,6,16,
603,0,24,7,17,
604,0,23,6,17,
605,0,25,6,19,
606,0,23,7,16,
607,0,22,6,16,
608,0,22,7,15,
609,0,22,6,16,
610,0,21,6,15,
611,0,22,7,15,
612,0,23,7,16,
613,0,22,7,15,
614,0,23,6,17,
615,0,22,6,16,
616,0,25,7,18,
617,0,23,6,17,
618,0,22,6,16,
619,0,24,7,17,
620,0,23,6,17,
621,0,23,7,16,
622,0,24,6,18,
623,0,23,6,17,
624,0,23,7,16,
625,0,22,6,16,
626,0,21,6,15,
627,0,22,7,15,
628,0,25,7,18,
629,0,24,6,18,
630,0,23,7,16,
631,0,23,6,17,
632,0,21,6,15,
633,0,22,7,15,
634,0,24,7,17,
635,0,22,6,16,
636,0,21,6,15,
637,0,24,7,17,
638,0,23,6,17,
639,0,23,7,16,
640,0,23,7,16,
641,0,24,7,17,
642,0,25,7,18,
643,0,23,6,17,
644,0,22,6,16,
645,0,25,7,18,
646,0,24,6,18,
647,0,24,7,17,
648,0,22,6,16,
649,0,21,6,15,
650,0,23,7,16,
651,0,22,6,16,
652,0,22,7,15,
653,0,23,6,17,
654,0,23,6,17,
655,0,24,7,17,
656,0,23,7,16,
657,0,24,7,17,
658,0,22,6,16,
659,0,25,7,18,
660,0,23,7,16,
661,0,24,7,17,
662,0,24,6,18,
663,0,24,6,18,
664,0,22,6,16,
665,0,25,7,18,
666,0,23,6,17,
667,0,23,7,16,
668,0,24,6,18,
669,0,23,6,17,
670,0,24,7,17,
671,0,24,7,17,
672,0,23,7,16,
673,0,23,7,16,
674,0,23,6,17,
675,0,23,6,17,
676,0,21,6,15,
677,0,24,7,17,
678,0,22,6,16,
679,0,26,8,18,
680,0,23,7,16,
681,0,26,6,20,
682,0,23,6,17,
683,0,23,7,16,
684,0,23,6,17,
685,0,22,6,16,
686,0,24,7,17,
687,0,25,7,18,
688,0,23,6,17,
689,0,23,7,16,
690,0,23,5,18,
691,0,24,7,17,
692,0,22,6,16,
693,0,23,6,17,
694,0,25,7,18,
695,0,22,6,16,
696,0,25,7,18,
697,0,23,6,17,
698,0,23,7,16,
699,0,23,6,17,
700,0,25,6,19,
701,0,24,7,17,
702,0,22,6,16,
703,0,24,7,17,
704,0,23,6,17,
705,0,24,6,18,
706,0,24,7,17,
707,0,24,6,18,
708,0,22,6,16,
709,0,26,7,19,
710,0,24,6,18,
711,0,23,6,17,
712,0,23,7,16,
713,0,21,6,15,
714,0,22,7,15,
715,0,22,7,15,
716,0,22,6,16,
717,0,22,6,16,
718,0,22,6,16,
719,0,25,7,18,
720,0,23,6,17,
721,0,24,7,17,
722,0,23,6,17,
723,0,22,6,16,
724,0,24,7,17,
725,0,23,6,17,
726,0,24,6,18,
727,0,23,6,17,
728,0,24,7,17,
729,0,22,6,16,
730,0,23,7,16,
731,0,22,7,15,
732,0,25,7,18,
733,0,23,7,16,
734,0,25,7,18,
735,0,24,6,18,
736,0,23,6,17,
737,0,26,7,19,
738,0,24,6,18,
739,0,23,7,16,
740,0,23,6,17,
741,0,23,6,17,
742,0,23,7,16,
743,0,21,6,15,
744,0,22,7,15,
745,0,22,6,16,
746,0,24,7,17,
747,0,25,6,19,
748,0,23,6,17,
749,0,23,7,16,
750,0,24,7,17,
751,0,22,6,16,
752,0,25,7,18,
753,0,23,6,17,
754,0,23,7,16,
755,0,24,6,18,
756,0,23,6,17,
757,0,23,7,16,
758,0,24,7,17,
759,0,24,6,18,
760,0,25,7,18,
761,0,24,7,17,
762,0,24,6,18,
763,0,24,7,17,
764,0,23,7,16,
765,0,22,6,16,
766,0,22,6,16,
767,0,22,7,15,
768,0,23,6,17,
769,0,22,6,16,
770,0,25,8,17,
771,0,22,6,16,
772,0,26,7,19,
773,0,23,7,16,
774,0,23,6,17,
775,0,24,6,18,
776,0,24,7,17,
777,0,24,6,18,
778,0,23,6,17,
779,0,23,7,16,
780,0,25,7,18,
781,0,22,6,16,
782,0,26,7,19,
783,0,24,6,18,
784,0,23,7,16,
785,0,25,7,18,
786,0,23,6,17,
787,0,24,7,17,
788,0,23,6,17,
789,0,22,6,16,
790,0,22,7,15,
791,0,24,7,17,
792,0,23,6,17,
793,0,23,7,16,
794,0,22,6,16,
795,0,25,7,18,
796,0,23,6,17,
797,0,23,7,16,
798,0,24,6,18,
799,0,25,7,18,
800,0,23,6,17,
801,0,26,7,19,
802,0,23,6,17,
803,0,22,6,16,
804,0,24,7,17,
805,0,24,6,18,
806,0,24,7,17,
807,0,23,6,17,
808,0,23,6,17,
809,0,21,6,15,
810,0,26,7,19,
811,0,24,7,17,
812,0,25,7,18,
813,0,22,6,16,
814,0,24,6,18,
815,0,24,7,17,
816,0,21,6,15,
817,0,26,8,18,
818,0,26,7,19,
819,0,22,6,16,
820,0,24,7,17,
821,0,24,7,17,
822,0,22,7,15,
823,0,23,6,17,
824,0,23,7,16,
825,0,21,6,15,
826,0,25,7,18,
827,0,23,6,17,
828,0,23,6,17,
829,0,23,6,17,
830,0,25,8,17,
831,0,24,6,18,
832,0,23,6,17,
833,0,24,7,17,
834,0,22,6,16,
835,0,23,6,17,
836,0,23,7,16,
837,0,24,7,17,
838,0,22,6,16,
839,0,25,7,18,
840,0,23,6,17,
841,0,24,7,17,
842,0,22,6,16,
843,0,21,6,15,
844,0,23,7,16,
845,0,21,6,15,
846,0,27,8,19,
847,0,24,6,18,
848,0,24,6,18,
849,0,22,6,16,
850,0,23,7,16,
851,0,23,6,17,
852,0,24,6,18,
853,0,22,6,16,
854,0,24,7,17,
855,0,23,6,17,
856,0,24,7,17,
857,0,22,6,16,
858,0,24,7,17,
859,0,23,6,17,
860,0,23,6,17,
861,0,27,8,19,
862,0,23,6,17,
863,0,24,7,17,
864,0,26,7,19,
865,0,24,6,18,
866,0,23,6,17,
867,0,26,8,18,
868,0,24,7,17,
869,0,23,7,16,
870,0,23,7,16,
871,0,24,7,17,
872,0,24,6,18,
873,0,24,6,18,
874,0,22,6,16,
875,0,25,7,18,
876,0,23,6,17,
877,0,23,7,16,
878,0,24,6,18,
879,0,23,6,17,
880,0,23,7,16,
881,0,22,6,16,
882,0,23,8,15,
883,0,23,6,17,
884,0,23,6,17,
885,0,24,7,17,
886,0,26,7,19,
887,0,13,2,11,
888,0,24,7,17,
889,0,25,8,17,
890,0,30,13,17,
891,0,27,9,18,
892,0,27,11,16,
893,0,24,8,16,
894,0,25,7,18,
895,0,24,8,16,
896,0,25,9,16,
897,0,24,8,16,
898,0,22,7,15,
899,0,23,8,15,
900,0,25,8,17,
901,0,25,8,17,
902,0,25,9,16,
903,0,24,7,17,
904,0,26,10,16,
905,0,27,9,18,
906,0,24,7,17,
907,0,29,11,18,
908,0,28,10,18,
909,0,26,10,16,
910,0,28,11,17,
911,0,27,8,19,
912,0,31,12,18,1
913,0,29,13,16,
914,0,29,14,15,
915,0,29,12,17,
916,0,28,12,16,
917,0,29,13,16,
918,0,28,12,16,
919,0,29,13,16,
920,0,32,13,18,1
921,0,29,12,17,
922,0,30,13,17,
923,0,29,12,17,
924,0,31,13,18,
925,0,31,13,18,
926,0,30,13,17,
927,0,29,11,17,1
928,0,29,13,16,
929,0,28,13,15,
930,0,30,13,17,
931,0,30,13,17,
932,0,30,13,17,
933,0,30,14,16,
934,0,29,13,16,
935,0,32,13,19,
936,0,31,13,18,
937,0,30,13,17,
938,0,28,12,16,
939,0,30,13,17,
940,0,30,13,17,
941,0,29,12,17,
942,0,31,13,17,1
943,0,31,13,18,
944,0,30,13,17,
945,0,29,13,16,
946,0,28,12,16,
947,0,29,13,16,
948,0,29,13,16,
949,0,28,12,16,
950,0,27,12,15,
951,0,29,13,16,
952,0,27,9,18,
953,0,23,6,17,
954,0,24,7,17,
955,0,26,8,18,
956,0,23,6,17,
957,0,25,6,19,
958,0,26,7,18,1
959,0,23,6,17,
960,0,24,7,17,
961,0,22,6,16,
962,0,21,6,15,
963,0,23,7,16,
964,0,22,6,16,
965,0,21,6,15,
966,0,24,7,17,
967,0,22,6,16,
968,0,23,7,16,
969,0,23,6,17,
970,0,23,7,16,
971,0,23,7,16,
972,0,25,9,16,
973,0,25,7,18,
974,0,23,6,17,
975,0,24,8,16,
976,0,22,6,16,
977,0,22,7,15,
978,0,23,7,16,
979,0,21,6,15,
980,0,25,7,18,
981,0,24,6,18,
982,0,23,7,16,
983,0,22,6,16,
984,0,23,7,16,
985,0,24,7,17,
986,0,22,6,16,
987,0,21,6,15,
988,0,25,8,16,1
989,0,21,6,15,
990,0,23,7,16,
991,0,24,6,18,
992,0,23,6,17,
993,0,24,6,18,
994,0,25,7,18,
995,0,23,6,17,
996,0,24,7,17,
997,0,24,6,18,
998,0,23,7,16,
999,0,24,7,17,
1000,0,24,6,18,
1001,0,23,6,17,
1002,0,22,6,16,
1003,0,24,7,17,
1004,0,27,7,20,
1005,0,25,8,17,
1006,0,24,6,18,
1007,0,22,6,16,
1008,0,24,7,17,
1009,0,22,6,16,
1010,0,24,7,17,
1011,0,24,6,18,
1012,0,23,6,17,
1013,0,23,7,16,
1014,0,24,6,18,
1015,0,23,6,17,
1016,0,23,7,16,
1017,0,22,6,16,
1018,0,22,6,15,1
1019,0,23,7,16,
1020,0,24,6,18,
1021,0,23,6,17,
1022,0,25,7,18,
1023,0,23,6,17,
1024,0,22,6,16,
1025,0,25,7,18,
1026,0,23,6,17,
1027,0,23,6,17,
1028,0,24,7,17,
1029,0,24,6,18,
1030,0,23,6,17,
1031,0,23,7,16,
1032,0,22,6,16,
1033,0,23,6,17,
1034,0,26,8,18,
1035,0,24,6,18,
1036,0,24,7,17,
1037,0,22,6,16,
1038,0,23,7,16,
1039,0,22,6,16,
1040,0,21,6,15,
1041,0,24,7,17,
1042,0,22,6,16,
1043,0,25,9,16,
1044,0,22,6,16,
1045,0,23,7,16,
1046,0,23,6,17,
1047,0,23,7,16,
1048,0,26,7,19,
1049,0,24,7,16,1
1050,0,25,7,18,
1051,0,23,6,17,
1052,0,24,7,17,
1053,0,23,6,17,
1054,0,22,7,15,
1055,0,22,6,16,
1056,0,21,6,15,
1057,0,26,7,19,
1058,0,22,6,16,
1059,0,24,7,17,
1060,0,23,6,17,
1061,0,23,7,16,
1062,0,23,6,17,
1063,0,22,6,16,
1064,0,26,8,18,
1065,0,23,6,17,
1066,0,23,6,17,
1067,0,22,7,15,
1068,0,23,6,17,
1069,0,22,6,16,
1070,0,24,7,17,
1071,0,22,6,16,
1072,0,24,7,17,
1073,0,21,6,15,
1074,0,23,7,16,
1075,0,22,7,15,
1076,0,22,7,15,
1077,0,26,7,19,
1078,0,24,6,18,
1079,0,26,7,18,1
1080,0,22,6,16,
1081,0,26,8,18,
1082,0,23,6,17,
1083,0,24,7,17,
1084,0,23,6,17,
1085,0,22,6,16,
1086,0,22,7,15,
1087,0,22,6,16,
1088,0,22,6,16,
1089,0,23,6,17,
1090,0,24,7,17,
1091,0,23,6,17,
1092,0,23,7,16,
1093,0,23,6,17,
1094,0,24,7,17,
1095,0,25,7,18,
1096,0,25,9,16,
1097,0,24,6,18,
1098,0,23,6,17,
1099,0,23,7,16,
1100,0,22,7,15,
1101,0,24,6,18,
1102,0,23,6,17,
1103,0,24,7,17,
1104,0,23,7,16,
1105,0,23,6,17,
1106,0,23,6,17,
1107,0,26,7,19,
1108,0,22,6,16,
1109,0,26,8,17,1
1110,0,21,6,15,
1111,0,23,7,16,
1112,0,23,6,17,
1113,0,23,6,17,
1114,0,24,6,18,
1115,0,24,7,17,
1116,0,24,7,17,
1117,0,25,6,19,
1118,0,23,6,17,
1119,0,24,7,17,
1120,0,22,6,16,
1121,0,21,6,15,
1122,0,24,7,17,
1123,0,22,6,16,
1124,0,22,7,15,
1125,0,24,7,17,
1126,0,22,6,16,
1127,0,23,7,16,
1128,0,23,7,16,
1129,0,23,6,17,
1130,0,22,6,16,
1131,0,25,7,18,
1132,0,25,6,19,
1133,0,24,7,17,
1134,0,25,8,17,
1135,0,25,7,18,
1136,0,24,6,18,
1137,0,24,7,17,
1138,0,23,7,16,
1139,0,23,6,17,
1140,0,27,8,18,1
1141,0,23,6,17,
1142,0,22,6,16,
1143,0,25,7,18,
1144,0,24,7,17,
1145,0,23,6,17,
1146,0,23,7,16,
1147,0,23,6,17,
1148,0,22,6,16,
1149,0,25,7,18,
1150,0,23,6,17,
1151,0,22,6,16,
1152,0,25,7,18,
1153,0,24,6,18,
1154,0,25,7,18,
1155,0,24,7,17,
1156,0,23,7,16,
1157,0,21,6,15,
1158,0,24,7,17,
1159,0,22,6,16,
1160,0,21,6,15,
1161,0,24,7,17,
1162,0,23,6,17,
1163,0,23,7,16,
1164,0,23,6,17,
1165,0,22,6,16,
1166,0,24,7,17,
1167,0,23,6,17,
1168,0,22,6,16,
1169,0,25,7,18,
1170,0,25,6,18,1
1171,0,24,7,17,
1172,0,22,6,16,
1173,0,21,6,15,
1174,0,23,7,16,
1175,0,22,6,16,
1176,0,24,7,17,
1177,0,24,7,17,
1178,0,23,6,17,
1179,0,23,7,16,
1180,0,24,6,18,
1181,0,23,6,17,
1182,0,23,7,16,
1183,0,23,6,17,
1184,0,25,6,19,
1185,0,23,6,17,
1186,0,24,7,17,
1187,0,22,6,16,
1188,0,26,7,19,
1189,0,24,6,18,
1190,0,23,7,16,
1191,0,23,6,17,
1192,0,24,7,17,
1193,0,23,6,17,
1194,0,24,7,17,
1195,0,24,7,17,
1196,0,22,6,16,
1197,0,22,6,16,
1198,0,22,7,15,
1199,0,22,6,16,
1200,0,25,7,17,1
1201,0,21,6,15,
1202,0,26,7,19,
1203,0,24,6,18,
1204,0,24,7,17,
1205,0,23,6,17,
1206,0,23,6,17,
1207,0,24,8,16,
1208,0,21,6,15,
1209,0,24,7,17,
1210,0,24,6,18,
1211,0,24,6,18,
1212,0,23,7,16,
1213,0,23,6,17,
1214,0,22,6,16,
1215,0,27,8,19,
1216,0,24,6,18,
1217,0,24,7,17,
1218,0,23,6,17,
1219,0,24,7,17,
1220,0,24,6,18,
1221,0,22,6,16,
1222,0,24,7,17,
1223,0,22,6,16,
1224,0,25,6,19,
1225,0,26,7,19,
1226,0,23,6,17,
1227,0,25,7,18,
1228,0,24,7,17,
1229,0,22,6,16,
1230,0,21,6,15,
1231,0,23,7,15,1
1232,0,23,7,16,
1233,0,22,6,16,
1234,0,23,6,17,
1235,0,23,6,17,
1236,0,23,7,16,
1237,0,23,6,17,
1238,0,22,6,16,
1239,0,23,7,16,
1240,0,26,7,19,
1241,0,24,6,18,
1242,0,24,8,16,
1243,0,23,6,17,
1244,0,23,6,17,
1245,0,23,7,16,
1246,0,24,7,17,
1247,0,22,6,16,
1248,0,24,7,17,
1249,0,24,7,17,
1250,0,24,6,18,
1251,0,24,6,18,
1252,0,23,6,17,
1253,0,25,7,18,
1254,0,23,6,17,
1255,0,22,6,16,
1256,0,23,7,16,
1257,0,22,6,16,
1258,0,25,7,18,
1259,0,24,7,17,
1260,0,25,7,18,
1261,0,26,7,18,1
1262,0,24,6,18,
1263,0,23,6,17,
1264,0,23,7,16,
1265,0,22,6,16,
1266,0,23,7,16,
1267,0,22,7,15,
1268,0,24,6,18,
1269,0,23,6,17,
1270,0,25,7,18,
1271,0,23,6,17,
1272,0,24,6,18,
1273,0,22,6,16,
1274,0,25,7,18,
1275,0,25,6,19,
1276,0,25,7,18,
1277,0,23,6,17,
1278,0,24,7,17,
1279,0,24,7,17,
1280,0,22,6,16,
1281,0,22,6,16,
1282,0,21,6,15,
1283,0,26,7,19,
1284,0,25,8,17,
1285,0,23,7,16,
1286,0,24,7,17,
1287,0,24,7,17,
1288,0,23,7,16,
1289,0,22,7,15,
1290,0,25,6,19,
1291,0,25,7,18,
1292,0,25,6,18,1
1293,0,24,7,17,
1294,0,22,6,16,
1295,0,21,6,15,
1296,0,23,7,16,
1297,0,22,6,16,
1298,0,22,7,15,
1299,0,23,6,17,
1300,0,23,6,17,
1301,0,23,7,16,
1302,0,23,6,17,
1303,0,22,6,16,
1304,0,24,7,17,
1305,0,22,6,16,
1306,0,23,7,16,
1307,0,24,6,18,
1308,0,25,7,18,
1309,0,23,6,17,
1310,0,23,7,16,
1311,0,24,6,18,
1312,0,23,6,17,
1313,0,23,7,16,
1314,0,22,6,16,
1315,0,23,8,15,
1316,0,28,13,15,
1317,0,29,13,16,
1318,0,28,12,16,
1319,0,29,13,16,
1320,0,27,11,16,
1321,0,30,13,17,
1322,0,29,12,16,1
1323,0,30,13,17,
1324,0,29,12,17,
1325,0,30,13,17,
1326,0,29,13,16,
1327,0,31,13,18,
1328,0,30,12,18,
1329,0,30,13,17,
1330,0,30,13,17,
1331,0,28,11,17,
1332,0,29,13,16,
1333,0,27,11,16,
1334,0,29,13,16,
1335,0,29,12,17,
1336,0,29,13,16,
1337,0,29,13,16,
1338,0,29,12,17,
1339,0,30,13,17,
1340,0,29,12,17,
1341,0,28,12,16,
1342,0,27,11,16,
1343,0,30,13,17,
1344,0,28,12,16,
1345,0,29,13,16,
1346,0,31,13,18,
1347,0,30,12,18,
1348,0,30,13,17,
1349,0,30,13,17,
1350,0,30,12,18,
1351,0,31,13,18,
1352,0,29,12,16,1
1353,0,28,12,16,
1354,0,29,13,16,
1355,0,30,13,17,
1356,0,29,13,16,
1357,0,28,12,16,
1358,0,30,13,17,
1359,0,30,13,17,
1360,0,30,13,17,
1361,0,29,12,17,
1362,0,29,13,16,
1363,0,28,12,16,
1364,0,29,13,16,
1365,0,28,12,16,
1366,0,30,13,17,
1367,0,29,13,16,
1368,0,29,13,16,
1369,0,29,12,17,
1370,0,29,12,17,
1371,0,28,12,16,
1372,0,29,13,16,
1373,0,29,12,17,
1374,0,29,13,16,
1375,0,30,13,17,
1376,0,28,12,16,
1377,0,31,13,18,
1378,0,29,12,17,
1379,0,31,12,19,
1380,0,30,12,18,
1381,0,28,12,16,
1382,0,29,13,16,
1383,0,31,13,17,1
1384,0,29,13,16,
1385,0,29,12,17,
1386,0,30,13,17,
1387,0,31,13,18,
1388,0,31,13,18,
1389,0,28,12,16,
1390,0,29,12,17,
1391,0,28,11,17,
1392,0,30,13,17,
1393,0,29,12,17,
1394,0,29,13,16,
1395,0,30,13,17,
1396,0,27,11,16,
1397,0,29,13,16,
1398,0,29,13,16,
1399,0,28,13,15,
1400,0,29,12,17,
1401,0,28,12,16,
1402,0,29,13,16,
1403,0,28,12,16,
1404,0,27,11,16,
1405,0,24,7,17,
1406,0,24,8,16,
1407,0,22,6,16,
1408,0,25,7,18,
1409,0,23,6,17,
1410,0,22,6,16,
1411,0,25,7,18,
1412,0,23,6,17,
1413,0,26,8,17,1
1414,0,22,6,16,
1415,0,21,6,15,
1416,0,23,7,16,
1417,0,22,6,16,
1418,0,21,6,15,
1419,0,24,7,17,
1420,0,22,6,16,
1421,0,23,7,16,
1422,0,23,6,17,
1423,0,22,6,16,
1424,0,24,7,17,
1425,0,22,6,16,
1426,0,23,7,16,
1427,0,23,6,17,
1428,0,24,7,17,
1429,0,23,6,17,
1430,0,23,7,16,
1431,0,23,6,17,
1432,0,22,6,16,
1433,0,24,7,17,
1434,0,23,6,17,
1435,0,23,7,16,
1436,0,24,6,18,
1437,0,24,6,18,
1438,0,24,7,17,
1439,0,22,6,16,
1440,0,21,6,15,
1441,0,23,7,16,
1442,0,22,6,16,
1443,0,23,7,15,1
1444,0,23,6,17,
1445,0,22,6,16,
1446,0,25,7,18,
1447,0,23,6,17,
1448,0,22,6,16,
1449,0,24,7,17,
1450,0,23,6,17,
1451,0,23,7,16,
1452,0,24,6,18,
1453,0,23,6,17,
1454,0,23,7,16,
1455,0,22,6,16,
1456,0,21,6,15,
1457,0,23,7,16,
1458,0,22,6,16,
1459,0,22,7,15,
1460,0,25,6,19,
1461,0,23,6,17,
1462,0,25,7,18,
1463,0,24,6,18,
1464,0,23,7,16,
1465,0,23,6,17,
1466,0,23,6,17,
1467,0,24,7,17,
1468,0,24,7,17,
1469,0,22,6,16,
1470,0,24,7,17,
1471,0,23,6,17,
1472,0,23,7,16,
1473,0,23,6,17,
1474,0,23,6,16,1
1475,0,26,7,19,
1476,0,24,6,18,
1477,0,23,6,17,
1478,0,23,7,16,
1479,0,21,6,15,
1480,0,22,7,15,
1481,0,22,7,15,
1482,0,22,6,16,
1483,0,21,6,15,
1484,0,26,7,19,
1485,0,22,5,17,
1486,0,24,7,17,
1487,0,22,6,16,
1488,0,24,7,17,
1489,0,23,7,16,
1490,0,23,6,17,
1491,0,22,6,16,
1492,0,24,6,18,
1493,0,24,7,17,
1494,0,23,6,17,
1495,0,22,6,16,
1496,0,23,7,16,
1497,0,23,7,16,
1498,0,22,6,16,
1499,0,24,7,17,
1500,0,22,6,16,
1501,0,22,7,15,
1502,0,24,6,18,
1503,0,26,8,18,
1504,0,25,6,18,1
1505,0,25,7,18,
1506,0,24,7,17,
1507,0,22,6,16,
1508,0,21,6,15,
1509,0,23,7,16,
1510,0,22,6,16,
1511,0,22,7,15,
1512,0,23,6,17,
1513,0,23,6,17,
1514,0,23,7,16,
1515,0,23,6,17,
1516,0,24,7,17,
1517,0,22,6,16,
1518,0,21,6,15,
1519,0,23,7,16,
1520,0,21,6,15,
1521,0,26,7,19,
1522,0,23,6,17,
1523,0,25,7,18,
1524,0,23,6,17,
1525,0,23,7,16,
1526,0,23,5,18,
1527,0,23,7,16,
1528,0,21,6,15,
1529,0,22,7,15,
1530,0,22,6,16,
1531,0,21,6,15,
1532,0,21,6,15,
1533,0,24,7,17,
1534,0,26,8,17,1
1535,0,24,6,18,
1536,0,24,7,17,
1537,0,25,7,18,
1538,0,22,6,16,
1539,0,23,7,16,
1540,0,24,6,18,
1541,0,23,6,17,
1542,0,24,7,17,
1543,0,22,6,16,
1544,0,21,6,15,
1545,0,23,7,16,
1546,0,24,7,17,
1547,0,22,6,16,
1548,0,23,7,16,
1549,0,24,6,18,
1550,0,24,6,18,
1551,0,25,7,18,
1552,0,23,6,17,
1553,0,25,7,18,
1554,0,23,6,17,
1555,0,23,7,16,
1556,0,22,6,16,
1557,0,22,7,15,
1558,0,22,6,16,
1559,0,21,6,15,
1560,0,22,7,15,
1561,0,23,6,17,
1562,0,22,6,16,
1563,0,24,7,17,
1564,0,23,7,16,
1565,0,24,7,16,1
1566,0,24,7,17,
1567,0,25,6,19,
1568,0,23,6,17,
1569,0,24,7,17,
1570,0,22,6,16,
1571,0,21,6,15,
1572,0,23,7,16,
1573,0,21,6,15,
1574,0,22,7,15,
1575,0,23,6,17,
1576,0,24,6,18,
1577,0,25,7,18,
1578,0,24,6,18,
1579,0,25,7,18,
1580,0,23,6,17,
1581,0,24,6,18,
1582,0,24,7,17,
1583,0,23,7,16,
1584,0,22,6,16,
1585,0,22,7,15,
1586,0,22,6,16,
1587,0,21,6,15,
1588,0,24,7,17,
1589,0,22,6,16,
1590,0,23,7,16,
1591,0,24,7,17,
1592,0,25,7,18,
1593,0,23,6,17,
1594,0,24,7,17,
1595,0,24,6,17,1
1596,0,24,7,17,
1597,0,25,8,17,
1598,0,22,6,16,
1599,0,22,6,16,
1600,0,22,7,15,
1601,0,23,7,16,
1602,0,21,6,15,
1603,0,25,7,18,
1604,0,23,6,17,
1605,0,23,6,17,
1606,0,22,6,16,
1607,0,25,7,18,
1608,0,23,6,17,
1609,0,22,6,16,
1610,0,25,7,18,
1611,0,23,6,17,
1612,0,24,7,17,
1613,0,22,6,16,
1614,0,21,6,15,
1615,0,23,7,16,
1616,0,22,6,16,
1617,0,21,6,15,
1618,0,24,7,17,
1619,0,26,8,18,
1620,0,23,6,17,
1621,0,24,7,17,
1622,0,23,6,17,
1623,0,23,7,16,
1624,0,23,7,16,
1625,0,24,6,17,1
1626,0,22,6,16,
1627,0,21,6,15,
1628,0,23,7,16,
1629,0,22,6,16,
1630,0,24,6,18,
1631,0,23,7,16,
1632,0,23,6,17,
1633,0,22,6,16,
1634,0,25,8,17,
1635,0,24,7,17,
1636,0,22,6,16,
1637,0,24,7,17,
1638,0,21,6,15,
1639,0,22,7,15,
1640,0,25,7,18,
1641,0,23,6,17,
1642,0,23,7,16,
1643,0,23,6,17,
1644,0,25,7,18,
1645,0,23,6,17,
1646,0,22,6,16,
1647,0,24,7,17,
1648,0,23,6,17,
1649,0,24,7,17,
1650,0,24,7,17,
1651,0,22,6,16,
1652,0,24,6,18,
1653,0,23,7,16,
1654,0,23,6,17,
1655,0,25,7,18,
1656,0,24,6,17,1
1657,0,23,7,16,
1658,0,24,6,18,
1659,0,23,6,17,
1660,0,23,7,16,
1661,0,22,6,16,
1662,0,22,7,15,
1663,0,22,6,16,
1664,0,22,6,16,
1665,0,24,7,17,
1666,0,22,6,16,
1667,0,23,6,17,
1668,0,24,7,17,
1669,0,24,6,18,
1670,0,25,7,18,
1671,0,24,7,17,
1672,0,24,7,17,
1673,0,24,7,17,
1674,0,22,6,16,
1675,0,21,6,15,
1676,0,23,7,16,
1677,0,22,6,16,
1678,0,22,7,15,
1679,0,24,7,17,
1680,0,22,6,16,
1681,0,22,6,16,
1682,0,24,7,17,
1683,0,22,6,16,
1684,0,24,7,17,
1685,0,23,7,16,
1686,0,23,7,15,1
1687,0,22,6,16,
1688,0,23,6,17,
1689,0,25,7,18,
1690,0,23,6,17,
1691,0,23,7,16,
1692,0,24,6,18,
1693,0,24,6,18,
1694,0,23,6,17,
1695,0,25,9,16,
1696,0,23,7,16,
1697,0,24,6,18,
1698,0,24,7,17,
1699,0,23,6,17,
1700,0,22,6,16,
1701,0,24,7,17,
1702,0,25,7,18,
1703,0,24,6,18,
1704,0,22,6,16,
1705,0,23,7,16,
1706,0,22,6,16,
1707,0,23,6,17,
1708,0,22,6,16,
1709,0,24,7,17,
1710,0,25,6,19,
1711,0,23,6,17,
1712,0,23,7,16,
1713,0,22,6,16,
1714,0,23,7,16,
1715,0,22,7,15,
1716,0,25,7,17,1
1717,0,22,6,16,
1718,0,24,7,17,
1719,0,23,6,17,
1720,0,22,6,16,
1721,0,24,7,17,
1722,0,23,6,17,
1723,0,23,7,16,
1724,0,24,6,18,
1725,0,23,6,17,
1726,0,23,7,16,
1727,0,23,7,16,
1728,0,23,6,17,
1729,0,22,6,16,
1730,0,22,7,15,
1731,0,22,6,16,
1732,0,22,6,16,
1733,0,22,7,15,
1734,0,22,7,15,
1735,0,23,6,17,
1736,0,23,7,16,
1737,0,24,7,17,
1738,0,23,6,17,
1739,0,23,7,16,
1740,0,24,8,16,
1741,0,24,6,18,
1742,0,25,7,18,
1743,0,23,6,17,
1744,0,24,7,17,
1745,0,22,6,16,
1746,0,23,7,16,
1747,0,24,7,16,1
1748,0,24,7,17,
1749,0,22,6,16,
1750,0,23,6,17,
1751,0,24,7,17,
1752,0,23,6,17,
1753,0,23,7,16,
1754,0,23,6,17,
1755,0,22,6,16,
1756,0,26,7,19,
1757,0,24,7,17,
1758,0,25,7,18,
1759,0,23,6,17,
1760,0,23,7,16,
1761,0,22,6,16,
1762,0,22,7,15,
1763,0,22,6,16,
1764,0,21,6,15,
1765,0,25,7,18,
1766,0,23,6,17,
1767,0,22,6,16,
1768,0,24,7,17,
1769,0,22,6,16,
1770,0,25,8,17,
1771,0,23,7,16,
1772,0,23,6,17,
1773,0,25,7,18,
1774,0,26,6,20,
1775,0,24,6,18,
1776,0,24,7,17,
1777,0,23,6,16,1
1778,0,22,7,15,
1779,0,23,6,17,
1780,0,22,6,16,
1781,0,22,7,15,
1782,0,24,7,17,
1783,0,23,6,17,
1784,0,23,7,16,
1785,0,24,7,17,
1786,0,22,6,16,
1787,0,24,7,17,
1788,0,23,6,17,
1789,0,23,7,16,
1790,0,24,6,18,
1791,0,23,6,17,
1792,0,24,7,17,
1793,0,21,6,15,
1794,0,23,7,16,
1795,0,21,6,15,
1796,0,22,7,15,
1797,0,23,6,17,
1798,0,23,7,16,
1799,0,24,7,17,
1800,0,24,7,17,
1801,0,23,6,17,
1802,0,24,7,17,
1803,0,25,6,19,
1804,0,23,6,17,
1805,0,24,7,17,
1806,0,22,6,16,
1807,0,23,7,15,1
1808,0,23,7,16,
1809,0,21,6,15,
1810,0,26,7,19,
1811,0,22,5,17,
1812,0,24,7,17,
1813,0,22,6,16,
1814,0,23,7,16,
1815,0,23,6,17,
1816,0,22,6,16,
1817,0,25,7,18,
1818,0,23,6,17,
1819,0,24,7,17,
1820,0,22,6,16,
1821,0,23,7,16,
1822,0,23,7,16,
1823,0,22,6,16,
1824,0,24,7,17,
1825,0,23,6,17,
1826,0,23,6,17,
1827,0,23,7,16,
1828,0,23,7,16,
1829,0,23,6,17,
1830,0,22,6,16,
1831,0,26,8,18,
1832,0,23,7,16,
1833,0,25,7,18,
1834,0,23,6,17,
1835,0,22,6,16,
1836,0,22,7,15,
1837,0,22,7,15,
1838,0,23,7,16,
1839,0,24,6,18,
1840,0,23,7,16,
1841,0,23,6,17,
1842,0,22,6,16,
1843,0,24,7,17,
1844,0,22,6,16,
1845,0,23,7,16,
1846,0,23,7,16,
1847,0,24,6,18,
1848,0,24,6,18,
1849,0,24,7,17,
1850,0,22,6,16,
1851,0,21,6,15,
1852,0,23,7,16,
1853,0,21,6,15,
1854,0,22,7,15,
1855,0,23,6,17,
1856,0,22,6,16,
1857,0,25,7,18,
1858,0,23,6,17,
1859,0,23,7,16,
1860,0,23,6,17,
1861,0,25,7,18,
1862,0,24,6,18,
1863,0,27,7,20,
1864,0,29,8,21,
1865,0,29,6,23,
1866,0,28,6,22,
1867,0,31,7,24,
1868,0,32,6,26,
1869,0,32,6,26,
1870,0,34,7,27,
1871,0,33,6,27,
1872,0,37,7,30,
1873,0,36,6,30,
1874,0,35,6,29,
1875,0,38,7,31,
1876,0,37,6,31,
1877,0,38,7,31,
1878,0,38,6,32,
1879,0,39,6,33,
1880,0,39,6,33,
1881,0,42,7,35,
1882,0,40,6,34,
1883,0,43,7,36,
1884,0,41,6,35,
1885,0,43,7,36,
1886,0,42,6,36,
1887,0,43,7,36,
1888,0,43,6,37,
1889,0,44,6,38,
1890,0,44,7,37,
1891,0,45,6,39,
1892,0,44,6,38,
1893,0,48,7,41,
1894,0,47,6,41,
1895,0,46,6,40,
1896,0,47,7,40,
1897,0,47,6,41,
1898,0,46,6,40,
1899,0,49,7,42,
1900,0,47,6,41,
1901,0,50,7,43,
1902,0,48,6,42,
1903,0,53,9,44,
1904,0,51,7,44,
1905,0,50,7,43,
1906,0,50,6,44,
1907,0,50,6,44,
1908,0,52,7,45,
1909,0,51,6,45,
1910,0,53,7,46,
1911,0,51,6,45,
1912,0,54,7,47,
1913,0,53,7,46,
1914,0,53,7,46,
1915,0,53,6,47,
1916,0,53,6,47,
1917,0,55,7,48,
1918,0,54,6,48,
1919,0,55,7,48,
1920,0,55,6,49,
1921,0,55,6,49,
1922,0,55,7,48,
1923,0,56,6,50,
1924,0,55,6,49,
1925,0,56,7,49,
1926,0,59,7,52,
1927,0,57,7,50,
1928,0,57,6,51,
1929,0,56,6,50,
1930,0,60,7,53,
1931,0,58,6,52,
1932,0,57,6,51,
1933,0,60,7,53,
1934,0,58,6,52,
1935,0,59,7,52,
1936,0,59,6,53,
1937,0,60,7,53,
1938,0,61,7,54,
1939,0,60,6,54,
1940,0,60,7,53,
1941,0,62,7,55,
1942,0,61,6,55,
1943,0,60,6,54,
1944,0,62,7,55,
1945,0,61,6,55,
1946,0,64,7,57,
1947,0,62,6,56,
1948,0,61,6,55,
1949,0,63,6,57,
1950,0,64,7,57,
1951,0,62,6,56,
1952,0,66,8,58,
1953,0,64,6,58,
1954,0,64,7,57,
1955,0,64,6,58,
1956,0,65,7,58,
1957,0,65,6,59,
1958,0,66,7,59,
1959,0,64,6,58,
1960,0,65,7,58,
1961,0,66,7,59,
1962,0,66,6,60,
1963,0,67,7,60,
1964,0,65,6,59,
1965,0,67,7,60,
1966,0,67,6,61,
1967,0,66,6,60,
1968,0,68,7,61,
1969,0,67,6,61,
1970,0,68,7,61,
1971,0,68,6,62,
1972,0,67,6,61,
1973,0,68,7,61,
1974,0,69,7,62,
1975,0,69,6,63,
1976,0,68,6,62,
1977,0,70,7,63,
1978,0,69,6,63,
1979,0,69,7,62,
1980,0,70,6,64,
1981,0,69,6,63,
1982,0,71,7,64,
1983,0,72,7,65,
1984,0,70,7,63,
1985,0,70,6,64,
1986,0,73,7,66,
1987,0,71,6,65,
1988,0,72,7,65,
1989,0,72,6,66,
1990,0,72,7,65,
1991,0,72,6,66,
1992,0,71,6,65,
1993,0,73,7,66,
1994,0,73,6,67,
1995,0,72,6,66,
1996,0,74,7,67,
1997,0,73,6,67,
1998,0,74,7,67,
1999,0,74,7,67,
2000,0,74,6,68,
2001,0,75,7,68,
2002,0,73,6,67,
2003,0,76,7,69,
2004,0,75,6,69,
2005,0,76,7,69,
2006,0,76,7,69,
2007,0,74,6,68,
2008,0,76,7,69,
2009,0,76,6,70,
2010,0,76,7,69,
2011,0,76,6,70,
2012,0,78,7,71,
2013,0,76,6,70,
2014,0,76,7,69,
2015,0,78,7,71,
2016,0,78,7,71,
2017,0,78,7,71,
2018,0,77,6,71,
2019,0,77,7,70,
2020,0,78,6,72,
2021,0,78,6,72,
2022,0,79,7,72,
2023,0,79,7,72,
2024,0,78,7,71,
2025,0,80,8,72,
2026,0,80,7,73,
2027,0,79,6,73,
2028,0,79,7,72,
2029,0,79,6,73,
2030,0,79,6,73,
2031,0,80,7,73,
2032,0,80,6,74,
2033,0,79,6,73,
2034,0,81,7,74,
2035,0,80,6,74,
2036,0,81,8,73,
2037,0,81,6,75,
2038,0,80,6,74,
2039,0,83,7,76,
2040,0,81,6,75,
2041,0,80,6,74,
2042,0,82,7,75,
2043,0,82,7,75,
2044,0,83,7,76,
2045,0,82,6,76,
2046,0,82,7,75,
2047,0,81,6,75,
2048,0,83,7,76,
2049,0,82,7,75,
2050,0,82,6,76,
2051,0,81,6,75,
2052,0,83,7,76,
2053,0,81,6,75,
2054,0,77,7,70,
2055,0,64,6,58,
2056,0,53,6,47,
2057,0,55,7,48,
2058,0,48,6,42,
2059,0,42,6,36,
2060,0,37,6,31,
2061,0,37,7,30,
2062,0,42,7,35,
2063,0,51,7,44,
2064,0,54,6,48,
2065,0,55,7,48,
2066,0,56,7,49,
2067,0,55,6,49,
2068,0,58,7,51,
2069,0,56,6,50,
2070,0,57,7,50,
2071,0,57,6,51,
2072,0,56,6,50,
2073,0,58,7,51,
2074,0,58,7,51,
2075,0,58,6,52,
2076,0,58,6,52,
2077,0,60,7,53,
2078,0,60,8,52,
2079,0,60,6,54,
2080,0,59,6,53,
2081,0,61,7,54,
2082,0,60,6,54,
2083,0,61,7,54,
2084,0,61,6,55,
2085,0,60,6,54,
2086,0,63,7,56,
2087,0,63,7,56,
2088,0,63,7,56,
2089,0,62,6,56,
2090,0,64,7,57,
2091,0,63,6,57,
2092,0,63,7,56,
2093,0,63,6,57,
2094,0,64,7,57,
2095,0,64,7,57,
2096,0,65,7,58,
2097,0,65,6,59,
2098,0,64,6,58,
2099,0,66,7,59,
2100,0,65,6,59,
2101,0,66,7,59,
2102,0,66,6,60,
2103,0,65,6,59,
2104,0,67,7,60,
2105,0,67,6,61,
2106,0,67,7,60,
2107,0,67,6,61,
2108,0,69,7,62,
2109,0,69,7,62,
2110,0,68,6,62,
2111,0,67,6,61,
2112,0,70,7,63,
2113,0,69,6,63,
2114,0,69,7,62,
2115,0,70,6,64,
2116,0,69,6,63,
2117,0,71,7,64,
2118,0,69,6,63,
2119,0,70,7,63,
2120,0,71,6,65,
2121,0,70,6,64,
2122,0,73,7,66,
2123,0,71,6,65,
2124,0,73,7,66,
2125,0,71,6,65,
2126,0,73,7,66,
2127,0,73,7,66,
2128,0,73,6,67,
2129,0,72,6,66,
2130,0,74,7,67,
2131,0,73,6,67,
2132,0,74,7,67,
2133,0,74,7,67,
2134,0,76,8,68,
2135,0,74,7,67,
2136,0,74,6,68,
2137,0,74,6,68,
2138,0,76,7,69,
2139,0,75,7,68,
2140,0,74,6,68,
2141,0,77,7,70,
2142,0,75,6,69,
2143,0,76,7,69,
2144,0,76,6,70,
2145,0,75,6,69,
2146,0,78,7,71,
2147,0,77,6,71,
2148,0,76,6,70,
2149,0,77,7,70,
2150,0,78,7,71,
2151,0,79,7,72,
2152,0,78,7,71,
2153,0,78,6,72,
2154,0,79,7,72,
2155,0,79,7,72,
2156,0,81,7,74,
2157,0,79,6,73,
2158,0,80,7,73,
2159,0,79,6,73,
2160,0,79,6,73,
2161,0,80,7,73,
2162,0,80,7,73,
2163,0,80,6,74,
2164,0,81,7,74,
2165,0,82,7,75,
2166,0,81,6,75,
2167,0,80,6,74,
2168,0,82,7,75,
2169,0,80,6,74,
2170,0,83,7,76,
2171,0,82,7,75,
2172,0,82,6,76,
2173,0,81,6,75,
2174,0,83,7,76,
2175,0,82,6,76,
2176,0,81,6,75,
2177,0,83,7,76,
2178,0,81,6,75,
2179,0,82,7,75,
2180,0,74,6,68,
2181,0,62,6,56,
2182,0,54,7,47,
2183,0,52,6,46,
2184,0,48,7,41,
2185,0,36,5,31,
2186,0,30,7,23,
2187,0,24,7,17,
2188,0,26,7,19,
2189,0,33,6,27,
2190,0,40,7,33,
2191,0,40,6,34,
2192,0,40,7,33,
2193,0,42,7,35,
2194,0,42,6,36,
2195,0,41,6,35,
2196,0,44,7,37,
2197,0,42,6,36,
2198,0,46,7,39,
2199,0,44,6,38,
2200,0,46,8,38,
2201,0,46,7,39,
2202,0,45,6,39,
2203,0,48,7,41,
2204,0,47,6,41,
2205,0,46,6,40,
2206,0,48,7,41,
2207,0,48,6,42,
2208,0,48,7,41,
2209,0,49,6,43,
2210,0,48,6,42,
2211,0,51,7,44,
2212,0,52,7,45,
2213,0,50,6,44,
2214,0,50,6,44,
2215,0,52,7,45,
2216,0,51,7,44,
2217,0,52,7,45,
2218,0,53,7,46,
2219,0,52,6,46,
2220,0,54,7,47,
2221,0,53,6,47,
2222,0,53,6,47,
2223,0,55,7,48,
2224,0,55,7,48,
2225,0,57,9,48,
2226,0,55,7,48,
2227,0,56,8,48,
2228,0,57,7,50,
2229,0,56,7,49,
2230,0,56,6,50,
2231,0,59,8,51,
2232,0,57,6,51,
2233,0,57,7,50,
2234,0,58,6,52,
2235,0,57,6,51,
2236,0,59,7,52,
2237,0,59,6,53,
2238,0,59,7,52,
2239,0,59,6,53,
2240,0,59,6,53,
2241,0,62,7,55,
2242,0,60,6,54,
2243,0,60,6,54,
2244,0,61,7,54,
2245,0,63,7,56,
2246,0,61,6,55,
2247,0,62,7,55,
2248,0,61,6,55,
2249,0,63,7,56,
2250,0,63,6,57,
2251,0,62,6,56,
2252,0,64,7,57,
2253,0,62,6,56,
2254,0,64,7,57,
2255,0,64,7,57,
2256,0,64,6,58,
2257,0,64,6,58,
2258,0,66,7,59,
2259,0,68,7,61,
2260,0,65,6,59,
2261,0,65,6,59,
2262,0,68,7,61,
2263,0,66,6,60,
2264,0,66,7,59,
2265,0,68,7,61,
2266,0,66,6,60,
2267,0,68,7,61,
2268,0,67,6,61,
2269,0,67,6,61,
2270,0,69,7,62,
2271,0,68,6,62,
2272,0,68,7,61,
2273,0,68,6,62,
2274,0,70,7,63,
2275,0,69,7,62,
2276,0,70,8,62,
2277,0,70,6,64,
2278,0,71,7,64,
2279,0,70,6,64,
2280,0,70,7,63,
2281,0,71,6,65,
2282,0,70,6,64,
2283,0,72,7,65,
2284,0,70,6,64,
2285,0,74,7,67,
2286,0,71,6,65,
2287,0,73,7,66,
2288,0,72,6,66,
2289,0,72,6,66,
2290,0,74,7,67,
2291,0,74,7,67,
2292,0,73,6,67,
2293,0,74,7,67,
2294,0,74,6,68,
2295,0,73,6,67,
2296,0,75,7,68,
2297,0,74,6,68,
2298,0,74,6,68,
2299,0,76,7,69,
2300,0,75,6,69,
2301,0,75,7,68,
2302,0,76,6,70,
2303,0,75,6,69,
2304,0,77,7,70,
2305,0,76,6,70,
2306,0,77,7,70,
2307,0,78,7,71,
2308,0,79,7,72,
2309,0,77,6,71,
2310,0,77,7,70,
2311,0,78,6,72,
2312,0,78,7,71,
2313,0,78,6,72,
2314,0,77,6,71,
2315,0,81,8,73,
2316,0,79,6,73,
2317,0,79,7,72,
2318,0,80,7,73,
2319,0,78,6,72,
2320,0,80,7,73,
2321,0,80,6,74,
2322,0,81,7,74,
2323,0,79,6,73,
2324,0,81,7,74,
2325,0,80,6,74,
2326,0,83,7,76,
2327,0,81,6,75,
2328,0,81,7,74,
2329,0,81,6,75,
2330,0,83,7,76,
2331,0,84,8,76,
2332,0,82,7,75,
2333,0,82,6,76,
2334,0,81,6,75,
2335,0,83,7,76,
2336,0,82,6,76,
2337,0,82,7,75,
2338,0,82,6,76,
2339,0,82,7,75,
2340,0,84,7,77,
2341,0,75,6,69,
2342,0,62,6,56,
2343,0,54,7,47,
2344,0,52,6,46,
2345,0,48,7,41,
2346,0,36,5,31,
2347,0,30,7,23,
2348,0,24,6,18,
2349,0,24,6,18,
2350,0,35,7,28,
2351,0,39,7,32,
2352,0,39,6,33,
2353,0,42,7,35,
2354,0,40,6,34,
2355,0,42,7,35,
2356,0,42,6,36,
2357,0,43,6,37,
2358,0,43,7,36,
2359,0,44,6,38,
2360,0,43,6,37,
2361,0,46,7,39,
2362,0,44,6,38,
2363,0,48,7,41,
2364,0,46,6,40,
2365,0,46,6,40,
2366,0,49,7,42,
2367,0,47,7,40,
2368,0,48,6,42,
2369,0,49,7,42,
2370,0,48,6,42,
2371,0,51,7,44,
2372,0,50,6,44,
2373,0,50,7,43,
2374,0,50,6,44,
2375,0,51,6,45,
2376,0,51,6,45,
2377,0,53,7,46,
2378,0,52,6,46,
2379,0,52,7,45,
2380,0,54,7,47,
2381,0,52,6,46,
2382,0,54,7,47,
2383,0,54,6,48,
2384,0,53,6,47,
2385,0,56,7,49,
2386,0,55,6,49,
2387,0,55,7,48,
2388,0,55,6,49,
2389,0,55,6,49,
2390,0,57,7,50,
2391,0,56,6,50,
2392,0,57,7,50,
2393,0,57,6,51,
2394,0,57,6,51,
2395,0,58,7,51,
2396,0,58,6,52,
2397,0,58,7,51,
2398,0,59,7,52,
2399,0,59,7,52,
2400,0,59,6,53,
2401,0,59,6,53,
2402,0,61,7,54,
2403,0,60,6,54,
2404,0,60,6,54,
2405,0,62,7,55,
2406,0,61,7,54,
2407,0,62,7,55,
2408,0,62,7,55,
2409,0,62,6,56,
2410,0,61,6,55,
2411,0,64,7,57,
2412,0,65,7,58,
2413,0,63,6,57,
2414,0,63,7,56,
2415,0,65,7,58,
2416,0,64,7,57,
2417,0,64,6,58,
2418,0,64,6,58,
2419,0,66,7,59,
2420,0,64,6,58,
2421,0,65,7,58,
2422,0,66,6,60,
2423,0,65,6,59,
2424,0,66,7,59,
2425,0,66,6,60,
2426,0,66,6,60,
2427,0,70,8,62,
2428,0,67,7,60,
2429,0,67,6,61,
2430,0,69,7,62,
2431,0,68,6,62,
2432,0,67,6,61,
2433,0,70,7,63,
2434,0,68,6,62,
2435,0,71,7,64,
2436,0,69,6,63,
2437,0,71,7,64,
2438,0,71,7,64,
2439,0,69,6,63,
2440,0,72,7,65,
2441,0,71,6,65,
2442,0,71,7,64,
2443,0,72,7,65,
2444,0,71,7,64,
2445,0,71,7,64,
2446,0,72,6,66,
2447,0,71,6,65,
2448,0,73,7,66,
2449,0,72,6,66,
2450,0,72,6,66,
2451,0,74,7,67,
2452,0,73,6,67,
2453,0,74,7,67,
2454,0,73,6,67,
2455,0,75,7,68,
2456,0,73,6,67,
2457,0,74,7,67,
2458,0,74,6,68,
2459,0,76,7,69,
2460,0,78,7,71,
2461,0,75,7,68,
2462,0,75,6,69,
2463,0,75,6,69,
2464,0,77,7,70,
2465,0,76,6,70,
2466,0,76,7,69,
2467,0,77,6,71,
2468,0,76,6,70,
2469,0,78,7,71,
2470,0,77,7,70,
2471,0,77,6,71,
2472,0,77,6,71,
2473,0,79,7,72,
2474,0,78,7,71,
2475,0,78,7,71,
2476,0,77,6,71,
2477,0,80,7,73,
2478,0,79,6,73,
2479,0,78,6,72,
2480,0,80,7,73,
2481,0,78,6,72,
2482,0,81,7,74,
2483,0,80,6,74,
2484,0,79,6,73,
2485,0,81,7,74,
2486,0,80,6,74,
2487,0,83,7,76,
2488,0,80,6,74,
2489,0,82,7,75,
2490,0,83,7,76,
2491,0,82,7,75,
2492,0,82,6,76,
2493,0,81,6,75,
2494,0,83,7,76,
2495,0,81,6,75,
2496,0,84,7,77,
2497,0,83,8,75,
2498,0,83,7,76,
2499,0,81,6,75,
2500,0,84,8,76,
2501,0,83,7,76,
2502,0,71,6,65,
2503,0,60,7,53,
2504,0,55,7,48,
2505,0,52,6,46,
2506,0,45,6,39,
2507,0,36,6,30,
2508,0,29,7,22,
2509,0,23,6,17,
2510,0,25,6,19,
2511,0,39,7,32,
2512,0,38,6,32,
2513,0,40,7,33,
2514,0,41,6,35,
2515,0,40,6,34,
2516,0,44,7,37,
2517,0,42,6,36,
2518,0,44,7,37,
2519,0,42,6,36,
2520,0,44,7,37,
2521,0,45,7,38,
2522,0,45,6,39,
2523,0,45,7,38,
2524,0,46,6,40,
2525,0,46,6,40,
2526,0,47,7,40,
2527,0,47,6,41,
2528,0,47,6,41,
2529,0,51,8,43,
2530,0,48,6,42,
2531,0,49,7,42,
2532,0,49,6,43,
2533,0,49,6,43,
2534,0,51,7,44,
2535,0,49,6,43,
2536,0,52,7,45,
2537,0,50,6,44,
2538,0,52,7,45,
2539,0,52,6,46,
2540,0,52,7,45,
2541,0,54,7,47,
2542,0,52,6,46,
2543,0,56,7,49,
2544,0,54,6,48,
2545,0,53,6,47,
2546,0,57,7,50,
2547,0,55,6,49,
2548,0,56,7,49,
2549,0,55,6,49,
2550,0,57,7,50,
2551,0,57,7,50,
2552,0,57,6,51,
2553,0,56,6,50,
2554,0,58,7,51,
2555,0,58,6,52,
2556,0,58,7,51,
2557,0,58,6,52,
2558,0,58,6,52,
2559,0,60,7,53,
2560,0,59,6,53,
2561,0,59,7,52,
2562,0,60,6,54,
2563,0,60,6,54,
2564,0,60,7,53,
2565,0,61,6,55,
2566,0,60,6,54,
2567,0,62,7,55,
2568,0,62,6,56,
2569,0,62,7,55,
2570,0,62,6,56,
2571,0,61,6,55,
2572,0,65,7,58,
2573,0,63,6,57,
2574,0,62,6,56,
2575,0,65,7,58,
2576,0,64,6,58,
2577,0,64,7,57,
2578,0,64,6,58,
2579,0,66,7,59,
2580,0,64,6,58,
2581,0,67,7,60,
2582,0,65,6,59,
2583,0,66,7,59,
2584,0,66,6,60,
2585,0,66,7,59,
2586,0,68,7,61,
2587,0,66,6,60,
2588,0,68,7,61,
2589,0,67,7,60,
2590,0,69,7,62,
2591,0,70,7,63,
2592,0,68,6,62,
2593,0,67,6,61,
2594,0,70,7,63,
2595,0,68,6,62,
2596,0,69,7,62,
2597,0,69,7,62,
2598,0,70,6,64,
2599,0,69,6,63,
2600,0,72,7,65,
2601,0,70,6,64,
2602,0,70,6,64,
2603,0,72,7,65,
2604,0,71,6,65,
2605,0,72,7,65,
2606,0,72,7,65,
2607,0,72,6,66,
2608,0,71,6,65,
2609,0,73,7,66,
2610,0,71,6,65,
2611,0,73,7,66,
2612,0,74,7,67,
2613,0,73,6,67,
2614,0,73,7,66,
2615,0,74,6,68,
2616,0,73,6,67,
2617,0,75,7,68,
2618,0,74,6,68,
2619,0,75,7,68,
2620,0,76,7,69,
2621,0,75,6,69,
2622,0,75,7,68,
2623,0,75,6,69,
2624,0,77,7,70,
2625,0,75,6,69,
2626,0,76,7,69,
2627,0,76,7,69,
2628,0,77,6,71,
2629,0,76,6,70,
2630,0,77,7,70,
2631,0,77,6,71,
2632,0,76,6,70,
2633,0,79,7,72,
2634,0,77,6,71,
2635,0,79,7,72,
2636,0,78,6,72,
2637,0,77,6,71,
2638,0,81,7,74,
2639,0,79,6,73,
2640,0,80,7,73,
2641,0,78,6,72,
2642,0,79,7,72,
2643,0,81,7,74,
2644,0,80,7,73,
2645,0,81,7,74,
2646,0,81,7,74,
2647,0,83,7,76,
2648,0,81,6,75,
2649,0,82,7,75,
2650,0,80,6,74,
2651,0,82,7,75,
2652,0,82,6,76,
2653,0,82,7,75,
2654,0,82,6,76,
2655,0,81,6,75,
2656,0,84,7,77,
2657,0,82,6,76,
2658,0,83,7,76,
2659,0,81,6,75,
2660,0,83,7,76,
2661,0,82,7,75,
2662,0,82,7,75,
2663,0,75,7,68,
2664,0,63,7,56,
2665,0,53,6,47,
2666,0,52,6,46,
2667,0,48,7,41,
2668,0,38,6,32,
2669,0,30,6,24,
2670,0,23,6,17,
2671,0,26,7,19,
2672,0,34,6,28,
2673,0,41,7,34,
2674,0,40,6,34,
2675,0,39,6,33,
2676,0,43,7,36,
2677,0,42,6,36,
2678,0,43,8,35,
2679,0,44,7,37,
2680,0,43,7,36,
2681,0,44,6,38,
2682,0,43,6,37,
2683,0,46,7,39,
2684,0,45,6,39,
2685,0,45,6,39,
2686,0,47,7,40,
2687,0,49,7,42,
2688,0,47,6,41,
2689,0,47,7,40,
2690,0,49,7,42,
2691,0,47,6,41,
2692,0,50,7,43,
2693,0,49,6,43,
2694,0,49,6,43,
2695,0,51,7,44,
2696,0,50,6,44,
2697,0,51,7,44,
2698,0,51,6,45,
2699,0,50,6,44,
2700,0,54,8,46,
2701,0,52,6,46,
2702,0,54,7,47,
2703,0,54,7,47,
2704,0,53,6,47,
2705,0,54,7,47,
2706,0,54,6,48,
2707,0,54,7,47,
2708,0,55,7,48,
2709,0,55,7,48,
2710,0,55,7,48,
2711,0,56,6,50,
2712,0,55,6,49,
2713,0,59,7,52,
2714,0,57,6,51,
2715,0,57,7,50,
2716,0,55,6,49,
2717,0,59,7,52,
2718,0,57,6,51,
2719,0,60,8,52,
2720,0,58,6,52,
2721,0,59,7,52,
2722,0,59,6,53,
2723,0,59,6,53,
2724,0,60,7,53,
2725,0,60,6,54,
2726,0,60,6,54,
2727,0,62,7,55,
2728,0,60,6,54,
2729,0,61,7,54,
2730,0,62,6,56,
2731,0,61,6,55,
2732,0,63,7,56,
2733,0,63,7,56,
2734,0,63,6,57,
2735,0,62,6,56,
2736,0,65,7,58,
2737,0,64,6,58,
2738,0,64,7,57,
2739,0,64,6,58,
2740,0,65,7,58,
2741,0,65,6,59,
2742,0,64,6,58,
2743,0,65,7,58,
2744,0,66,6,60,
2745,0,65,6,59,
2746,0,67,7,60,
2747,0,65,6,59,
2748,0,68,7,61,
2749,0,67,6,61,
2750,0,66,6,60,
2751,0,69,7,62,
2752,0,68,6,62,
2753,0,68,7,61,
2754,0,68,6,62,
2755,0,68,6,62,
2756,0,70,7,63,
2757,0,70,7,63,
2758,0,69,6,63,
2759,0,69,6,63,
2760,0,72,7,65,
2761,0,70,6,64,
2762,0,70,7,63,
2763,0,71,6,65,
2764,0,70,6,64,
2765,0,72,7,65,
2766,0,71,6,65,
2767,0,71,7,64,
2768,0,72,6,66,
2769,0,74,7,67,
2770,0,78,13,65,
2771,0,77,12,65,
2772,0,80,13,67,
2773,0,79,13,66,
2774,0,79,13,66,
2775,0,79,13,66,
2776,0,81,13,68,
2777,0,80,13,67,
2778,0,80,13,67,
2779,0,80,12,68,
2780,0,82,13,69,
2781,0,81,13,68,
2782,0,80,12,68,
2783,0,82,13,69,
2784,0,81,13,68,
2785,0,82,13,69,
2786,0,82,13,69,
2787,0,83,13,70,
2788,0,83,13,70,
2789,0,82,13,69,
2790,0,83,12,71,
2791,0,84,13,71,
2792,0,84,13,71,
2793,0,82,12,70,
2794,0,85,13,72,
2795,0,84,13,71,
2796,0,84,13,71,
2797,0,83,12,71,
2798,0,84,13,71,
2799,0,86,13,73,
2800,0,84,12,72,
2801,0,86,13,73,
2802,0,86,13,73,
2803,0,86,13,73,
2804,0,85,12,73,
2805,0,86,13,73,
2806,0,87,13,74,
2807,0,86,13,73,
2808,0,86,13,73,
2809,0,87,13,74,
2810,0,88,13,75,
2811,0,87,13,74,
2812,0,88,13,75,
2813,0,88,13,75,
2814,0,89,13,76,
2815,0,87,12,75,
2816,0,88,13,75,
2817,0,89,13,76,
2818,0,88,13,75,
2819,0,89,13,76,
2820,0,88,12,76,
2821,0,90,13,77,
2822,0,90,13,77,
2823,0,89,13,76,
2824,0,89,12,77,
2825,0,90,13,77,
2826,0,89,13,76,
2827,0,88,12,76,
2828,0,90,13,77,
2829,0,88,13,75,
2830,0,77,13,64,
2831,0,64,12,52,
2832,0,58,7,51,
2833,0,53,6,47,
2834,0,45,6,39,
2835,0,33,6,27,
2836,0,27,7,20,
2837,0,24,7,17,
2838,0,30,6,24,
2839,0,38,6,32,
2840,0,41,7,34,
2841,0,40,6,34,
2842,0,42,7,35,
2843,0,40,6,34,
2844,0,44,7,37,
2845,0,43,6,37,
2846,0,43,7,36,
2847,0,44,6,38,
2848,0,43,6,37,
2849,0,46,7,39,
2850,0,45,6,39,
2851,0,47,7,40,
2852,0,48,7,41,
2853,0,46,6,40,
2854,0,48,8,40,
2855,0,47,6,41,
2856,0,47,6,41,
2857,0,49,7,42,
2858,0,49,6,43,
2859,0,49,7,42,
2860,0,49,6,43,
2861,0,52,7,45,
2862,0,50,6,44,
2863,0,51,7,44,
2864,0,53,8,45,
2865,0,50,6,44,
2866,0,53,7,46,
2867,0,52,7,45,
2868,0,53,7,46,
2869,0,52,6,46,
2870,0,55,7,48,
2871,0,54,6,48,
2872,0,55,8,47,
2873,0,54,6,48,
2874,0,54,6,48,
2875,0,56,7,49,
2876,0,55,6,49,
2877,0,56,7,49,
2878,0,56,6,50,
2879,0,55,6,49,
2880,0,57,7,50,
2881,0,57,6,51,
2882,0,57,7,50,
2883,0,58,6,52,
2884,0,58,7,51,
2885,0,59,7,52,
2886,0,59,6,53,
2887,0,58,6,52,
2888,0,60,7,53,
2889,0,59,6,53,
2890,0,60,7,53,
2891,0,61,8,53,
2892,0,61,7,54,
2893,0,61,7,54,
2894,0,62,7,55,
2895,0,61,6,55,
2896,0,61,6,55,
2897,0,62,7,55,
2898,0,63,7,56,
2899,0,63,6,57,
2900,0,63,7,56,
2901,0,63,6,57,
2902,0,62,6,56,
2903,0,65,7,58,
2904,0,64,6,58,
2905,0,63,6,57,
2906,0,66,7,59,
2907,0,64,6,58,
2908,0,68,9,59,
2909,0,65,6,59,
2910,0,66,7,59,
2911,0,66,6,60,
2912,0,67,7,60,
2913,0,66,6,60,
2914,0,66,6,60,
2915,0,68,7,61,
2916,0,66,6,60,
2917,0,68,7,61,
2918,0,68,6,62,
2919,0,68,7,61,
2920,0,68,6,62,
2921,0,69,7,62,
2922,0,72,7,65,
2923,0,69,6,63,
2924,0,68,6,62,
2925,0,71,7,64,
2926,0,69,6,63,
2927,0,70,7,63,
2928,0,70,6,64,
2929,0,70,7,63,
2930,0,72,7,65,
2931,0,71,6,65,
2932,0,71,7,64,
2933,0,71,6,65,
2934,0,71,6,65,
2935,0,73,7,66,
2936,0,71,6,65,
2937,0,72,7,65,
2938,0,73,6,67,
2939,0,72,6,66,
2940,0,75,7,68,
2941,0,73,6,67,
2942,0,74,7,67,
2943,0,74,6,68,
2944,0,73,6,67,
2945,0,75,7,68,
2946,0,74,6,68,
2947,0,76,7,69,
2948,0,74,6,68,
2949,0,76,7,69,
2950,0,75,6,69,
2951,0,76,7,69,
2952,0,75,6,69,
2953,0,77,7,70,
2954,0,75,6,69,
2955,0,76,7,69,
2956,0,78,7,71,
2957,0,76,6,70,
2958,0,81,10,71,
2959,0,77,6,71,
2960,0,79,7,72,
2961,0,77,6,71,
2962,0,79,7,72,
2963,0,78,6,72,
2964,0,78,7,71,
2965,0,79,6,73,
2966,0,78,6,72,
2967,0,79,7,72,
2968,0,79,6,73,
2969,0,79,7,72,
2970,0,80,6,74,
2971,0,79,6,73,
2972,0,81,7,74,
2973,0,80,6,74,
2974,0,79,6,73,
2975,0,81,7,74,
2976,0,82,7,75,
2977,0,81,6,75,
2978,0,81,7,74,
2979,0,81,7,74,
2980,0,82,6,76,
2981,0,81,6,75,
2982,0,84,7,77,
2983,0,82,6,76,
2984,0,81,6,75,
2985,0,83,7,76,
2986,0,81,6,75,
2987,0,82,7,75,
2988,0,82,6,76,
2989,0,82,7,75,
2990,0,76,7,69,
2991,0,64,6,58,
2992,0,52,6,46,
2993,0,54,7,47,
2994,0,48,7,41,
2995,0,39,6,33,
2996,0,30,6,24,
2997,0,24,6,18,
2998,0,22,6,16,
2999,0,36,7,29,
3000,0,39,6,33,
3001,0,40,7,33,
3002,0,41,7,34,
3003,0,40,6,34,
3004,0,43,7,36,
3005,0,43,7,36,
3006,0,43,7,36,
3007,0,43,6,37,
3008,0,43,6,37,
3009,0,45,7,38,
3010,0,46,7,39,
3011,0,45,7,38,
3012,0,47,7,40,
3013,0,45,6,39,
3014,0,48,7,41,
3015,0,47,6,41,
3016,0,47,7,40,
3017,0,48,6,42,
3018,0,49,7,42,
3019,0,50,7,43,
3020,0,50,7,43,
3021,0,48,6,42,
3022,0,51,7,44,
3023,0,49,6,43,
3024,0,51,7,44,
3025,0,51,6,45,
3026,0,50,6,44,
3027,0,54,7,47,
3028,0,52,6,46,
3029,0,53,7,46,
3030,0,53,6,47,
3031,0,52,6,46,
3032,0,55,7,48,
3033,0,54,6,48,
3034,0,54,7,47,
3035,0,54,6,48,
3036,0,56,7,49,
3037,0,55,7,48,
3038,0,56,6,50,
3039,0,56,7,49,
3040,0,55,6,49,
3041,0,58,7,51,
3042,0,57,6,51,
3043,0,58,8,50,
3044,0,58,6,52,
3045,0,58,6,52,
3046,0,58,7,51,
3047,0,59,6,53,
3048,0,58,6,52,
3049,0,60,7,53,
3050,0,61,7,54,
3051,0,60,6,54,
3052,0,60,7,53,
3053,0,61,6,55,
3054,0,60,6,54,
3055,0,61,7,54,
3056,0,61,6,55,
3057,0,61,6,55,
3058,0,63,7,56,
3059,0,61,6,55,
3060,0,65,7,58,
3061,0,63,6,57,
3062,0,62,6,56,
3063,0,64,7,57,
3064,0,64,7,57,
3065,0,64,6,58,
3066,0,64,7,57,
3067,0,66,7,59,
3068,0,64,6,58,
3069,0,67,7,60,
3070,0,65,7,58,
3071,0,66,6,60,
3072,0,65,6,59,
3073,0,69,7,62,
3074,0,67,7,60,
3075,0,66,6,60,
3076,0,67,7,60,
3077,0,67,6,61,
3078,0,67,7,60,
3079,0,69,7,62,
3080,0,68,6,62,
3081,0,69,7,62,
3082,0,69,6,63,
3083,0,69,7,62,
3084,0,69,6,63,
3085,0,68,6,62,
3086,0,71,7,64,
3087,0,69,6,63,
3088,0,72,7,65,
3089,0,70,6,64,
3090,0,70,6,64,
3091,0,72,7,65,
3092,0,71,6,65,
3093,0,71,7,64,
3094,0,71,6,65,
3095,0,71,6,65,
3096,0,73,7,66,
3097,0,72,6,66,
3098,0,71,6,65,
3099,0,74,7,67,
3100,0,72,6,66,
3101,0,73,7,66,
3102,0,73,6,67,
3103,0,75,7,68,
3104,0,73,6,67,
3105,0,75,7,68,
3106,0,74,6,68,
3107,0,73,6,67,
3108,0,76,7,69,
3109,0,77,7,70,
3110,0,75,6,69,
3111,0,75,7,68,
3112,0,76,6,70,
3113,0,77,7,70,
3114,0,75,6,69,
3115,0,76,7,69,
3116,0,77,7,70,
3117,0,76,6,70,
3118,0,77,7,70,
3119,0,77,6,71,
3120,0,76,6,70,
3121,0,79,7,72,
3122,0,77,6,71,
3123,0,78,7,71,
3124,0,78,6,72,
3125,0,77,6,71,
3126,0,81,7,74,
3127,0,79,6,73,
3128,0,78,6,72,
3129,0,80,7,73,
3130,0,78,6,72,
3131,0,80,7,73,
3132,0,80,7,73,
3133,0,80,6,74,
3134,0,82,8,74,
3135,0,79,6,73,
3136,0,82,7,75,
3137,0,81,6,75,
3138,0,81,7,74,
3139,0,81,6,75,
3140,0,80,6,74,
3141,0,84,8,76,
3142,0,82,6,76,
3143,0,81,6,75,
3144,0,82,7,75,
3145,0,84,7,77,
3146,0,82,6,76,
3147,0,82,7,75,
3148,0,83,7,76,
3149,0,83,7,76,
3150,0,81,6,75,
3151,0,76,7,69,
3152,0,63,6,57,
3153,0,53,6,47,
3154,0,53,7,46,
3155,0,47,6,41,
3156,0,38,6,32,
3157,0,22,2,20,
3162,0,13,5,8,
3164,0,17,5,12,
3165,0,27,6,21,
3166,0,40,7,33,
3167,0,39,6,33,
3168,0,40,7,33,
3169,0,41,6,35,
3170,0,41,6,35,
3171,0,42,7,35,
3172,0,43,6,37,
3173,0,42,6,36,
3174,0,45,7,38,
3175,0,43,6,37,
3176,0,46,7,39,
3177,0,45,6,39,
3178,0,45,6,39,
3179,0,48,7,41,
3180,0,46,6,40,
3181,0,47,7,40,
3182,0,48,7,41,
3183,0,47,6,41,
3184,0,49,7,42,
3185,0,49,6,43,
3186,0,49,7,42,
3187,0,48,6,42,
3188,0,52,7,45,
3189,0,50,6,44,
3190,0,50,6,44,
3191,0,52,7,45,
3192,0,50,6,44,
3193,0,52,7,45,
3194,0,52,6,46,
3195,0,53,7,46,
3196,0,54,7,47,
3197,0,56,8,48,
3198,0,54,6,48,
3199,0,53,6,47,
3200,0,54,7,47,
3201,0,55,7,48,
3202,0,55,6,49,
3203,0,54,6,48,
3204,0,58,8,50,
3205,0,55,6,49,
3206,0,58,7,51,
3207,0,57,6,51,
3208,0,58,7,51,
3209,0,56,6,50,
3210,0,58,7,51,
3211,0,60,8,52,
3212,0,57,6,51,
3213,0,60,7,53,
3214,0,58,6,52,
3215,0,61,8,53,
3216,0,60,6,54,
3217,0,59,6,53,
3218,0,62,7,55,
3219,0,61,6,55,
3220,0,61,7,54,
3221,0,62,7,55,
3222,0,60,6,54,
3223,0,63,7,56,
3224,0,62,7,55,
3225,0,61,6,55,
3226,0,64,7,57,
3227,0,63,6,57,
3228,0,64,7,57,
3229,0,63,7,56,
3230,0,64,7,57,
3231,0,65,7,58,
3232,0,63,6,57,
3233,0,66,7,59,
3234,0,65,6,59,
3235,0,64,6,58,
3236,0,65,7,58,
3237,0,66,6,60,
3238,0,66,7,59,
3239,0,67,7,60,
3240,0,67,7,60,
3241,0,67,6,61,
3242,0,67,7,60,
3243,0,67,6,61,
3244,0,66,6,60,
3245,0,68,7,61,
3246,0,68,7,61,
3247,0,68,6,62,
3248,0,70,7,63,
3249,0,68,6,62,
3250,0,71,7,64,
3251,0,69,6,63,
3252,0,69,6,63,
3253,0,72,7,65,
3254,0,70,6,64,
3255,0,71,7,64,
3256,0,70,7,63,
3257,0,72,7,65,
3258,0,71,6,65,
3259,0,72,7,65,
3260,0,73,7,66,
3261,0,72,6,66,
3262,0,71,6,65,
3263,0,73,7,66,
3264,0,71,6,65,
3265,0,73,7,66,
3266,0,74,7,67,
3267,0,72,6,66,
3268,0,75,8,67,
3269,0,75,7,68,
3270,0,74,6,68,
3271,0,73,6,67,
3272,0,75,7,68,
3273,0,75,6,69,
3274,0,75,7,68,
3275,0,75,6,69,
3276,0,76,7,69,
3277,0,74,6,68,
3278,0,78,8,70,
3279,0,76,6,70,
3280,0,75,6,69,
3281,0,77,7,70,
3282,0,77,6,71,
3283,0,77,7,70,
3284,0,76,6,70,
3285,0,78,7,71,
3286,0,76,6,70,
3287,0,79,7,72,
3288,0,78,6,72,
3289,0,80,7,73,
3290,0,78,6,72,
3291,0,77,6,71,
3292,0,80,7,73,
3293,0,79,6,73,
3294,0,79,7,72,
3295,0,79,6,73,
3296,0,78,6,72,
3297,0,81,7,74,
3298,0,80,6,74,
3299,0,81,8,73,
3300,0,79,6,73,
3301,0,83,7,76,
3302,0,81,6,75,
3303,0,81,7,74,
3304,0,82,7,75,
3305,0,80,6,74,
3306,0,82,7,75,
3307,0,82,7,75,
3308,0,82,6,76,
3309,0,82,6,76,
3310,0,82,7,75,
3311,0,82,6,76,
3312,0,81,6,75,
3313,0,83,7,76,
3314,0,81,6,75,
3315,0,83,7,76,
3316,0,82,7,75,
3317,0,72,6,66,
3318,0,63,8,55,
3319,0,56,7,49,
3320,0,51,6,45,
3321,0,46,7,39,
3322,0,36,6,30,
3323,0,28,7,21,
3324,0,23,6,17,
3325,0,27,7,20,
3326,0,40,7,33,
3327,0,39,6,33,
3328,0,40,7,33,
3329,0,41,6,35,
3330,0,41,7,34,
3331,0,43,7,36,
3332,0,42,6,36,
3333,0,43,7,36,
3334,0,43,6,37,
3335,0,43,6,37,
3336,0,46,7,39,
3337,0,45,6,39,
3338,0,44,6,38,
3339,0,48,8,40,
3340,0,46,6,40,
3341,0,50,7,43,
3342,0,46,6,40,
3343,0,48,7,41,
3344,0,48,6,42,
3345,0,49,7,42,
3346,0,49,6,43,
3347,0,50,7,43,
3348,0,51,7,44,
3349,0,49,6,43,
3350,0,51,7,44,
3351,0,51,6,45,
3352,0,51,7,44,
3353,0,52,6,46,
3354,0,51,6,45,
3355,0,54,7,47,
3356,0,53,6,47,
3357,0,52,6,46,
3358,0,54,7,47,
3359,0,53,6,47,
3360,0,54,7,47,
3361,0,55,7,48,
3362,0,55,6,49,
3363,0,55,7,48,
3364,0,56,6,50,
3365,0,56,6,50,
3366,0,56,7,49,
3367,0,58,7,51,
3368,0,58,7,51,
3369,0,57,7,50,
3370,0,59,7,52,
3371,0,58,6,52,
3372,0,58,7,51,
3373,0,59,6,53,
3374,0,59,6,53,
3375,0,59,7,52,
3376,0,60,7,53,
3377,0,59,6,53,
3378,0,61,7,54,
3379,0,64,9,55,
3380,0,60,6,54,
3381,0,63,7,56,
3382,0,62,7,55,
3383,0,62,6,56,
3384,0,62,6,56,
3385,0,62,7,55,
3386,0,62,6,56,
3387,0,62,6,56,
3388,0,64,7,57,
3389,0,62,6,56,
3390,0,65,7,58,
3391,0,64,7,57,
3392,0,64,6,58,
3393,0,64,6,58,
3394,0,65,7,58,
3395,0,65,6,59,
3396,0,64,6,58,
3397,0,68,8,60,
3398,0,66,6,60,
3399,0,67,8,59,
3400,0,66,6,60,
3401,0,66,6,60,
3402,0,69,7,62,
3403,0,67,6,61,
3404,0,66,6,60,
3405,0,69,7,62,
3406,0,70,7,63,
3407,0,68,6,62,
3408,0,68,7,61,
3409,0,70,7,63,
3410,0,68,6,62,
3411,0,71,7,64,
3412,0,69,6,63,
3413,0,69,6,63,
3414,0,71,7,64,
3415,0,70,6,64,
3416,0,70,7,63,
3417,0,71,6,65,
3418,0,70,6,64,
3419,0,72,7,65,
3420,0,71,6,65,
3421,0,71,6,65,
3422,0,73,7,66,
3423,0,73,7,66,
3424,0,72,6,66,
3425,0,73,7,66,
3426,0,73,6,67,
3427,0,72,6,66,
3428,0,73,7,66,
3429,0,73,7,66,
3430,0,73,6,67,
3431,0,75,7,68,
3432,0,74,6,68,
3433,0,74,7,67,
3434,0,76,7,69,
3435,0,74,6,68,
3436,0,76,7,69,
3437,0,75,7,68,
3438,0,75,7,68,
3439,0,76,6,70,
3440,0,76,6,70,
3441,0,76,7,69,
3442,0,76,6,70,
3443,0,76,6,70,
3444,0,78,7,71,
3445,0,77,6,71,
3446,0,77,7,70,
3447,0,77,6,71,
3448,0,77,6,71,
3449,0,80,7,73,
3450,0,78,6,72,
3451,0,77,6,71,
3452,0,79,8,71,
3453,0,79,6,73,
3454,0,80,7,73,
3455,0,78,6,72,
3456,0,81,7,74,
3457,0,80,6,74,
3458,0,79,6,73,
3459,0,81,7,74,
3460,0,80,6,74,
3461,0,80,7,73,
3462,0,81,6,75,
3463,0,80,6,74,
3464,0,82,7,75,
3465,0,81,6,75,
3466,0,81,7,74,
3467,0,83,7,76,
3468,0,82,6,76,
3469,0,82,7,75,
3470,0,82,6,76,
3471,0,81,6,75,
3472,0,83,7,76,
3473,0,82,6,76,
3474,0,82,7,75,
3475,0,82,6,76,
3476,0,81,6,75,
3477,0,84,7,77,
3478,0,70,6,64,
3479,0,58,6,52,
3480,0,54,7,47,
3481,0,51,6,45,
3482,0,46,7,39,
3483,0,36,6,30,
3484,0,30,7,23,
3485,0,24,7,17,
3486,0,28,7,21,
3487,0,37,6,31,
3488,0,41,7,34,
3489,0,39,6,33,
3490,0,43,8,35,
3491,0,40,6,34,
3492,0,42,7,35,
3493,0,42,6,36,
3494,0,43,7,36,
3495,0,44,7,37,
3496,0,44,6,38,
3497,0,46,7,39,
3498,0,47,9,38,
3499,0,45,6,39,
3500,0,45,6,39,
3501,0,47,7,40,
3502,0,46,6,40,
3503,0,48,7,41,
3504,0,48,7,41,
3505,0,47,6,41,
3506,0,51,7,44,
3507,0,49,6,43,
3508,0,49,7,42,
3509,0,51,7,44,
3510,0,49,6,43,
3511,0,52,7,45,
3512,0,51,6,45,
3513,0,52,7,45,
3514,0,54,8,46,
3515,0,53,7,46,
3516,0,52,7,45,
3517,0,54,7,47,
3518,0,52,6,46,
3519,0,55,7,48,
3520,0,54,6,48,
3521,0,54,7,47,
3522,0,55,6,49,
3523,0,54,6,48,
3524,0,57,7,50,
3525,0,56,6,50,
3526,0,55,6,49,
3527,0,56,7,49,
3528,0,59,7,52,
3529,0,57,6,51,
3530,0,57,7,50,
3531,0,58,6,52,
3532,0,57,6,51,
3533,0,60,7,53,
3534,0,59,6,53,
3535,0,58,6,52,
3536,0,60,7,53,
3537,0,60,6,54,
3538,0,60,7,53,
3539,0,60,6,54,
3540,0,59,6,53,
3541,0,62,7,55,
3542,0,61,6,55,
3543,0,60,6,54,
3544,0,63,7,56,
3545,0,62,6,56,
3546,0,62,7,55,
3547,0,62,6,56,
3548,0,62,6,56,
3549,0,64,7,57,
3550,0,62,6,56,
3551,0,66,7,59,
3552,0,63,6,57,
3553,0,65,7,58,
3554,0,64,6,58,
3555,0,65,7,58,
3556,0,65,6,59,
3557,0,64,6,58,
3558,0,66,7,59,
3559,0,67,7,60,
3560,0,66,6,60,
3561,0,65,6,59,
3562,0,69,7,62,
3563,0,67,6,61,
3564,0,68,7,61,
3565,0,66,6,60,
3566,0,69,7,62,
3567,0,68,6,62,
3568,0,68,7,61,
3569,0,68,6,62,
3570,0,68,6,62,
3571,0,71,7,64,
3572,0,69,6,63,
3573,0,68,6,62,
3574,0,71,7,64,
3575,0,69,6,63,
3576,0,71,7,64,
3577,0,70,7,63,
3578,0,71,6,65,
3579,0,70,6,64,
3580,0,73,7,66,
3581,0,70,6,64,
3582,0,73,7,66,
3583,0,71,6,65,
3584,0,73,7,66,
3585,0,72,6,66,
3586,0,73,7,66,
3587,0,73,6,67,
3588,0,75,8,67,
3589,0,73,6,67,
3590,0,75,7,68,
3591,0,74,6,68,
3592,0,74,7,67,
3593,0,75,7,68,
3594,0,75,7,68,
3595,0,74,6,68,
3596,0,76,8,68,
3597,0,75,6,69,
3598,0,74,6,68,
3599,0,78,7,71,
3600,0,76,6,70,
3601,0,75,6,69,
3602,0,77,7,70,
3603,0,75,6,69,
3604,0,77,7,70,
3605,0,77,6,71,
3606,0,77,7,70,
3607,0,77,6,71,
3608,0,77,6,71,
3609,0,81,9,72,
3610,0,77,6,71,
3611,0,79,7,72,
3612,0,77,6,71,
3613,0,78,7,71,
3614,0,79,6,73,
3615,0,80,7,73,
3616,0,78,6,72,
3617,0,81,7,74,
3618,0,80,7,73,
3619,0,80,7,73,
3620,0,81,7,74,
3621,0,80,6,74,
3622,0,80,7,73,
3623,0,81,6,75,
3624,0,82,7,75,
3625,0,80,6,74,
3626,0,83,7,76,
3627,0,81,6,75,
3628,0,81,6,75,
3629,0,84,7,77,
3630,0,82,6,76,
3631,0,82,7,75,
3632,0,82,6,76,
3633,0,81,6,75,
3634,0,83,7,76,
3635,0,82,6,76,
3636,0,68,2,66,
3637,0,45,,45,
3638,0,21,,21,
