window-id,queue-size-CL,queue-size-LL,10.0.0.13:40042 -> 10.0.1.13:3000,10.0.1.13:3000 -> 10.0.0.13:40042,10.0.0.13:41448 -> 10.0.1.13:1000
0,0,27,8,19,
1,0,42,7,35,
2,0,36,7,29,
3,0,31,7,24,
4,0,26,6,20,
5,0,27,7,20,
6,0,23,7,16,
7,0,23,6,17,
8,0,23,7,16,
9,0,30,12,18,
10,0,29,12,17,
11,0,28,12,16,
12,0,29,13,16,
13,0,29,13,16,
14,0,29,13,16,
15,0,31,13,18,
16,0,29,12,17,
17,0,30,12,18,
18,0,28,11,17,
19,0,29,13,16,
20,0,29,13,16,
21,0,29,12,17,
22,0,30,13,17,
23,0,29,13,16,
24,0,29,13,16,
25,0,29,12,17,
26,0,31,13,18,
27,0,30,13,17,
28,0,29,12,17,
29,0,29,12,17,
30,0,30,13,17,
31,0,30,12,18,
32,0,29,11,18,
33,0,30,12,18,
34,0,31,14,17,
35,0,27,12,15,
36,0,29,13,16,
37,0,27,12,15,
38,0,29,13,16,
39,0,30,13,17,
40,0,30,13,17,
41,0,29,13,16,
42,0,32,13,19,
43,0,29,11,18,
44,0,30,13,17,
45,0,28,11,17,
46,0,27,11,16,
47,0,29,13,16,
48,0,28,11,17,
49,0,31,13,18,
50,0,31,12,19,
51,0,31,13,18,
52,0,28,11,17,
53,0,30,13,17,
54,0,31,12,19,
55,0,31,13,18,
56,0,30,12,18,
57,0,30,13,17,
58,0,29,11,18,
59,0,30,13,17,
60,0,28,11,17,
61,0,28,12,16,
62,0,29,13,16,
63,0,30,13,17,
64,0,29,12,17,
65,0,30,13,17,
66,0,30,13,17,
67,0,31,13,18,
68,0,31,13,18,
69,0,28,11,17,
70,0,31,13,18,
71,0,30,12,18,
72,0,30,13,17,
73,0,30,12,18,
74,0,29,12,17,
75,0,30,12,18,
76,0,29,12,17,
77,0,30,13,17,
78,0,29,12,17,
79,0,29,12,17,
80,0,31,13,18,
81,0,28,12,16,
82,0,29,13,16,
83,0,27,12,15,
84,0,30,11,19,
85,0,31,13,18,
86,0,29,12,17,
87,0,27,11,16,
88,0,29,13,16,
89,0,28,12,16,
90,0,30,13,17,
91,0,29,12,17,
92,0,30,13,17,
93,0,33,14,19,
94,0,30,12,18,
95,0,31,13,18,
96,0,28,12,16,
97,0,28,12,16,
98,0,28,12,16,
99,0,27,10,17,
100,0,23,7,16,
101,0,24,6,18,
102,0,23,6,17,
103,0,25,7,18,
104,0,23,6,17,
105,0,24,7,17,
106,0,23,6,17,
107,0,22,7,15,
108,0,22,6,16,
109,0,21,6,15,
110,0,25,7,18,
111,0,23,6,17,
112,0,22,6,16,
113,0,24,7,17,
114,0,22,6,16,
115,0,24,7,17,
116,0,22,6,16,
117,0,26,7,19,
118,0,24,6,18,
119,0,23,6,17,
120,0,25,7,18,
121,0,24,7,17,
122,0,23,6,17,
123,0,22,6,16,
124,0,25,7,18,
125,0,21,6,15,
126,0,22,7,15,
127,0,24,6,18,
128,0,23,6,17,
129,0,25,8,17,
130,0,24,8,16,
131,0,29,8,21,
132,0,31,10,21,
133,0,22,6,16,
134,0,24,7,17,
135,0,23,6,17,
136,0,24,6,18,
137,0,23,6,17,
138,0,24,7,17,
139,0,23,7,16,
140,0,23,7,16,
141,0,21,6,15,
142,0,24,7,17,
143,0,23,6,17,
144,0,23,7,16,
145,0,23,6,17,
146,0,22,6,16,
147,0,25,7,18,
148,0,23,6,17,
149,0,22,6,16,
150,0,25,7,18,
151,0,23,6,17,
152,0,25,8,17,
153,0,24,6,18,
154,0,25,7,18,
155,0,22,6,16,
156,0,25,7,18,
157,0,23,6,17,
158,0,23,7,16,
159,0,23,7,16,
160,0,23,7,16,
161,0,23,7,16,
162,0,24,6,18,
163,0,24,7,17,
164,0,23,7,16,
165,0,22,6,16,
166,0,22,7,15,
167,0,22,6,16,
168,0,21,6,15,
169,0,27,8,19,
170,0,24,6,18,
171,0,24,7,17,
172,0,25,6,19,
173,0,24,7,17,
174,0,24,6,18,
175,0,24,7,17,
176,0,25,7,18,
177,0,24,7,17,
178,0,22,6,16,
179,0,21,6,15,
180,0,25,7,18,
181,0,9,1,8,
182,0,8,2,6,
183,0,24,7,17,
184,0,24,7,17,
185,0,22,6,16,
186,0,25,7,18,
187,0,24,6,18,
188,0,24,7,17,
189,0,23,6,17,
190,0,23,7,16,
191,0,22,6,16,
192,0,22,6,16,
193,0,22,6,16,
194,0,24,7,17,
195,0,25,6,19,
196,0,24,7,17,
197,0,24,6,18,
198,0,22,6,16,
199,0,23,7,16,
200,0,24,7,17,
201,0,24,7,17,
202,0,22,6,16,
203,0,23,6,17,
204,0,25,7,18,
205,0,24,6,18,
206,0,23,6,17,
207,0,23,6,17,
208,0,25,7,18,
209,0,23,6,17,
210,0,22,6,16,
211,0,23,7,16,
212,0,23,7,16,
213,0,22,6,16,
214,0,23,7,16,
215,0,23,7,16,
216,0,21,6,15,
217,0,24,7,17,
218,0,23,6,17,
219,0,22,6,16,
220,0,24,8,16,
221,0,24,7,17,
222,0,23,6,17,
223,0,23,7,16,
224,0,23,6,17,
225,0,22,6,16,
226,0,24,6,18,
227,0,24,7,17,
228,0,23,6,17,
229,0,23,7,16,
230,0,21,6,15,
231,0,22,7,15,
232,0,22,6,16,
233,0,22,7,15,
234,0,24,7,17,
235,0,22,6,16,
236,0,25,7,18,
237,0,24,7,17,
238,0,24,6,18,
239,0,22,6,16,
240,0,23,7,16,
241,0,24,6,18,
242,0,25,7,18,
243,0,22,6,16,
244,0,24,7,17,
245,0,24,6,18,
246,0,23,6,17,
247,0,23,7,16,
248,0,23,6,17,
249,0,24,7,17,
250,0,23,7,16,
251,0,23,6,17,
252,0,22,6,16,
253,0,23,7,16,
254,0,23,6,17,
255,0,23,6,17,
256,0,23,7,16,
257,0,24,6,18,
258,0,23,7,16,
259,0,21,6,15,
260,0,22,7,15,
261,0,22,6,16,
262,0,22,7,15,
263,0,23,6,17,
264,0,23,6,17,
265,0,23,7,16,
266,0,23,6,17,
267,0,22,6,16,
268,0,24,7,17,
269,0,22,6,16,
270,0,23,7,16,
271,0,23,6,17,
272,0,22,6,16,
273,0,22,6,16,
274,0,24,7,17,
275,0,22,6,16,
276,0,24,7,17,
277,0,23,7,16,
278,0,23,6,17,
279,0,22,6,16,
280,0,24,7,17,
281,0,23,6,17,
282,0,25,7,18,
283,0,22,6,16,
284,0,25,7,18,
285,0,23,7,16,
286,0,22,6,16,
287,0,23,8,15,
288,0,23,7,16,
289,0,23,6,17,
290,0,22,6,16,
291,0,27,7,20,
292,0,24,6,18,
293,0,23,6,17,
294,0,24,7,17,
295,0,23,6,17,
296,0,22,7,15,
297,0,23,6,17,
298,0,24,7,17,
299,0,23,7,16,
300,0,24,7,17,
301,0,23,6,17,
302,0,24,7,17,
303,0,23,7,16,
304,0,23,7,16,
305,0,24,6,18,
306,0,24,7,17,
307,0,23,7,16,
308,0,23,7,16,
309,0,23,6,17,
310,0,22,6,16,
311,0,25,7,18,
312,0,24,6,18,
313,0,24,7,17,
314,0,22,6,16,
315,0,21,6,15,
316,0,24,8,16,
317,0,21,6,15,
318,0,24,7,17,
319,0,23,6,17,
320,0,22,6,16,
321,0,25,7,18,
322,0,23,6,17,
323,0,23,7,16,
324,0,24,7,17,
325,0,22,6,16,
326,0,25,7,18,
327,0,22,6,16,
328,0,24,7,17,
329,0,24,6,18,
330,0,24,6,18,
331,0,23,7,16,
332,0,24,6,18,
333,0,23,6,17,
334,0,24,7,17,
335,0,23,6,17,
336,0,22,7,15,
337,0,21,6,15,
338,0,24,7,17,
339,0,23,6,17,
340,0,22,6,16,
341,0,24,7,17,
342,0,24,7,17,
343,0,23,6,17,
344,0,25,7,18,
345,0,23,7,16,
346,0,23,7,16,
347,0,24,7,17,
348,0,24,6,18,
349,0,23,6,17,
350,0,23,7,16,
351,0,23,6,17,
352,0,23,7,16,
353,0,21,6,15,
354,0,23,7,16,
355,0,22,6,16,
356,0,23,6,17,
357,0,22,6,16,
358,0,25,7,18,
359,0,23,6,17,
360,0,22,6,16,
361,0,24,7,17,
362,0,26,6,20,
363,0,24,6,18,
364,0,25,7,18,
365,0,23,6,17,
366,0,23,7,16,
367,0,24,7,17,
368,0,25,7,18,
369,0,22,6,16,
370,0,22,6,16,
371,0,21,6,15,
372,0,23,7,16,
373,0,23,6,17,
374,0,25,7,18,
375,0,24,6,18,
376,0,23,6,17,
377,0,24,7,17,
378,0,22,6,16,
379,0,22,7,15,
380,0,23,7,16,
381,0,21,6,15,
382,0,24,7,17,
383,0,22,7,15,
384,0,23,6,17,
385,0,22,6,16,
386,0,23,6,17,
387,0,24,7,17,
388,0,23,6,17,
389,0,24,7,17,
390,0,22,6,16,
391,0,21,6,15,
392,0,24,7,17,
393,0,26,6,20,
394,0,24,6,18,
395,0,26,7,19,
396,0,24,6,18,
397,0,23,6,17,
398,0,23,7,16,
399,0,22,6,16,
400,0,22,7,15,
401,0,22,6,16,
402,0,21,6,15,
403,0,24,7,17,
404,0,23,6,17,
405,0,22,6,16,
406,0,24,7,17,
407,0,23,6,17,
408,0,25,8,17,
409,0,23,6,17,
410,0,23,7,16,
411,0,25,7,18,
412,0,24,6,18,
413,0,25,7,18,
414,0,24,7,17,
415,0,26,7,19,
416,0,23,6,17,
417,0,22,6,16,
418,0,24,7,17,
419,0,22,6,16,
420,0,24,7,17,
421,0,24,6,18,
422,0,22,6,16,
423,0,23,7,16,
424,0,27,8,19,
425,0,22,6,16,
426,0,24,7,17,
427,0,23,6,17,
428,0,24,6,18,
429,0,22,6,16,
430,0,24,7,17,
431,0,22,6,16,
432,0,23,7,16,
433,0,23,7,16,
434,0,24,6,18,
435,0,24,6,18,
436,0,24,7,17,
437,0,22,6,16,
438,0,23,7,16,
439,0,21,6,15,
440,0,22,7,15,
441,0,23,6,17,
442,0,22,6,16,
443,0,24,7,17,
444,0,25,7,18,
445,0,23,6,17,
446,0,22,6,16,
447,0,25,7,18,
448,0,24,6,18,
449,0,25,7,18,
450,0,22,6,16,
451,0,25,7,18,
452,0,24,6,18,
453,0,24,7,17,
454,0,24,6,18,
455,0,24,7,17,
456,0,24,6,18,
457,0,22,6,16,
458,0,24,7,17,
459,0,24,7,17,
460,0,23,6,17,
461,0,23,6,17,
462,0,23,7,16,
463,0,22,6,16,
464,0,21,6,15,
465,0,23,7,16,
466,0,21,6,15,
467,0,25,7,18,
468,0,18,5,13,
469,0,32,13,19,
470,0,30,12,18,
471,0,31,13,18,
472,0,30,13,17,
473,0,28,12,16,
474,0,30,12,18,
475,0,29,13,16,
476,0,29,12,17,
477,0,30,14,16,
478,0,29,12,17,
479,0,31,13,18,
480,0,31,12,19,
481,0,31,13,18,
482,0,30,12,18,
483,0,30,13,17,
484,0,30,13,17,
485,0,29,12,17,
486,0,29,12,17,
487,0,30,13,17,
488,0,27,12,15,
489,0,30,13,17,
490,0,30,12,18,
491,0,31,13,18,
492,0,30,12,18,
493,0,30,13,17,
494,0,29,11,18,
495,0,30,12,18,
496,0,30,13,17,
497,0,28,12,16,
498,0,29,13,16,
499,0,27,11,16,
500,0,29,13,16,
501,0,30,12,18,
502,0,29,12,17,
503,0,30,12,18,
504,0,29,12,17,
505,0,31,13,18,
506,0,28,11,17,
507,0,30,13,17,
508,0,31,13,18,
509,0,31,14,17,
510,0,28,12,16,
511,0,29,12,17,
512,0,29,12,17,
513,0,31,13,18,
514,0,29,13,16,
515,0,29,12,17,
516,0,30,13,17,
517,0,30,13,17,
518,0,29,12,17,
519,0,29,13,16,
520,0,30,13,17,
521,0,28,13,15,
522,0,28,13,15,
523,0,28,12,16,
524,0,30,13,17,
525,0,27,11,16,
526,0,30,13,17,
527,0,27,12,15,
528,0,29,12,17,
529,0,28,12,16,
530,0,30,13,17,
531,0,29,13,16,
532,0,30,14,16,
533,0,28,11,17,
534,0,30,13,17,
535,0,29,12,17,
536,0,28,12,16,
537,0,30,13,17,
538,0,29,13,16,
539,0,31,13,18,
540,0,30,13,17,
541,0,30,13,17,
542,0,30,13,17,
543,0,29,13,16,
544,0,31,12,19,
545,0,29,12,17,
546,0,29,11,18,
547,0,28,12,16,
548,0,27,10,17,
549,0,24,7,17,
550,0,24,7,17,
551,0,23,7,16,
552,0,23,6,17,
553,0,21,6,15,
554,0,25,7,18,
555,0,24,6,18,
556,0,24,6,18,
557,0,23,7,16,
558,0,23,6,17,
559,0,23,7,16,
560,0,26,7,19,
561,0,24,6,18,
562,0,25,7,18,
563,0,25,8,17,
564,0,23,6,17,
565,0,25,7,18,
566,0,23,6,17,
567,0,24,7,17,
568,0,22,6,16,
569,0,22,6,16,
570,0,24,7,17,
571,0,23,6,17,
572,0,23,7,16,
573,0,25,7,18,
574,0,23,6,17,
575,0,25,7,18,
576,0,25,7,18,
577,0,23,6,17,
578,0,23,7,16,
579,0,23,6,17,
580,0,23,6,17,
581,0,24,7,17,
582,0,23,7,16,
583,0,21,6,15,
584,0,24,8,16,
585,0,21,6,15,
586,0,24,7,17,
587,0,25,8,17,
588,0,24,6,18,
589,0,23,6,17,
590,0,24,7,17,
591,0,23,6,17,
592,0,23,7,16,
593,0,23,6,17,
594,0,22,6,16,
595,0,25,6,19,
596,0,24,7,17,
597,0,24,6,18,
598,0,24,7,17,
599,0,22,6,16,
600,0,23,7,16,
601,0,22,6,16,
602,0,23,6,17,
603,0,22,6,16,
604,0,26,7,19,
605,0,13,3,10,
606,0,15,5,10,
607,0,25,7,18,
608,0,22,6,16,
609,0,26,7,19,
610,0,25,9,16,
611,0,24,7,17,
612,0,23,6,17,
613,0,23,7,16,
614,0,23,7,16,
615,0,24,7,17,
616,0,22,6,16,
617,0,24,7,17,
618,0,23,6,17,
619,0,22,6,16,
620,0,25,7,18,
621,0,24,6,18,
622,0,24,7,17,
623,0,22,6,16,
624,0,21,6,15,
625,0,23,7,16,
626,0,24,7,17,
627,0,23,7,16,
628,0,22,6,16,
629,0,24,6,18,
630,0,23,7,16,
631,0,23,6,17,
632,0,22,6,16,
633,0,25,7,18,
634,0,23,6,17,
635,0,25,7,18,
636,0,24,7,17,
637,0,22,6,16,
638,0,23,6,17,
639,0,22,6,16,
640,0,24,7,17,
641,0,22,6,16,
642,0,25,7,18,
643,0,21,6,15,
644,0,24,7,17,
645,0,23,6,17,
646,0,23,7,16,
647,0,23,6,17,
648,0,23,6,17,
649,0,23,7,16,
650,0,24,7,17,
651,0,23,6,17,
652,0,23,7,16,
653,0,24,6,18,
654,0,23,6,17,
655,0,24,7,17,
656,0,24,7,17,
657,0,22,6,16,
658,0,21,6,15,
659,0,23,7,16,
660,0,22,6,16,
661,0,21,6,15,
662,0,24,7,17,
663,0,22,6,16,
664,0,24,7,17,
665,0,23,7,16,
666,0,24,6,18,
667,0,26,7,19,
668,0,24,7,17,
669,0,22,6,16,
670,0,21,6,15,
671,0,23,7,16,
672,0,22,6,16,
673,0,22,7,15,
674,0,23,6,17,
675,0,25,8,17,
676,0,25,6,19,
677,0,23,6,17,
678,0,22,6,16,
679,0,25,7,18,
680,0,23,6,17,
681,0,24,7,17,
682,0,22,6,16,
683,0,21,6,15,
684,0,23,7,16,
685,0,22,6,16,
686,0,22,7,15,
687,0,24,7,17,
688,0,22,6,16,
689,0,25,7,18,
690,0,23,6,17,
691,0,23,7,16,
692,0,23,6,17,
693,0,22,6,16,
694,0,26,7,19,
695,0,24,6,18,
696,0,24,7,17,
697,0,24,6,18,
698,0,23,7,16,
699,0,23,6,17,
700,0,25,8,17,
701,0,24,7,17,
702,0,21,6,15,
703,0,24,7,17,
704,0,21,6,15,
705,0,25,7,18,
706,0,24,6,18,
707,0,23,6,17,
708,0,23,7,16,
709,0,23,6,17,
710,0,22,6,16,
711,0,25,7,18,
712,0,24,6,18,
713,0,22,6,16,
714,0,24,7,17,
715,0,23,6,17,
716,0,23,7,16,
717,0,23,6,17,
718,0,23,6,17,
719,0,24,7,17,
720,0,23,7,16,
721,0,23,6,17,
722,0,22,6,16,
723,0,23,6,17,
724,0,25,7,18,
725,0,22,6,16,
726,0,25,8,17,
727,0,22,6,16,
728,0,23,7,16,
729,0,21,6,15,
730,0,24,7,17,
731,0,23,6,17,
732,0,22,6,16,
733,0,24,7,17,
734,0,24,7,17,
735,0,24,6,18,
736,0,22,6,16,
737,0,25,7,18,
738,0,24,6,18,
739,0,24,7,17,
740,0,24,6,18,
741,0,23,6,17,
742,0,25,7,18,
743,0,23,6,17,
744,0,22,6,16,
745,0,24,7,17,
746,0,23,6,17,
747,0,23,6,17,
748,0,25,7,18,
749,0,24,6,18,
750,0,24,7,17,
751,0,21,5,16,
752,0,24,7,17,
753,0,24,6,18,
754,0,23,6,17,
755,0,25,7,18,
756,0,22,6,16,
757,0,25,7,18,
758,0,24,8,16,
759,0,24,6,18,
760,0,23,6,17,
761,0,24,7,17,
762,0,22,6,16,
763,0,21,6,15,
764,0,22,7,15,
765,0,24,7,17,
766,0,25,7,18,
767,0,24,6,18,
768,0,25,6,19,
769,0,23,6,17,
770,0,24,7,17,
771,0,22,7,15,
772,0,21,6,15,
773,0,22,7,15,
774,0,22,6,16,
775,0,22,6,16,
776,0,23,6,17,
777,0,24,7,17,
778,0,23,6,17,
779,0,23,7,16,
780,0,22,6,16,
781,0,25,7,18,
782,0,23,6,17,
783,0,21,6,15,
784,0,25,7,18,
785,0,24,7,17,
786,0,24,6,18,
787,0,24,7,17,
788,0,22,6,16,
789,0,21,6,15,
790,0,23,7,16,
791,0,21,6,15,
792,0,25,8,17,
793,0,24,6,18,
794,0,23,6,17,
795,0,25,7,18,
796,0,23,6,17,
797,0,23,6,17,
798,0,21,6,15,
799,0,26,7,19,
800,0,24,6,18,
801,0,23,7,16,
802,0,23,6,17,
803,0,22,6,16,
804,0,24,7,17,
805,0,22,6,16,
806,0,24,7,17,
807,0,24,6,18,
808,0,23,6,17,
809,0,23,7,16,
810,0,24,6,18,
811,0,25,7,18,
812,0,23,6,17,
813,0,24,6,18,
814,0,24,7,17,
815,0,23,6,17,
816,0,23,7,16,
817,0,26,7,19,
818,0,24,6,18,
819,0,23,6,17,
820,0,23,7,16,
821,0,23,6,17,
822,0,21,6,15,
823,0,24,7,17,
824,0,24,6,18,
825,0,24,6,18,
826,0,22,6,16,
827,0,24,7,17,
828,0,24,6,18,
829,0,23,7,16,
830,0,24,7,17,
831,0,23,6,17,
832,0,24,7,17,
833,0,24,6,18,
834,0,25,7,18,
835,0,23,6,17,
836,0,25,7,18,
837,0,21,5,16,
838,0,24,7,17,
839,0,22,6,16,
840,0,23,6,17,
841,0,24,7,17,
842,0,22,6,16,
843,0,24,7,17,
844,0,23,6,17,
845,0,23,7,16,
846,0,24,6,18,
847,0,25,7,18,
848,0,25,7,18,
849,0,25,7,18,
850,0,23,6,17,
851,0,23,7,16,
852,0,22,6,16,
853,0,22,7,15,
854,0,22,6,16,
855,0,21,6,15,
856,0,24,7,17,
857,0,24,7,17,
858,0,23,6,17,
859,0,23,7,16,
860,0,24,7,17,
861,0,23,7,16,
862,0,24,6,18,
863,0,24,8,16,
864,0,21,6,15,
865,0,23,7,16,
866,0,22,6,16,
867,0,21,6,15,
868,0,25,7,18,
869,0,23,6,17,
870,0,23,7,16,
871,0,24,7,17,
872,0,24,7,17,
873,0,23,6,17,
874,0,23,7,16,
875,0,24,6,18,
876,0,24,6,18,
877,0,24,7,17,
878,0,23,7,16,
879,0,23,7,16,
880,0,25,7,18,
881,0,24,6,18,
882,0,23,7,16,
883,0,23,6,17,
884,0,24,6,18,
885,0,24,6,18,
886,0,25,7,18,
887,0,28,10,18,
888,0,22,6,16,
889,0,25,9,16,
890,0,27,11,16,
891,0,26,10,16,
892,0,23,7,16,
893,0,26,10,16,
894,0,25,8,17,
895,0,23,7,16,
896,0,24,8,16,
897,0,25,8,17,
898,0,23,8,15,
899,0,24,9,15,
900,0,26,10,16,
901,0,24,8,16,
902,0,27,11,16,
903,0,26,8,18,
904,0,27,10,17,
905,0,28,12,16,
906,0,27,10,17,
907,0,28,12,16,
908,0,24,7,17,
909,0,27,10,16,1
910,0,25,7,18,
911,0,23,6,17,
912,0,22,7,15,
913,0,25,6,19,
914,0,24,6,18,
915,0,25,8,17,
916,0,23,7,16,
917,0,25,7,17,1
918,0,24,7,17,
919,0,22,6,16,
920,0,24,7,17,
921,0,23,7,16,
922,0,23,6,17,
923,0,24,6,18,
924,0,24,7,16,1
925,0,24,7,17,
926,0,24,6,18,
927,0,22,6,16,
928,0,24,7,17,
929,0,23,6,17,
930,0,25,6,19,
931,0,23,6,17,
932,0,26,7,19,
933,0,23,7,16,
934,0,23,6,17,
935,0,22,6,16,
936,0,22,6,16,
937,0,23,7,16,
938,0,23,6,17,
939,0,22,6,16,
940,0,25,7,17,1
941,0,26,7,19,
942,0,24,6,18,
943,0,23,6,17,
944,0,22,6,16,
945,0,22,7,15,
946,0,22,6,16,
947,0,22,7,15,
948,0,22,7,15,
949,0,26,7,19,
950,0,24,6,18,
951,0,23,6,17,
952,0,25,7,18,
953,0,23,6,17,
954,0,23,7,16,
955,0,24,7,16,1
956,0,23,6,17,
957,0,22,6,16,
958,0,24,7,17,
959,0,23,6,17,
960,0,22,6,16,
961,0,24,7,17,
962,0,23,6,17,
963,0,23,7,16,
964,0,24,6,18,
965,0,25,7,18,
966,0,23,6,17,
967,0,23,7,16,
968,0,22,6,16,
969,0,23,7,16,
970,0,25,7,18,
971,0,24,6,18,
972,0,23,7,16,
973,0,23,6,17,
974,0,22,6,16,
975,0,24,7,17,
976,0,23,6,17,
977,0,23,7,16,
978,0,24,7,17,
979,0,25,6,19,
980,0,23,6,17,
981,0,23,7,16,
982,0,25,8,17,
983,0,22,6,16,
984,0,22,7,15,
985,0,24,6,17,1
986,0,24,7,17,
987,0,24,6,18,
988,0,24,6,18,
989,0,22,6,16,
990,0,23,7,16,
991,0,22,6,16,
992,0,24,7,17,
993,0,24,6,18,
994,0,24,7,17,
995,0,22,6,16,
996,0,24,6,18,
997,0,22,6,16,
998,0,25,7,18,
999,0,24,6,18,
1000,0,25,6,19,
1001,0,24,7,17,
1002,0,22,6,16,
1003,0,24,7,17,
1004,0,22,6,16,
1005,0,23,7,16,
1006,0,23,6,17,
1007,0,23,6,17,
1008,0,23,7,16,
1009,0,24,7,17,
1010,0,23,5,18,
1011,0,24,7,17,
1012,0,23,6,17,
1013,0,22,6,16,
1014,0,22,7,15,
1015,0,24,6,17,1
1016,0,23,6,17,
1017,0,23,7,16,
1018,0,23,6,17,
1019,0,22,6,16,
1020,0,24,7,17,
1021,0,23,6,17,
1022,0,23,7,16,
1023,0,24,6,18,
1024,0,25,7,18,
1025,0,23,6,17,
1026,0,23,7,16,
1027,0,23,6,17,
1028,0,22,6,16,
1029,0,22,6,16,
1030,0,25,7,18,
1031,0,24,7,17,
1032,0,23,7,16,
1033,0,23,5,18,
1034,0,24,7,17,
1035,0,22,6,16,
1036,0,21,6,15,
1037,0,23,7,16,
1038,0,21,6,15,
1039,0,22,7,15,
1040,0,23,6,17,
1041,0,22,6,16,
1042,0,24,7,17,
1043,0,23,6,17,
1044,0,24,7,17,
1045,0,23,6,17,
1046,0,25,7,17,1
1047,0,23,6,17,
1048,0,22,7,15,
1049,0,22,6,16,
1050,0,22,6,16,
1051,0,23,6,17,
1052,0,25,7,18,
1053,0,24,6,18,
1054,0,23,6,17,
1055,0,25,7,18,
1056,0,23,6,17,
1057,0,23,6,17,
1058,0,23,6,17,
1059,0,24,7,17,
1060,0,25,7,18,
1061,0,24,7,17,
1062,0,25,6,19,
1063,0,23,6,17,
1064,0,25,7,18,
1065,0,23,6,17,
1066,0,25,7,18,
1067,0,23,6,17,
1068,0,23,7,16,
1069,0,24,7,17,
1070,0,24,7,17,
1071,0,26,7,19,
1072,0,23,6,17,
1073,0,22,6,16,
1074,0,27,7,20,
1075,0,24,7,17,
1076,0,24,7,16,1
1077,0,23,6,17,
1078,0,22,6,16,
1079,0,24,7,17,
1080,0,23,6,17,
1081,0,24,6,18,
1082,0,22,6,16,
1083,0,23,7,16,
1084,0,23,6,17,
1085,0,22,6,16,
1086,0,24,7,17,
1087,0,22,6,16,
1088,0,23,7,16,
1089,0,25,7,18,
1090,0,23,6,17,
1091,0,25,7,18,
1092,0,23,7,16,
1093,0,22,6,16,
1094,0,23,6,17,
1095,0,25,7,18,
1096,0,24,6,18,
1097,0,23,7,16,
1098,0,25,6,19,
1099,0,24,6,18,
1100,0,23,6,17,
1101,0,25,8,17,
1102,0,22,6,16,
1103,0,23,8,15,
1104,0,23,7,16,
1105,0,22,6,16,
1106,0,26,7,18,1
1107,0,24,7,17,
1108,0,23,7,16,
1109,0,22,6,16,
1110,0,22,6,16,
1111,0,23,7,16,
1112,0,22,6,16,
1113,0,24,7,17,
1114,0,22,6,16,
1115,0,23,7,16,
1116,0,23,6,17,
1117,0,22,6,16,
1118,0,24,7,17,
1119,0,23,6,17,
1120,0,25,7,18,
1121,0,22,6,16,
1122,0,24,7,17,
1123,0,24,6,18,
1124,0,23,7,16,
1125,0,22,6,16,
1126,0,23,7,16,
1127,0,21,5,16,
1128,0,24,7,17,
1129,0,26,7,19,
1130,0,23,6,17,
1131,0,25,7,18,
1132,0,23,6,17,
1133,0,24,7,17,
1134,0,23,6,17,
1135,0,24,7,17,
1136,0,22,6,16,
1137,0,25,8,16,1
1138,0,25,7,18,
1139,0,21,5,16,
1140,0,23,7,16,
1141,0,21,6,15,
1142,0,22,7,15,
1143,0,23,6,17,
1144,0,24,6,18,
1145,0,25,7,18,
1146,0,23,6,17,
1147,0,25,7,18,
1148,0,23,6,17,
1149,0,24,7,17,
1150,0,24,7,17,
1151,0,24,7,17,
1152,0,23,6,17,
1153,0,22,6,16,
1154,0,22,7,15,
1155,0,23,6,17,
1156,0,24,6,18,
1157,0,23,6,17,
1158,0,22,6,16,
1159,0,24,7,17,
1160,0,23,6,17,
1161,0,24,7,17,
1162,0,23,7,16,
1163,0,25,7,18,
1164,0,23,6,17,
1165,0,22,7,15,
1166,0,22,7,15,
1167,0,23,6,16,1
1168,0,24,7,17,
1169,0,22,6,16,
1170,0,24,7,17,
1171,0,24,6,18,
1172,0,23,6,17,
1173,0,23,7,16,
1174,0,25,7,18,
1175,0,23,6,17,
1176,0,25,7,18,
1177,0,21,5,16,
1178,0,25,7,18,
1179,0,24,6,18,
1180,0,24,7,17,
1181,0,22,6,16,
1182,0,25,8,17,
1183,0,22,6,16,
1184,0,25,7,18,
1185,0,24,6,18,
1186,0,23,6,17,
1187,0,26,7,19,
1188,0,24,6,18,
1189,0,22,6,16,
1190,0,25,8,17,
1191,0,23,6,17,
1192,0,25,7,18,
1193,0,25,8,17,
1194,0,23,6,17,
1195,0,23,7,16,
1196,0,25,7,18,
1197,0,24,6,17,1
1198,0,23,7,16,
1199,0,23,6,17,
1200,0,25,7,18,
1201,0,24,6,18,
1202,0,22,6,16,
1203,0,24,7,17,
1204,0,21,6,15,
1205,0,26,7,19,
1206,0,22,5,17,
1207,0,23,7,16,
1208,0,25,7,18,
1209,0,23,6,17,
1210,0,22,6,16,
1211,0,25,7,18,
1212,0,23,6,17,
1213,0,24,7,17,
1214,0,22,7,15,
1215,0,22,6,16,
1216,0,22,6,16,
1217,0,22,7,15,
1218,0,23,6,17,
1219,0,22,6,16,
1220,0,23,7,16,
1221,0,25,7,18,
1222,0,28,11,17,
1223,0,29,12,17,
1224,0,29,12,17,
1225,0,29,13,16,
1226,0,30,12,18,
1227,0,29,12,17,
1228,0,31,13,17,1
1229,0,28,12,16,
1230,0,29,13,16,
1231,0,25,7,18,
1232,0,24,6,18,
1233,0,23,6,17,
1234,0,25,7,18,
1235,0,24,6,18,
1236,0,23,6,17,
1237,0,23,6,17,
1238,0,24,7,17,
1239,0,23,7,16,
1240,0,23,6,17,
1241,0,25,7,18,
1242,0,23,6,17,
1243,0,25,7,18,
1244,0,24,7,17,
1245,0,23,6,17,
1246,0,26,6,20,
1247,0,23,6,17,
1248,0,22,6,16,
1249,0,24,7,17,
1250,0,22,6,16,
1251,0,23,7,16,
1252,0,24,7,17,
1253,0,23,6,17,
1254,0,23,7,16,
1255,0,23,6,17,
1256,0,24,7,17,
1257,0,22,6,16,
1258,0,23,7,15,1
1259,0,22,6,16,
1260,0,21,6,15,
1261,0,24,7,17,
1262,0,23,6,17,
1263,0,23,7,16,
1264,0,23,6,17,
1265,0,23,6,17,
1266,0,23,7,16,
1267,0,22,6,16,
1268,0,23,6,17,
1269,0,24,7,17,
1270,0,23,7,16,
1271,0,23,6,17,
1272,0,24,7,17,
1273,0,25,6,19,
1274,0,24,6,18,
1275,0,22,6,16,
1276,0,24,7,17,
1277,0,22,6,16,
1278,0,23,7,16,
1279,0,23,6,17,
1280,0,22,6,16,
1281,0,24,7,17,
1282,0,22,6,16,
1283,0,23,7,16,
1284,0,25,7,18,
1285,0,23,6,17,
1286,0,24,7,17,
1287,0,22,6,16,
1288,0,22,6,16,
1289,0,22,6,15,1
1290,0,25,7,18,
1291,0,24,7,17,
1292,0,24,6,18,
1293,0,24,6,18,
1294,0,24,7,17,
1295,0,22,6,16,
1296,0,21,6,15,
1297,0,23,7,16,
1298,0,21,6,15,
1299,0,24,7,17,
1300,0,23,7,16,
1301,0,23,6,17,
1302,0,23,7,16,
1303,0,25,7,18,
1304,0,22,6,16,
1305,0,24,7,17,
1306,0,22,6,16,
1307,0,26,7,19,
1308,0,24,6,18,
1309,0,24,7,17,
1310,0,24,6,18,
1311,0,25,8,17,
1312,0,31,14,17,
1313,0,29,12,17,
1314,0,29,13,16,
1315,0,29,12,17,
1316,0,30,13,17,
1317,0,29,13,16,
1318,0,30,12,18,
1319,0,29,11,17,1
1320,0,30,13,17,
1321,0,28,11,17,
1322,0,30,13,17,
1323,0,28,12,16,
1324,0,29,13,16,
1325,0,29,12,17,
1326,0,30,13,17,
1327,0,28,12,16,
1328,0,28,12,16,
1329,0,30,13,17,
1330,0,29,13,16,
1331,0,29,13,16,
1332,0,29,12,17,
1333,0,31,12,19,
1334,0,30,12,18,
1335,0,30,13,17,
1336,0,30,11,19,
1337,0,31,13,18,
1338,0,29,11,18,
1339,0,30,13,17,
1340,0,31,12,19,
1341,0,30,13,17,
1342,0,30,12,18,
1343,0,29,12,17,
1344,0,30,12,18,
1345,0,31,13,18,
1346,0,29,12,17,
1347,0,30,12,18,
1348,0,29,12,17,
1349,0,31,13,17,1
1350,0,28,12,16,
1351,0,30,13,17,
1352,0,28,12,16,
1353,0,29,13,16,
1354,0,27,11,16,
1355,0,23,7,16,
1356,0,21,6,15,
1357,0,24,7,17,
1358,0,22,6,16,
1359,0,23,7,16,
1360,0,23,6,17,
1361,0,22,6,16,
1362,0,24,8,16,
1363,0,26,8,18,
1364,0,24,6,18,
1365,0,24,7,17,
1366,0,22,6,16,
1367,0,22,6,16,
1368,0,22,7,15,
1369,0,24,6,18,
1370,0,23,6,17,
1371,0,25,7,18,
1372,0,24,7,17,
1373,0,23,6,17,
1374,0,23,6,17,
1375,0,25,7,18,
1376,0,23,7,16,
1377,0,23,6,17,
1378,0,23,6,17,
1379,0,25,7,18,
1380,0,26,7,18,1
1381,0,23,6,17,
1382,0,24,7,17,
1383,0,22,5,17,
1384,0,25,7,18,
1385,0,23,6,17,
1386,0,22,6,16,
1387,0,24,7,17,
1388,0,22,6,16,
1389,0,25,7,18,
1390,0,24,7,17,
1391,0,23,7,16,
1392,0,21,6,15,
1393,0,25,8,17,
1394,0,22,7,15,
1395,0,21,6,15,
1396,0,24,7,17,
1397,0,23,6,17,
1398,0,23,6,17,
1399,0,24,8,16,
1400,0,30,13,17,
1401,0,31,13,18,
1402,0,30,13,17,
1403,0,29,11,18,
1404,0,24,7,17,
1405,0,23,7,16,
1406,0,22,7,15,
1407,0,24,7,17,
1408,0,22,6,16,
1409,0,22,7,15,
1410,0,25,7,17,1
1411,0,23,6,17,
1412,0,24,6,18,
1413,0,22,6,16,
1414,0,24,7,17,
1415,0,22,6,16,
1416,0,22,7,15,
1417,0,22,6,16,
1418,0,21,6,15,
1419,0,24,7,17,
1420,0,22,6,16,
1421,0,25,7,18,
1422,0,23,6,17,
1423,0,23,7,16,
1424,0,25,7,18,
1425,0,23,7,16,
1426,0,23,6,17,
1427,0,22,6,16,
1428,0,25,7,18,
1429,0,24,6,18,
1430,0,24,7,17,
1431,0,22,6,16,
1432,0,22,6,16,
1433,0,22,7,15,
1434,0,23,8,15,
1435,0,22,6,16,
1436,0,24,7,17,
1437,0,21,6,15,
1438,0,25,7,18,
1439,0,22,7,15,
1440,0,24,6,17,1
1441,0,23,6,17,
1442,0,23,7,16,
1443,0,23,6,17,
1444,0,22,6,16,
1445,0,24,7,17,
1446,0,23,6,17,
1447,0,23,7,16,
1448,0,24,6,18,
1449,0,23,6,17,
1450,0,24,7,17,
1451,0,23,7,16,
1452,0,21,6,15,
1453,0,24,8,16,
1454,0,22,7,15,
1455,0,22,7,15,
1456,0,23,6,17,
1457,0,22,6,16,
1458,0,24,7,17,
1459,0,23,6,17,
1460,0,22,6,16,
1461,0,24,7,17,
1462,0,23,6,17,
1463,0,23,7,16,
1464,0,24,6,18,
1465,0,23,6,17,
1466,0,23,7,16,
1467,0,22,6,16,
1468,0,22,7,15,
1469,0,22,6,16,
1470,0,22,6,16,
1471,0,23,7,15,1
1472,0,23,6,17,
1473,0,22,6,16,
1474,0,24,7,17,
1475,0,23,6,17,
1476,0,24,7,17,
1477,0,22,6,16,
1478,0,21,6,15,
1479,0,27,11,16,
1480,0,30,13,17,
1481,0,28,12,16,
1482,0,28,12,16,
1483,0,30,13,17,
1484,0,30,13,17,
1485,0,29,12,17,
1486,0,30,13,17,
1487,0,29,12,17,
1488,0,30,13,17,
1489,0,27,12,15,
1490,0,31,12,19,
1491,0,31,13,18,
1492,0,29,12,17,
1493,0,28,12,16,
1494,0,30,13,17,
1495,0,29,13,16,
1496,0,28,12,16,
1497,0,29,12,17,
1498,0,28,12,16,
1499,0,31,13,18,
1500,0,28,12,16,
1501,0,30,12,17,1
1502,0,30,13,17,
1503,0,30,13,17,
1504,0,28,12,16,
1505,0,26,11,15,
1506,0,29,12,17,
1507,0,27,11,16,
1508,0,32,13,19,
1509,0,29,12,17,
1510,0,29,13,16,
1511,0,30,13,17,
1512,0,33,14,19,
1513,0,30,12,18,
1514,0,28,11,17,
1515,0,31,13,18,
1516,0,29,13,16,
1517,0,28,12,16,
1518,0,28,12,16,
1519,0,30,13,17,
1520,0,29,13,16,
1521,0,29,13,16,
1522,0,30,13,17,
1523,0,29,12,17,
1524,0,29,13,16,
1525,0,28,12,16,
1526,0,30,13,17,
1527,0,31,13,18,
1528,0,30,13,17,
1529,0,29,12,17,
1530,0,31,13,18,
1531,0,31,13,17,1
1532,0,29,13,16,
1533,0,29,12,17,
1534,0,30,13,17,
1535,0,30,13,17,
1536,0,28,11,17,
1537,0,30,13,17,
1538,0,29,12,17,
1539,0,31,13,18,
1540,0,29,12,17,
1541,0,30,13,17,
1542,0,29,12,17,
1543,0,31,13,18,
1544,0,31,13,18,
1545,0,28,12,16,
1546,0,30,12,18,
1547,0,31,13,18,
1548,0,29,13,16,
1549,0,28,12,16,
1550,0,29,13,16,
1551,0,30,13,17,
1552,0,30,13,17,
1553,0,30,12,18,
1554,0,29,12,17,
1555,0,30,13,17,
1556,0,30,13,17,
1557,0,27,12,15,
1558,0,28,12,16,
1559,0,30,14,16,
1560,0,29,13,16,
1561,0,26,11,15,
1562,0,30,13,16,1
1563,0,28,12,16,
1564,0,28,13,15,
1565,0,28,12,16,
1566,0,29,13,16,
1567,0,30,13,17,
1568,0,27,11,16,
1569,0,31,13,18,
1570,0,27,11,16,
1571,0,30,13,17,
1572,0,28,12,16,
1573,0,29,12,17,
1574,0,28,11,17,
1575,0,30,13,17,
1576,0,29,12,17,
1577,0,30,13,17,
1578,0,29,12,17,
1579,0,29,13,16,
1580,0,27,12,15,
1581,0,28,13,15,
1582,0,29,13,16,
1583,0,28,13,15,
1584,0,29,13,16,
1585,0,27,11,16,
1586,0,29,13,16,
1587,0,28,12,16,
1588,0,29,13,16,
1589,0,31,13,18,
1590,0,29,12,17,
1591,0,30,13,17,
1592,0,30,12,17,1
1593,0,31,13,18,
1594,0,31,13,18,
1595,0,29,12,17,
1596,0,30,12,18,
1597,0,31,13,18,
1598,0,30,13,17,
1599,0,30,13,17,
1600,0,29,12,17,
1601,0,30,13,17,
1602,0,30,13,17,
1603,0,24,8,16,
1604,0,24,7,17,
1605,0,24,7,17,
1606,0,21,6,15,
1607,0,22,7,15,
1608,0,22,7,15,
1609,0,23,7,16,
1610,0,24,6,18,
1611,0,24,7,17,
1612,0,22,6,16,
1613,0,23,7,16,
1614,0,23,6,17,
1615,0,23,6,17,
1616,0,24,7,17,
1617,0,25,7,18,
1618,0,22,6,16,
1619,0,25,7,18,
1620,0,23,6,17,
1621,0,23,6,17,
1622,0,24,7,16,1
1623,0,26,6,20,
1624,0,26,7,19,
1625,0,24,7,17,
1626,0,24,6,18,
1627,0,22,6,16,
1628,0,24,7,17,
1629,0,23,6,17,
1630,0,23,7,16,
1631,0,23,6,17,
1632,0,22,6,16,
1633,0,25,7,18,
1634,0,23,6,17,
1635,0,22,6,16,
1636,0,24,7,17,
1637,0,25,6,19,
1638,0,24,7,17,
1639,0,24,6,18,
1640,0,22,6,16,
1641,0,24,7,17,
1642,0,23,6,17,
1643,0,22,6,16,
1644,0,25,7,18,
1645,0,22,6,16,
1646,0,22,7,15,
1647,0,22,6,16,
1648,0,21,6,15,
1649,0,24,7,17,
1650,0,25,7,18,
1651,0,23,6,17,
1652,0,24,7,17,
1653,0,26,6,19,1
1654,0,23,7,16,
1655,0,24,6,18,
1656,0,23,6,17,
1657,0,23,7,16,
1658,0,22,6,16,
1659,0,22,7,15,
1660,0,22,6,16,
1661,0,21,6,15,
1662,0,25,7,18,
1663,0,23,6,17,
1664,0,22,6,16,
1665,0,24,7,17,
1666,0,23,6,17,
1667,0,24,8,16,
1668,0,23,7,16,
1669,0,24,7,17,
1670,0,25,7,18,
1671,0,23,6,17,
1672,0,21,6,15,
1673,0,24,7,17,
1674,0,23,6,17,
1675,0,24,7,17,
1676,0,23,7,16,
1677,0,24,7,17,
1678,0,22,6,16,
1679,0,25,7,18,
1680,0,24,6,18,
1681,0,24,7,17,
1682,0,25,7,18,
1683,0,24,6,17,1
1684,0,21,6,15,
1685,0,22,7,15,
1686,0,23,6,17,
1687,0,24,6,18,
1688,0,22,6,16,
1689,0,24,7,17,
1690,0,23,6,17,
1691,0,22,6,16,
1692,0,24,7,17,
1693,0,23,6,17,
1694,0,23,7,16,
1695,0,24,6,18,
1696,0,22,6,16,
1697,0,23,7,16,
1698,0,24,6,18,
1699,0,23,7,16,
1700,0,23,6,17,
1701,0,22,6,16,
1702,0,24,6,18,
1703,0,23,7,16,
1704,0,24,6,18,
1705,0,25,7,18,
1706,0,25,7,18,
1707,0,24,6,18,
1708,0,24,7,17,
1709,0,22,6,16,
1710,0,22,6,16,
1711,0,23,7,16,
1712,0,23,7,16,
1713,0,25,7,17,1
1714,0,21,6,15,
1715,0,24,7,17,
1716,0,24,6,18,
1717,0,23,6,17,
1718,0,25,7,18,
1719,0,24,6,18,
1720,0,23,7,16,
1721,0,26,7,19,
1722,0,23,6,17,
1723,0,24,7,17,
1724,0,24,6,18,
1725,0,24,7,17,
1726,0,24,6,18,
1727,0,25,7,18,
1728,0,25,7,18,
1729,0,23,6,17,
1730,0,22,6,16,
1731,0,24,7,17,
1732,0,22,6,16,
1733,0,23,7,16,
1734,0,23,6,17,
1735,0,22,6,16,
1736,0,25,7,18,
1737,0,24,6,18,
1738,0,23,6,17,
1739,0,23,7,16,
1740,0,22,6,16,
1741,0,22,7,15,
1742,0,22,7,15,
1743,0,23,6,17,
1744,0,24,7,16,1
1745,0,23,6,17,
1746,0,23,7,16,
1747,0,23,6,17,
1748,0,23,6,17,
1749,0,23,7,16,
1750,0,24,6,18,
1751,0,23,6,17,
1752,0,23,7,16,
1753,0,22,6,16,
1754,0,22,7,15,
1755,0,22,6,16,
1756,0,23,7,16,
1757,0,25,7,18,
1758,0,23,6,17,
1759,0,24,7,17,
1760,0,24,6,18,
1761,0,23,6,17,
1762,0,23,7,16,
1763,0,24,6,18,
1764,0,23,6,17,
1765,0,23,7,16,
1766,0,23,7,16,
1767,0,22,6,16,
1768,0,22,6,16,
1769,0,24,7,17,
1770,0,23,6,17,
1771,0,23,7,16,
1772,0,23,6,17,
1773,0,22,6,16,
1774,0,25,7,17,1
1775,0,23,6,17,
1776,0,22,6,16,
1777,0,25,7,18,
1778,0,24,6,18,
1779,0,24,7,17,
1780,0,22,6,16,
1781,0,21,6,15,
1782,0,24,7,17,
1783,0,22,6,16,
1784,0,22,7,15,
1785,0,23,6,17,
1786,0,23,6,17,
1787,0,24,7,17,
1788,0,22,6,16,
1789,0,23,7,16,
1790,0,24,7,17,
1791,0,24,6,18,
1792,0,24,7,17,
1793,0,22,6,16,
1794,0,21,6,15,
1795,0,25,7,18,
1796,0,21,5,16,
1797,0,24,7,17,
1798,0,23,6,17,
1799,0,24,7,17,
1800,0,24,7,17,
1801,0,23,6,17,
1802,0,24,7,17,
1803,0,24,7,17,
1804,0,24,6,17,1
1805,0,12,2,10,
1817,0,25,7,18,
1818,0,26,7,19,
1819,0,29,10,19,
1820,0,27,7,20,
1821,0,26,7,19,
1822,0,28,7,21,
1823,0,31,6,25,
1824,0,32,7,25,
1825,0,33,6,27,
1826,0,35,7,28,
1827,0,35,7,28,
1828,0,34,6,28,
1829,0,37,7,30,
1830,0,35,6,29,
1831,0,37,7,30,
1832,0,37,6,31,
1833,0,40,8,32,
1834,0,39,6,33,
1835,0,39,7,32,
1836,0,40,6,34,
1837,0,40,7,33,
1838,0,42,7,35,
1839,0,40,6,34,
1840,0,44,7,37,
1841,0,44,7,37,
1842,0,43,6,37,
1843,0,43,7,36,
1844,0,44,6,38,
1845,0,43,6,37,
1846,0,45,7,38,
1847,0,47,7,40,
1848,0,45,6,39,
1849,0,47,7,40,
1850,0,46,6,40,
1851,0,50,10,40,
1852,0,54,13,41,
1853,0,53,13,40,
1854,0,53,12,41,
1855,0,54,13,41,
1856,0,54,13,41,
1857,0,55,13,42,
1858,0,55,13,42,
1859,0,56,13,43,
1860,0,57,13,44,
1861,0,56,13,43,
1862,0,55,12,43,
1863,0,58,13,45,
1864,0,57,13,44,
1865,0,57,13,44,
1866,0,57,12,45,
1867,0,58,13,45,
1868,0,59,13,46,
1869,0,59,13,46,
1870,0,60,13,47,
1871,0,60,13,47,
1872,0,61,13,48,
1873,0,59,12,47,
1874,0,60,13,47,
1875,0,62,13,49,
1876,0,61,13,48,
1877,0,61,13,48,
1878,0,60,12,48,
1879,0,63,13,50,
1880,0,63,13,50,
1881,0,62,13,49,
1882,0,62,12,50,
1883,0,64,13,51,
1884,0,63,13,50,
1885,0,62,12,50,
1886,0,63,12,51,
1887,0,65,13,52,
1888,0,64,13,51,
1889,0,65,13,52,
1890,0,66,13,53,
1891,0,66,13,53,
1892,0,66,13,53,
1893,0,64,11,53,
1894,0,67,13,54,
1895,0,66,13,53,
1896,0,66,13,53,
1897,0,65,11,54,
1898,0,67,13,54,
1899,0,68,13,55,
1900,0,67,13,54,
1901,0,69,13,56,
1902,0,68,12,56,
1903,0,69,13,56,
1904,0,67,12,55,
1905,0,69,13,56,
1906,0,70,13,57,
1907,0,69,13,56,
1908,0,69,13,56,
1909,0,69,12,57,
1910,0,71,13,58,
1911,0,70,13,57,
1912,0,70,13,57,
1913,0,71,12,59,
1914,0,71,12,59,
1915,0,70,12,58,
1916,0,71,13,58,
1917,0,72,13,59,
1918,0,71,12,59,
1919,0,72,13,59,
1920,0,71,12,59,
1921,0,73,13,60,
1922,0,74,13,61,
1923,0,73,13,60,
1924,0,73,12,61,
1925,0,74,13,61,
1926,0,73,13,60,
1927,0,72,11,61,
1928,0,74,13,61,
1929,0,75,13,62,
1930,0,74,13,61,
1931,0,75,13,62,
1932,0,76,13,63,
1933,0,76,13,63,
1934,0,75,13,62,
1935,0,74,12,62,
1936,0,76,12,64,
1937,0,76,13,63,
1938,0,75,12,63,
1939,0,76,13,63,
1940,0,76,12,64,
1941,0,77,13,64,
1942,0,77,13,64,
1943,0,78,13,65,
1944,0,78,13,65,
1945,0,78,13,65,
1946,0,76,11,65,
1947,0,79,13,66,
1948,0,73,8,65,
1949,0,73,7,66,
1950,0,74,7,67,
1951,0,73,6,67,
1952,0,73,7,66,
1953,0,73,6,67,
1954,0,73,6,67,
1955,0,75,7,68,
1956,0,73,6,67,
1957,0,75,7,68,
1958,0,73,6,67,
1959,0,76,7,69,
1960,0,75,6,69,
1961,0,75,7,68,
1962,0,76,7,69,
1963,0,75,6,69,
1964,0,74,6,68,
1965,0,76,7,69,
1966,0,75,6,69,
1967,0,78,7,71,
1968,0,76,6,70,
1969,0,76,7,69,
1970,0,77,7,70,
1971,0,78,7,71,
1972,0,77,6,71,
1973,0,78,7,71,
1974,0,76,6,70,
1975,0,78,7,71,
1976,0,78,7,71,
1977,0,78,6,72,
1978,0,77,6,71,
1979,0,79,7,72,
1980,0,77,6,71,
1981,0,79,7,72,
1982,0,79,6,73,
1983,0,79,7,72,
1984,0,79,7,72,
1985,0,79,6,73,
1986,0,78,6,72,
1987,0,81,7,74,
1988,0,79,6,73,
1989,0,82,7,75,
1990,0,80,6,74,
1991,0,79,6,73,
1992,0,82,7,75,
1993,0,81,6,75,
1994,0,81,7,74,
1995,0,82,7,75,
1996,0,80,6,74,
1997,0,82,7,75,
1998,0,81,6,75,
1999,0,83,8,75,
2000,0,82,6,76,
2001,0,82,6,76,
2002,0,82,7,75,
2003,0,82,6,76,
2004,0,81,6,75,
2005,0,83,7,76,
2006,0,82,6,76,
2007,0,82,7,75,
2008,0,82,7,75,
2009,0,82,6,76,
2010,0,80,6,74,
2011,0,68,6,62,
2012,0,57,7,50,
2013,0,53,6,47,
2014,0,51,7,44,
2015,0,43,6,37,
2016,0,40,7,33,
2017,0,38,7,31,
2018,0,39,6,33,
2019,0,47,7,40,
2020,0,53,6,47,
2021,0,54,6,48,
2022,0,56,7,49,
2023,0,56,6,50,
2024,0,56,7,49,
2025,0,56,6,50,
2026,0,56,6,50,
2027,0,58,7,51,
2028,0,57,6,51,
2029,0,57,6,51,
2030,0,59,7,52,
2031,0,57,6,51,
2032,0,60,7,53,
2033,0,59,7,52,
2034,0,59,6,53,
2035,0,59,6,53,
2036,0,61,7,54,
2037,0,60,6,54,
2038,0,61,7,54,
2039,0,61,7,54,
2040,0,63,7,56,
2041,0,61,7,54,
2042,0,62,6,56,
2043,0,61,6,55,
2044,0,63,8,55,
2045,0,64,7,57,
2046,0,64,7,57,
2047,0,62,6,56,
2048,0,66,8,58,
2049,0,64,6,58,
2050,0,64,7,57,
2051,0,65,7,58,
2052,0,64,7,57,
2053,0,65,6,59,
2054,0,64,6,58,
2055,0,66,7,59,
2056,0,66,6,60,
2057,0,65,6,59,
2058,0,67,7,60,
2059,0,67,7,60,
2060,0,67,7,60,
2061,0,66,6,60,
2062,0,68,7,61,
2063,0,68,7,61,
2064,0,68,6,62,
2065,0,68,7,61,
2066,0,68,6,62,
2067,0,68,6,62,
2068,0,69,7,62,
2069,0,70,6,64,
2070,0,69,6,63,
2071,0,69,7,62,
2072,0,70,6,64,
2073,0,69,6,63,
2074,0,71,7,64,
2075,0,70,6,64,
2076,0,70,6,64,
2077,0,72,7,65,
2078,0,71,6,65,
2079,0,71,7,64,
2080,0,72,6,66,
2081,0,71,6,65,
2082,0,73,7,66,
2083,0,71,6,65,
2084,0,73,7,66,
2085,0,73,6,67,
2086,0,72,6,66,
2087,0,73,7,66,
2088,0,73,6,67,
2089,0,73,6,67,
2090,0,74,7,67,
2091,0,75,7,68,
2092,0,74,6,68,
2093,0,76,8,68,
2094,0,75,6,69,
2095,0,75,6,69,
2096,0,75,7,68,
2097,0,76,6,70,
2098,0,75,6,69,
2099,0,77,8,69,
2100,0,82,13,69,
2101,0,82,13,69,
2102,0,84,13,71,
2103,0,84,13,71,
2104,0,83,13,70,
2105,0,83,12,71,
2106,0,84,13,71,
2107,0,85,13,72,
2108,0,83,12,71,
2109,0,84,13,71,
2110,0,85,13,72,
2111,0,85,13,72,
2112,0,84,12,72,
2113,0,85,13,72,
2114,0,86,13,73,
2115,0,85,13,72,
2116,0,87,13,74,
2117,0,87,13,74,
2118,0,87,13,74,
2119,0,85,12,73,
2120,0,85,12,73,
2121,0,88,13,75,
2122,0,87,13,74,
2123,0,87,13,74,
2124,0,87,13,74,
2125,0,88,13,75,
2126,0,88,13,75,
2127,0,89,13,76,
2128,0,89,13,76,
2129,0,89,13,76,
2130,0,83,7,76,
2131,0,81,6,75,
2132,0,83,7,76,
2133,0,82,7,75,
2134,0,82,6,76,
2135,0,81,6,75,
2136,0,82,7,75,
2137,0,70,7,63,
2138,0,58,7,51,
2139,0,53,7,46,
2140,0,51,7,44,
2141,0,43,6,37,
2142,0,34,6,28,
2143,0,27,6,21,
2144,0,21,6,15,
2145,0,28,7,21,
2146,0,39,6,33,
2147,0,39,6,33,
2148,0,41,7,34,
2149,0,40,6,34,
2150,0,41,7,34,
2151,0,42,7,35,
2152,0,42,6,36,
2153,0,42,6,36,
2154,0,44,7,37,
2155,0,44,6,38,
2156,0,43,6,37,
2157,0,46,7,39,
2158,0,45,6,39,
2159,0,47,7,40,
2160,0,46,7,39,
2161,0,48,8,40,
2162,0,47,6,41,
2163,0,47,6,41,
2164,0,49,7,42,
2165,0,49,6,43,
2166,0,48,6,42,
2167,0,50,7,43,
2168,0,49,6,43,
2169,0,51,7,44,
2170,0,52,7,45,
2171,0,50,6,44,
2172,0,52,7,45,
2173,0,51,6,45,
2174,0,53,7,46,
2175,0,52,6,46,
2176,0,52,6,46,
2177,0,53,7,46,
2178,0,54,6,48,
2179,0,53,6,47,
2180,0,55,7,48,
2181,0,54,6,48,
2182,0,56,7,49,
2183,0,55,7,48,
2184,0,56,6,50,
2185,0,58,7,51,
2186,0,56,6,50,
2187,0,57,7,50,
2188,0,58,7,51,
2189,0,56,6,50,
2190,0,58,7,51,
2191,0,59,7,52,
2192,0,57,6,51,
2193,0,61,7,54,
2194,0,59,6,53,
2195,0,59,7,52,
2196,0,61,7,54,
2197,0,60,6,54,
2198,0,60,7,53,
2199,0,61,7,54,
2200,0,62,7,55,
2201,0,60,6,54,
2202,0,61,7,54,
2203,0,62,6,56,
2204,0,62,6,56,
2205,0,62,7,55,
2206,0,62,6,56,
2207,0,62,6,56,
2208,0,64,7,57,
2209,0,62,6,56,
2210,0,67,7,60,
2211,0,65,7,58,
2212,0,64,6,58,
2213,0,63,6,57,
2214,0,65,7,58,
2215,0,65,6,59,
2216,0,64,6,58,
2217,0,67,7,60,
2218,0,66,6,60,
2219,0,66,7,59,
2220,0,68,9,59,
2221,0,72,12,60,
2222,0,74,13,61,
2223,0,73,12,61,
2224,0,66,6,60,
2225,0,69,7,62,
2226,0,68,7,61,
2227,0,68,6,62,
2228,0,68,7,61,
2229,0,70,7,63,
2230,0,69,6,63,
2231,0,70,7,63,
2232,0,68,6,62,
2233,0,72,7,65,
2234,0,70,6,64,
2235,0,70,7,63,
2236,0,71,7,64,
2237,0,70,6,64,
2238,0,73,7,66,
2239,0,71,6,65,
2240,0,71,7,64,
2241,0,71,6,65,
2242,0,75,7,68,
2243,0,72,7,65,
2244,0,74,7,67,
2245,0,73,6,67,
2246,0,74,7,67,
2247,0,72,6,66,
2248,0,74,7,67,
2249,0,73,6,67,
2250,0,74,7,67,
2251,0,74,6,68,
2252,0,73,6,67,
2253,0,74,7,67,
2254,0,75,6,69,
2255,0,74,6,68,
2256,0,76,7,69,
2257,0,74,6,68,
2258,0,78,7,71,
2259,0,76,6,70,
2260,0,75,6,69,
2261,0,78,7,71,
2262,0,76,6,70,
2263,0,77,7,70,
2264,0,78,7,71,
2265,0,76,6,70,
2266,0,78,7,71,
2267,0,77,6,71,
2268,0,78,7,71,
2269,0,78,6,72,
2270,0,78,6,72,
2271,0,78,7,71,
2272,0,79,6,73,
2273,0,80,7,73,
2274,0,78,6,72,
2275,0,80,7,73,
2276,0,79,7,72,
2277,0,81,7,74,
2278,0,79,6,73,
2279,0,82,7,75,
2280,0,80,6,74,
2281,0,81,7,74,
2282,0,80,6,74,
2283,0,82,7,75,
2284,0,81,6,75,
2285,0,80,6,74,
2286,0,82,8,74,
2287,0,82,7,75,
2288,0,82,6,76,
2289,0,82,6,76,
2290,0,82,7,75,
2291,0,82,6,76,
2292,0,82,7,75,
2293,0,83,7,76,
2294,0,82,6,76,
2295,0,82,7,75,
2296,0,82,6,76,
2297,0,81,6,75,
2298,0,71,7,64,
2299,0,58,6,52,
2300,0,52,6,46,
2301,0,51,7,44,
2302,0,46,7,39,
2303,0,40,6,34,
2304,0,38,7,31,
2305,0,38,6,32,
2306,0,46,7,39,
2307,0,57,7,50,
2308,0,55,6,49,
2309,0,54,6,48,
2310,0,57,7,50,
2311,0,59,9,50,
2312,0,59,8,51,
2313,0,58,7,51,
2314,0,57,6,51,
2315,0,58,7,51,
2316,0,57,6,51,
2317,0,60,7,53,
2318,0,58,6,52,
2319,0,59,7,52,
2320,0,60,7,53,
2321,0,58,6,52,
2322,0,62,7,55,
2323,0,60,6,54,
2324,0,60,7,53,
2325,0,62,7,55,
2326,0,61,6,55,
2327,0,60,6,54,
2328,0,62,7,55,
2329,0,61,6,55,
2330,0,64,8,56,
2331,0,65,9,56,
2332,0,65,8,57,
2333,0,63,6,57,
2334,0,64,7,57,
2335,0,62,6,56,
2336,0,67,8,59,
2337,0,64,6,58,
2338,0,63,6,57,
2339,0,66,7,59,
2340,0,64,6,58,
2341,0,66,7,59,
2342,0,66,7,59,
2343,0,66,7,59,
2344,0,66,6,60,
2345,0,66,6,60,
2346,0,67,8,59,
2347,0,69,8,61,
2348,0,66,6,60,
2349,0,67,7,60,
2350,0,67,7,60,
2351,0,68,6,62,
2352,0,67,6,61,
2353,0,68,7,61,
2354,0,70,7,63,
2355,0,69,6,63,
2356,0,68,6,62,
2357,0,70,7,63,
2358,0,69,6,63,
2359,0,70,7,63,
2360,0,70,6,64,
2361,0,69,6,63,
2362,0,72,8,64,
2363,0,71,6,65,
2364,0,72,7,65,
2365,0,71,7,64,
2366,0,72,7,65,
2367,0,71,6,65,
2368,0,75,8,67,
2369,0,72,6,66,
2370,0,71,6,65,
2371,0,75,7,68,
2372,0,74,7,67,
2373,0,73,7,66,
2374,0,73,6,67,
2375,0,73,6,67,
2376,0,75,7,68,
2377,0,74,7,67,
2378,0,74,6,68,
2379,0,73,6,67,
2380,0,77,7,70,
2381,0,75,6,69,
2382,0,75,7,68,
2383,0,76,7,69,
2384,0,75,6,69,
2385,0,78,7,71,
2386,0,76,6,70,
2387,0,76,7,69,
2388,0,77,7,70,
2389,0,77,6,71,
2390,0,77,7,70,
2391,0,78,7,71,
2392,0,76,6,70,
2393,0,79,7,72,
2394,0,79,7,72,
2395,0,78,7,71,
2396,0,78,6,72,
2397,0,77,6,71,
2398,0,81,7,74,
2399,0,78,6,72,
2400,0,80,7,73,
2401,0,78,6,72,
2402,0,83,9,74,
2403,0,80,6,74,
2404,0,80,7,73,
2405,0,81,7,74,
2406,0,79,6,73,
2407,0,82,7,75,
2408,0,81,6,75,
2409,0,80,6,74,
2410,0,82,8,74,
2411,0,81,7,74,
2412,0,81,6,75,
2413,0,81,6,75,
2414,0,83,7,76,
2415,0,81,6,75,
2416,0,82,7,75,
2417,0,82,6,76,
2418,0,81,6,75,
2419,0,82,7,75,
2420,0,82,6,76,
2421,0,81,6,75,
2422,0,83,7,76,
2423,0,82,7,75,
2424,0,71,7,64,
2425,0,59,7,52,
2426,0,52,6,46,
2427,0,52,7,45,
2428,0,45,6,39,
2429,0,35,6,29,
2430,0,27,6,21,
2431,0,22,6,16,
2432,0,29,7,22,
2433,0,41,8,33,
2434,0,39,6,33,
2435,0,40,7,33,
2436,0,41,6,35,
2437,0,41,6,35,
2438,0,43,7,36,
2439,0,42,7,35,
2440,0,43,6,37,
2441,0,42,6,36,
2442,0,45,7,38,
2443,0,44,6,38,
2444,0,45,7,38,
2445,0,45,6,39,
2446,0,46,6,40,
2447,0,46,7,39,
2448,0,47,6,41,
2449,0,46,6,40,
2450,0,49,7,42,
2451,0,48,6,42,
2452,0,48,7,41,
2453,0,49,6,43,
2454,0,48,6,42,
2455,0,52,7,45,
2456,0,50,6,44,
2457,0,50,6,44,
2458,0,52,7,45,
2459,0,50,6,44,
2460,0,53,7,46,
2461,0,52,7,45,
2462,0,52,6,46,
2463,0,52,6,46,
2464,0,55,7,48,
2465,0,54,6,48,
2466,0,53,6,47,
2467,0,55,7,48,
2468,0,55,6,49,
2469,0,55,7,48,
2470,0,57,7,50,
2471,0,56,6,50,
2472,0,57,8,49,
2473,0,56,6,50,
2474,0,57,6,51,
2475,0,57,7,50,
2476,0,57,6,51,
2477,0,59,7,52,
2478,0,57,6,51,
2479,0,59,7,52,
2480,0,59,6,53,
2481,0,58,6,52,
2482,0,60,7,53,
2483,0,60,6,54,
2484,0,61,7,54,
2485,0,61,7,54,
2486,0,59,6,53,
2487,0,61,7,54,
2488,0,61,6,55,
2489,0,61,7,54,
2490,0,63,7,56,
2491,0,61,6,55,
2492,0,63,7,56,
2493,0,68,10,58,
2494,0,63,7,56,
2495,0,63,6,57,
2496,0,62,6,56,
2497,0,65,7,58,
2498,0,64,6,58,
2499,0,65,8,57,
2500,0,64,6,58,
2501,0,65,7,58,
2502,0,67,7,60,
2503,0,65,6,59,
2504,0,65,6,59,
2505,0,67,7,60,
2506,0,65,6,59,
2507,0,66,7,59,
2508,0,67,6,61,
2509,0,66,6,60,
2510,0,68,7,61,
2511,0,67,6,61,
2512,0,67,6,61,
2513,0,69,7,62,
2514,0,67,6,61,
2515,0,68,7,61,
2516,0,70,8,62,
2517,0,69,6,63,
2518,0,68,6,62,
2519,0,70,7,63,
2520,0,70,6,64,
2521,0,71,7,64,
2522,0,69,6,63,
2523,0,72,7,65,
2524,0,72,7,65,
2525,0,71,7,64,
2526,0,71,6,65,
2527,0,70,6,64,
2528,0,73,7,66,
2529,0,72,7,65,
2530,0,72,6,66,
2531,0,71,6,65,
2532,0,74,7,67,
2533,0,73,7,66,
2534,0,74,7,67,
2535,0,72,6,66,
2536,0,74,7,67,
2537,0,74,6,68,
2538,0,74,7,67,
2539,0,73,6,67,
2540,0,76,7,69,
2541,0,75,6,69,
2542,0,75,7,68,
2543,0,76,7,69,
2544,0,76,7,69,
2545,0,74,6,68,
2546,0,77,7,70,
2547,0,76,7,69,
2548,0,76,6,70,
2549,0,76,6,70,
2550,0,77,7,70,
2551,0,77,6,71,
2552,0,76,6,70,
2553,0,77,7,70,
2554,0,79,7,72,
2555,0,77,6,71,
2556,0,79,7,72,
2557,0,78,6,72,
2558,0,77,6,71,
2559,0,81,8,73,
2560,0,79,6,73,
2561,0,79,7,72,
2562,0,79,6,73,
2563,0,78,6,72,
2564,0,81,7,74,
2565,0,80,6,74,
2566,0,80,7,73,
2567,0,80,6,74,
2568,0,81,7,74,
2569,0,81,6,75,
2570,0,81,7,74,
2571,0,82,7,75,
2572,0,80,6,74,
2573,0,82,7,75,
2574,0,82,6,76,
2575,0,83,7,76,
2576,0,82,7,75,
2577,0,84,7,77,
2578,0,82,6,76,
2579,0,81,6,75,
2580,0,83,7,76,
2581,0,81,6,75,
2582,0,83,7,76,
2583,0,82,7,75,
2584,0,86,9,77,
2585,0,71,6,65,
2586,0,59,6,53,
2587,0,55,7,48,
2588,0,51,6,45,
2589,0,45,6,39,
2590,0,36,6,30,
2591,0,28,7,21,
2592,0,21,5,16,
2593,0,28,7,21,
2594,0,38,6,32,
2595,0,42,7,35,
2596,0,40,6,34,
2597,0,40,6,34,
2598,0,43,7,36,
2599,0,42,6,36,
2600,0,42,7,35,
2601,0,44,7,37,
2602,0,42,6,36,
2603,0,45,7,38,
2604,0,44,6,38,
2605,0,44,6,38,
2606,0,46,8,38,
2607,0,46,7,39,
2608,0,46,6,40,
2609,0,46,6,40,
2610,0,48,7,41,
2611,0,47,6,41,
2612,0,48,7,41,
2613,0,48,6,42,
2614,0,48,6,42,
2615,0,51,7,44,
2616,0,50,6,44,
2617,0,49,6,43,
2618,0,51,7,44,
2619,0,50,6,44,
2620,0,53,7,46,
2621,0,52,6,46,
2622,0,52,7,45,
2623,0,53,7,46,
2624,0,53,6,47,
2625,0,53,7,46,
2626,0,54,7,47,
2627,0,53,6,47,
2628,0,55,7,48,
2629,0,54,7,47,
2630,0,55,6,49,
2631,0,54,6,48,
2632,0,57,7,50,
2633,0,56,6,50,
2634,0,55,6,49,
2635,0,57,7,50,
2636,0,57,7,50,
2637,0,58,7,51,
2638,0,58,7,51,
2639,0,58,6,52,
2640,0,58,7,51,
2641,0,60,7,53,
2642,0,59,6,53,
2643,0,59,7,52,
2644,0,58,6,52,
2645,0,60,7,53,
2646,0,60,6,54,
2647,0,59,6,53,
2648,0,62,7,55,
2649,0,60,6,54,
2650,0,62,7,55,
2651,0,62,7,55,
2652,0,62,6,56,
2653,0,62,6,56,
2654,0,62,7,55,
2655,0,63,6,57,
2656,0,62,6,56,
2657,0,64,7,57,
2658,0,66,7,59,
2659,0,63,6,57,
2660,0,65,7,58,
2661,0,64,6,58,
2662,0,64,6,58,
2663,0,66,7,59,
2664,0,65,6,59,
2665,0,65,7,58,
2666,0,66,7,59,
2667,0,67,7,60,
2668,0,65,6,59,
2669,0,68,7,61,
2670,0,67,6,61,
2671,0,66,6,60,
2672,0,69,7,62,
2673,0,68,6,62,
2674,0,68,7,61,
2675,0,69,7,62,
2676,0,69,7,62,
2677,0,69,6,63,
2678,0,68,6,62,
2679,0,70,7,63,
2680,0,69,6,63,
2681,0,69,6,63,
2682,0,71,7,64,
2683,0,72,7,65,
2684,0,70,6,64,
2685,0,71,7,64,
2686,0,71,6,65,
2687,0,70,6,64,
2688,0,72,7,65,
2689,0,72,7,65,
2690,0,72,6,66,
2691,0,71,6,65,
2692,0,72,7,65,
2693,0,73,6,67,
2694,0,73,6,67,
2695,0,72,6,66,
2696,0,73,7,66,
2697,0,74,7,67,
2698,0,76,7,69,
2699,0,73,6,67,
2700,0,76,7,69,
2701,0,74,6,68,
2702,0,74,6,68,
2703,0,76,7,69,
2704,0,76,7,69,
2705,0,75,6,69,
2706,0,76,7,69,
2707,0,76,7,69,
2708,0,77,7,70,
2709,0,75,6,69,
2710,0,77,7,70,
2711,0,77,6,71,
2712,0,78,7,71,
2713,0,77,6,71,
2714,0,77,7,70,
2715,0,77,6,71,
2716,0,77,6,71,
2717,0,79,7,72,
2718,0,78,6,72,
2719,0,77,6,71,
2720,0,79,7,72,
2721,0,80,7,73,
2722,0,79,6,73,
2723,0,79,7,72,
2724,0,79,6,73,
2725,0,79,6,73,
2726,0,80,7,73,
2727,0,82,7,75,
2728,0,79,6,73,
2729,0,82,8,74,
2730,0,82,7,75,
2731,0,81,7,74,
2732,0,81,6,75,
2733,0,80,6,74,
2734,0,82,7,75,
2735,0,84,8,76,
2736,0,83,8,75,
2737,0,82,6,76,
2738,0,81,6,75,
2739,0,82,7,75,
2740,0,82,6,76,
2741,0,83,7,76,
2742,0,81,6,75,
2743,0,83,7,76,
2744,0,82,6,76,
2745,0,82,7,75,
2746,0,69,6,63,
2747,0,57,6,51,
2748,0,53,7,46,
2749,0,51,7,44,
2750,0,44,6,38,
2751,0,35,7,28,
2752,0,26,6,20,
2753,0,24,7,17,
2754,0,27,6,21,
2755,0,39,7,32,
2756,0,40,6,34,
2757,0,39,6,33,
2758,0,41,7,34,
2759,0,41,6,35,
2760,0,41,6,35,
2761,0,43,7,36,
2762,0,42,6,36,
2763,0,44,7,37,
2764,0,44,7,37,
2765,0,44,7,37,
2766,0,51,11,40,
2767,0,45,6,39,
2768,0,45,6,39,
2769,0,47,7,40,
2770,0,46,6,40,
2771,0,47,7,40,
2772,0,48,6,42,
2773,0,49,8,41,
2774,0,47,6,41,
2775,0,51,7,44,
2776,0,49,6,43,
2777,0,49,6,43,
2778,0,51,7,44,
2779,0,50,6,44,
2780,0,51,7,44,
2781,0,51,6,45,
2782,0,52,7,45,
2783,0,53,7,46,
2784,0,52,6,46,
2785,0,52,6,46,
2786,0,54,7,47,
2787,0,55,7,48,
2788,0,54,7,47,
2789,0,54,7,47,
2790,0,55,6,49,
2791,0,54,6,48,
2792,0,56,7,49,
2793,0,56,6,50,
2794,0,55,6,49,
2795,0,57,7,50,
2796,0,59,7,52,
2797,0,57,7,50,
2798,0,58,7,51,
2799,0,58,6,52,
2800,0,58,7,51,
2801,0,58,6,52,
2802,0,58,6,52,
2803,0,61,7,54,
2804,0,59,6,53,
2805,0,58,6,52,
2806,0,61,7,54,
2807,0,60,6,54,
2808,0,60,7,53,
2809,0,61,6,55,
2810,0,60,6,54,
2811,0,62,7,55,
2812,0,62,6,56,
2813,0,61,6,55,
2814,0,63,7,56,
2815,0,61,6,55,
2816,0,65,7,58,
2817,0,63,7,56,
2818,0,63,6,57,
2819,0,65,7,58,
2820,0,63,6,57,
2821,0,66,7,59,
2822,0,64,6,58,
2823,0,64,6,58,
2824,0,66,7,59,
2825,0,65,6,59,
2826,0,67,8,59,
2827,0,67,7,60,
2828,0,65,6,59,
2829,0,67,7,60,
2830,0,67,6,61,
2831,0,70,7,63,
2832,0,66,6,60,
2833,0,68,7,61,
2834,0,67,6,61,
2835,0,69,7,62,
2836,0,68,6,62,
2837,0,68,7,61,
2838,0,70,7,63,
2839,0,68,6,62,
2840,0,69,7,62,
2841,0,69,6,63,
2842,0,69,6,63,
2843,0,72,7,65,
2844,0,71,7,64,
2845,0,70,7,63,
2846,0,71,6,65,
2847,0,72,7,65,
2848,0,70,6,64,
2849,0,72,8,64,
2850,0,72,6,66,
2851,0,71,6,65,
2852,0,73,7,66,
2853,0,72,6,66,
2854,0,72,6,66,
2855,0,74,7,67,
2856,0,72,6,66,
2857,0,79,11,68,
2858,0,73,6,67,
2859,0,73,6,67,
2860,0,76,7,69,
2861,0,74,6,68,
2862,0,75,7,68,
2863,0,76,7,69,
2864,0,74,6,68,
2865,0,73,6,67,
2866,0,75,7,68,
2867,0,76,6,70,
2868,0,75,6,69,
2869,0,78,7,71,
2870,0,76,6,70,
2871,0,75,6,69,
2872,0,78,7,71,
2873,0,76,6,70,
2874,0,77,7,70,
2875,0,77,6,71,
2876,0,77,7,70,
2877,0,79,7,72,
2878,0,78,6,72,
2879,0,79,7,72,
2880,0,77,6,71,
2881,0,80,7,73,
2882,0,80,7,73,
2883,0,79,6,73,
2884,0,79,7,72,
2885,0,80,7,73,
2886,0,79,6,73,
2887,0,83,7,76,
2888,0,81,7,74,
2889,0,81,8,73,
2890,0,80,6,74,
2891,0,80,6,74,
2892,0,82,7,75,
2893,0,81,6,75,
2894,0,81,7,74,
2895,0,80,6,74,
2896,0,83,7,76,
2897,0,82,6,76,
2898,0,81,6,75,
2899,0,83,7,76,
2900,0,81,6,75,
2901,0,82,7,75,
2902,0,82,6,76,
2903,0,83,7,76,
2904,0,83,7,76,
2905,0,81,6,75,
2906,0,80,7,73,
2907,0,67,6,61,
2908,0,54,6,48,
2909,0,52,7,45,
2910,0,49,7,42,
2911,0,41,6,35,
2912,0,32,7,25,
2913,0,25,6,19,
2914,0,23,6,17,
2915,0,32,7,25,
2916,0,39,6,33,
2917,0,39,6,33,
2918,0,42,8,34,
2919,0,40,6,34,
2920,0,43,7,36,
2921,0,42,6,36,
2922,0,43,7,36,
2923,0,44,7,37,
2924,0,43,6,37,
2925,0,46,7,39,
2926,0,45,6,39,
2927,0,44,6,38,
2928,0,47,7,40,
2929,0,46,6,40,
2930,0,46,7,39,
2931,0,47,6,41,
2932,0,46,6,40,
2933,0,49,7,42,
2934,0,48,7,41,
2935,0,49,6,43,
2936,0,48,6,42,
2937,0,49,7,42,
2938,0,50,6,44,
2939,0,49,6,43,
2940,0,52,7,45,
2941,0,50,6,44,
2942,0,52,7,45,
2943,0,52,6,46,
2944,0,51,6,45,
2945,0,55,7,48,
2946,0,53,6,47,
2947,0,54,7,47,
2948,0,56,8,48,
2949,0,53,6,47,
2950,0,54,7,47,
2951,0,56,7,49,
2952,0,55,6,49,
2953,0,54,6,48,
2954,0,58,7,51,
2955,0,56,6,50,
2956,0,55,6,49,
2957,0,58,7,51,
2958,0,57,6,51,
2959,0,57,7,50,
2960,0,58,6,52,
2961,0,57,6,51,
2962,0,59,7,52,
2963,0,59,6,53,
2964,0,59,7,52,
2965,0,60,7,53,
2966,0,59,6,53,
2967,0,60,7,53,
2968,0,60,7,53,
2969,0,60,6,54,
2970,0,62,7,55,
2971,0,60,6,54,
2972,0,61,7,54,
2973,0,62,6,56,
2974,0,61,6,55,
2975,0,62,7,55,
2976,0,63,6,57,
2977,0,64,8,56,
2978,0,62,6,56,
2979,0,64,7,57,
2980,0,63,6,57,
2981,0,66,7,59,
2982,0,64,6,58,
2983,0,65,7,58,
2984,0,65,7,58,
2985,0,66,7,59,
2986,0,65,7,58,
2987,0,66,6,60,
2988,0,65,6,59,
2989,0,67,7,60,
2990,0,66,6,60,
2991,0,66,6,60,
2992,0,68,7,61,
2993,0,67,6,61,
2994,0,67,7,60,
2995,0,68,6,62,
2996,0,67,6,61,
2997,0,69,7,62,
2998,0,68,6,62,
2999,0,69,7,62,
3000,0,69,6,63,
3001,0,69,6,63,
3002,0,69,7,62,
3003,0,70,6,64,
3004,0,69,6,63,
3005,0,71,7,64,
3006,0,69,6,63,
3007,0,71,7,64,
3008,0,71,7,64,
3009,0,73,7,66,
3010,0,72,7,65,
3011,0,72,7,65,
3012,0,71,6,65,
3013,0,73,7,66,
3014,0,73,7,66,
3015,0,72,6,66,
3016,0,73,7,66,
3017,0,73,6,67,
3018,0,72,6,66,
3019,0,76,7,69,
3020,0,74,6,68,
3021,0,73,6,67,
3022,0,75,7,68,
3023,0,73,6,67,
3024,0,76,7,69,
3025,0,75,6,69,
3026,0,75,7,68,
3027,0,76,7,69,
3028,0,76,6,70,
3029,0,77,7,70,
3030,0,77,7,70,
3031,0,75,6,69,
3032,0,76,7,69,
3033,0,77,7,70,
3034,0,77,6,71,
3035,0,76,6,70,
3036,0,78,7,71,
3037,0,78,6,72,
3038,0,80,8,72,
3039,0,80,8,72,
3040,0,79,7,72,
3041,0,78,7,71,
3042,0,79,7,72,
3043,0,80,7,73,
3044,0,80,7,73,
3045,0,79,7,72,
3046,0,78,6,72,
3047,0,82,7,75,
3048,0,80,6,74,
3049,0,79,6,73,
3050,0,81,7,74,
3051,0,79,6,73,
3052,0,82,7,75,
3053,0,81,7,74,
3054,0,81,6,75,
3055,0,80,6,74,
3056,0,83,7,76,
3057,0,82,6,76,
3058,0,81,6,75,
3059,0,83,7,76,
3060,0,81,6,75,
3061,0,83,7,76,
3062,0,82,7,75,
3063,0,82,6,76,
3064,0,81,6,75,
3065,0,84,7,77,
3066,0,82,6,76,
3067,0,77,6,71,
3068,0,66,7,59,
3069,0,54,7,47,
3070,0,53,7,46,
3071,0,49,7,42,
3072,0,39,5,34,
3073,0,32,7,25,
3074,0,27,7,20,
3075,0,25,6,19,
3076,0,29,6,23,
3077,0,40,7,33,
3078,0,39,6,33,
3079,0,40,7,33,
3080,0,41,6,35,
3081,0,40,6,34,
3082,0,43,7,36,
3083,0,43,6,37,
3084,0,42,6,36,
3085,0,45,7,38,
3086,0,44,7,37,
3087,0,45,7,38,
3088,0,45,6,39,
3089,0,46,7,39,
3090,0,46,7,39,
3091,0,46,7,39,
3092,0,50,8,42,
3093,0,47,6,41,
3094,0,47,6,41,
3095,0,50,7,43,
3096,0,49,6,43,
3097,0,49,7,42,
3098,0,49,6,43,
3099,0,49,6,43,
3100,0,51,7,44,
3101,0,53,7,46,
3102,0,51,6,45,
3103,0,50,6,44,
3104,0,53,7,46,
3105,0,52,6,46,
3106,0,57,9,48,
3107,0,53,7,46,
3108,0,55,8,47,
3109,0,55,7,48,
3110,0,55,7,48,
3111,0,56,8,48,
3112,0,55,6,49,
3113,0,56,7,49,
3114,0,55,7,48,
3115,0,56,6,50,
3116,0,55,6,49,
3117,0,57,7,50,
3118,0,57,6,51,
3119,0,57,7,50,
3120,0,56,6,50,
3121,0,60,7,53,
3122,0,58,6,52,
3123,0,57,6,51,
3124,0,60,7,53,
3125,0,58,6,52,
3126,0,61,7,54,
3127,0,60,6,54,
3128,0,60,7,53,
3129,0,62,8,54,
3130,0,63,8,55,
3131,0,60,6,54,
3132,0,61,7,54,
3133,0,61,6,55,
3134,0,61,6,55,
3135,0,62,7,55,
3136,0,63,7,56,
3137,0,63,6,57,
3138,0,64,7,57,
3139,0,62,6,56,
3140,0,65,7,58,
3141,0,64,6,58,
3142,0,65,7,58,
3143,0,63,6,57,
3144,0,66,7,59,
3145,0,64,6,58,
3146,0,67,7,60,
3147,0,65,7,58,
3148,0,66,6,60,
3149,0,65,6,59,
3150,0,66,7,59,
3151,0,66,7,59,
3152,0,68,7,61,
3153,0,67,7,60,
3154,0,67,7,60,
3155,0,70,7,63,
3156,0,68,6,62,
3157,0,67,6,61,
3158,0,69,7,62,
3159,0,69,6,63,
3160,0,69,7,62,
3161,0,69,6,63,
3162,0,68,6,62,
3163,0,71,7,64,
3164,0,70,6,64,
3165,0,70,7,63,
3166,0,70,7,63,
3167,0,72,7,65,
3168,0,71,6,65,
3169,0,71,7,64,
3170,0,71,6,65,
3171,0,70,6,64,
3172,0,73,7,66,
3173,0,72,6,66,
3174,0,71,6,65,
3175,0,73,7,66,
3176,0,72,6,66,
3177,0,74,7,67,
3178,0,73,6,67,
3179,0,73,7,66,
3180,0,74,7,67,
3181,0,75,7,68,
3182,0,74,6,68,
3183,0,75,7,68,
3184,0,73,6,67,
3185,0,76,7,69,
3186,0,75,6,69,
3187,0,75,7,68,
3188,0,75,6,69,
3189,0,75,6,69,
3190,0,77,7,70,
3191,0,77,7,70,
3192,0,75,6,69,
3193,0,77,7,70,
3194,0,77,6,71,
3195,0,77,7,70,
3196,0,77,6,71,
3197,0,76,6,70,
3198,0,79,7,72,
3199,0,78,7,71,
3200,0,78,7,71,
3201,0,78,6,72,
3202,0,77,6,71,
3203,0,79,7,72,
3204,0,79,6,73,
3205,0,78,6,72,
3206,0,80,7,73,
3207,0,78,6,72,
3208,0,82,7,75,
3209,0,80,6,74,
3210,0,79,6,73,
3211,0,82,7,75,
3212,0,80,6,74,
3213,0,83,8,75,
3214,0,80,6,74,
3215,0,82,7,75,
3216,0,84,8,76,
3217,0,81,6,75,
3218,0,82,7,75,
3219,0,82,6,76,
3220,0,82,6,76,
3221,0,83,7,76,
3222,0,81,6,75,
3223,0,83,7,76,
3224,0,81,6,75,
3225,0,82,7,75,
3226,0,82,6,76,
3227,0,82,7,75,
3228,0,76,7,69,
3229,0,65,7,58,
3230,0,53,6,47,
3231,0,52,6,46,
3232,0,49,7,42,
3233,0,38,5,33,
3234,0,31,7,24,
3235,0,24,6,18,
3236,0,25,7,18,
3237,0,33,6,27,
3238,0,38,6,32,
3239,0,42,7,35,
3240,0,40,6,34,
3241,0,42,7,35,
3242,0,40,6,34,
3243,0,42,7,35,
3244,0,43,7,36,
3245,0,43,6,37,
3246,0,44,7,37,
3247,0,44,6,38,
3248,0,47,7,40,
3249,0,45,6,39,
3250,0,46,7,39,
3251,0,47,7,40,
3252,0,45,6,39,
3253,0,48,7,41,
3254,0,47,6,41,
3255,0,48,7,41,
3256,0,48,6,42,
3257,0,49,6,43,
3258,0,49,7,42,
3259,0,49,6,43,
3260,0,49,6,43,
3261,0,51,8,43,
3262,0,53,8,45,
3263,0,51,6,45,
3264,0,51,7,44,
3265,0,52,6,46,
3266,0,52,6,46,
3267,0,53,7,46,
3268,0,53,6,47,
3269,0,52,6,46,
3270,0,55,7,48,
3271,0,53,6,47,
3272,0,54,7,47,
3273,0,55,7,48,
3274,0,55,6,49,
3275,0,55,6,49,
3276,0,57,7,50,
3277,0,55,6,49,
3278,0,56,7,49,
3279,0,58,7,51,
3280,0,57,6,51,
3281,0,57,7,50,
3282,0,58,6,52,
3283,0,57,6,51,
3284,0,60,7,53,
3285,0,59,6,53,
3286,0,58,6,52,
3287,0,59,7,52,
3288,0,61,7,54,
3289,0,60,6,54,
3290,0,60,7,53,
3291,0,61,6,55,
3292,0,60,6,54,
3293,0,62,7,55,
3294,0,60,6,54,
3295,0,63,7,56,
3296,0,61,6,55,
3297,0,62,7,55,
3298,0,63,6,57,
3299,0,62,6,56,
3300,0,64,7,57,
3301,0,62,6,56,
3302,0,67,8,59,
3303,0,64,6,58,
3304,0,63,6,57,
3305,0,67,7,60,
3306,0,65,6,59,
3307,0,65,7,58,
3308,0,65,6,59,
3309,0,65,6,59,
3310,0,67,7,60,
3311,0,67,7,60,
3312,0,65,6,59,
3313,0,68,7,61,
3314,0,68,8,60,
3315,0,67,6,61,
3316,0,67,7,60,
3317,0,68,7,61,
3318,0,69,7,62,
3319,0,68,7,61,
3320,0,68,7,61,
3321,0,69,6,63,
3322,0,68,6,62,
3323,0,69,7,62,
3324,0,69,6,63,
3325,0,69,6,63,
3326,0,71,7,64,
3327,0,69,6,63,
3328,0,72,7,65,
3329,0,71,6,65,
3330,0,70,6,64,
3331,0,73,7,66,
3332,0,71,6,65,
3333,0,72,7,65,
3334,0,72,6,66,
3335,0,71,6,65,
3336,0,72,7,65,
3337,0,74,7,67,
3338,0,73,6,67,
3339,0,72,6,66,
3340,0,74,7,67,
3341,0,75,7,68,
3342,0,74,7,67,
3343,0,75,7,68,
3344,0,73,6,67,
3345,0,76,7,69,
3346,0,75,6,69,
3347,0,75,7,68,
3348,0,75,6,69,
3349,0,75,6,69,
3350,0,76,7,69,
3351,0,77,7,70,
3352,0,75,6,69,
3353,0,77,7,70,
3354,0,76,6,70,
3355,0,77,7,70,
3356,0,77,6,71,
3357,0,76,6,70,
3358,0,79,7,72,
3359,0,77,6,71,
3360,0,77,6,71,
3361,0,79,7,72,
3362,0,78,6,72,
3363,0,79,7,72,
3364,0,80,7,73,
3365,0,78,6,72,
3366,0,80,7,73,
3367,0,79,6,73,
3368,0,78,6,72,
3369,0,80,7,73,
3370,0,80,7,73,
3371,0,80,7,73,
3372,0,81,7,74,
3373,0,80,6,74,
3374,0,82,7,75,
3375,0,81,7,74,
3376,0,83,7,76,
3377,0,81,6,75,
3378,0,83,7,76,
3379,0,82,6,76,
3380,0,82,7,75,
3381,0,82,6,76,
3382,0,81,6,75,
3383,0,83,7,76,
3384,0,81,6,75,
3385,0,82,7,75,
3386,0,82,6,76,
3387,0,81,6,75,
3388,0,82,7,75,
3389,0,78,6,72,
3390,0,66,6,60,
3391,0,55,7,48,
3392,0,53,6,47,
3393,0,49,7,42,
3394,0,41,6,35,
3395,0,32,6,26,
3396,0,26,6,20,
3397,0,24,7,17,
3398,0,29,6,23,
3399,0,38,6,32,
3400,0,41,7,34,
3401,0,40,6,34,
3402,0,44,9,35,
3403,0,42,7,35,
3404,0,42,6,36,
3405,0,43,6,37,
3406,0,43,7,36,
3407,0,45,7,38,
3408,0,45,7,38,
3409,0,44,6,38,
3410,0,46,7,39,
3411,0,46,7,39,
3412,0,46,6,40,
3413,0,45,6,39,
3414,0,49,7,42,
3415,0,47,6,41,
3416,0,47,6,41,
3417,0,48,7,41,
3418,0,51,7,44,
3419,0,49,6,43,
3420,0,49,7,42,
3421,0,51,7,44,
3422,0,49,6,43,
3423,0,52,7,45,
3424,0,50,6,44,
3425,0,52,7,45,
3426,0,51,6,45,
3427,0,52,7,45,
3428,0,53,6,47,
3429,0,53,7,46,
3430,0,53,7,46,
3431,0,55,7,48,
3432,0,54,6,48,
3433,0,53,6,47,
3434,0,56,7,49,
3435,0,54,6,48,
3436,0,55,7,48,
3437,0,56,6,50,
3438,0,55,6,49,
3439,0,57,7,50,
3440,0,56,6,50,
3441,0,57,7,50,
3442,0,57,6,51,
3443,0,57,6,51,
3444,0,58,7,51,
3445,0,58,6,52,
3446,0,58,6,52,
3447,0,60,7,53,
3448,0,58,6,52,
3449,0,62,7,55,
3450,0,60,6,54,
3451,0,59,6,53,
3452,0,63,7,56,
3453,0,61,6,55,
3454,0,61,7,54,
3455,0,61,6,55,
3456,0,63,7,56,
3457,0,61,6,55,
3458,0,62,7,55,
3459,0,63,6,57,
3460,0,62,6,56,
3461,0,65,7,58,
3462,0,63,6,57,
3463,0,64,7,57,
3464,0,64,6,58,
3465,0,66,8,58,
3466,0,65,6,59,
3467,0,65,7,58,
3468,0,65,7,58,
3469,0,65,6,59,
3470,0,66,6,60,
3471,0,66,7,59,
3472,0,67,7,60,
3473,0,65,6,59,
3474,0,68,7,61,
3475,0,67,6,61,
3476,0,67,7,60,
3477,0,67,6,61,
3478,0,67,6,61,
3479,0,70,7,63,
3480,0,68,6,62,
3481,0,67,6,61,
3482,0,70,7,63,
3483,0,69,6,63,
3484,0,69,7,62,
3485,0,69,6,63,
3486,0,72,7,65,
3487,0,70,6,64,
3488,0,69,6,63,
3489,0,72,7,65,
3490,0,71,6,65,
3491,0,71,7,64,
3492,0,72,7,65,
3493,0,73,8,65,
3494,0,71,6,65,
3495,0,73,7,66,
3496,0,72,7,65,
3497,0,74,7,67,
3498,0,73,6,67,
3499,0,74,7,67,
3500,0,73,6,67,
3501,0,74,7,67,
3502,0,74,7,67,
3503,0,75,7,68,
3504,0,73,6,67,
3505,0,75,7,68,
3506,0,74,6,68,
3507,0,74,6,68,
3508,0,76,7,69,
3509,0,75,6,69,
3510,0,75,7,68,
3511,0,76,6,70,
3512,0,75,6,69,
3513,0,77,7,70,
3514,0,78,7,71,
3515,0,76,7,69,
3516,0,76,6,70,
3517,0,78,7,71,
3518,0,77,7,70,
3519,0,77,6,71,
3520,0,77,6,71,
3521,0,79,7,72,
3522,0,78,6,72,
3523,0,78,7,71,
3524,0,78,6,72,
3525,0,80,7,73,
3526,0,79,6,73,
3527,0,80,7,73,
3528,0,78,6,72,
3529,0,80,7,73,
3530,0,79,6,73,
3531,0,80,7,73,
3532,0,80,6,74,
3533,0,79,6,73,
3534,0,81,7,74,
3535,0,81,6,75,
3536,0,80,6,74,
3537,0,82,7,75,
3538,0,80,6,74,
3539,0,83,7,76,
3540,0,82,6,76,
3541,0,82,7,75,
3542,0,83,7,76,
3543,0,81,6,75,
3544,0,83,7,76,
3545,0,83,7,76,
3546,0,81,6,75,
3547,0,82,7,75,
3548,0,82,7,75,
3549,0,82,6,76,
3550,0,78,6,72,
3551,0,66,7,59,
3552,0,53,6,47,
3553,0,53,7,46,
3554,0,48,6,42,
3555,0,40,6,34,
3556,0,32,6,26,
3557,0,26,7,19,
3558,0,24,6,18,
3559,0,32,7,25,
3560,0,40,7,33,
3561,0,40,6,34,
3562,0,40,7,33,
3563,0,41,6,35,
3564,0,41,6,35,
3565,0,42,7,35,
3566,0,42,6,36,
3567,0,42,6,36,
3568,0,45,7,38,
3569,0,43,6,37,
3570,0,46,7,39,
3571,0,45,6,39,
3572,0,44,6,38,
3573,0,48,7,41,
3574,0,46,6,40,
3575,0,49,8,41,
3576,0,46,6,40,
3577,0,48,7,41,
3578,0,50,7,43,
3579,0,49,6,43,
3580,0,49,7,42,
3581,0,49,6,43,
3582,0,50,6,44,
3583,0,50,7,43,
3584,0,51,7,44,
3585,0,52,7,45,
3586,0,50,6,44,
3587,0,53,7,46,
3588,0,52,7,45,
3589,0,53,6,47,
3590,0,53,7,46,
3591,0,55,7,48,
3592,0,54,6,48,
3593,0,53,6,47,
3594,0,55,7,48,
3595,0,55,6,49,
3596,0,55,7,48,
3597,0,55,6,49,
3598,0,55,6,49,
3599,0,57,7,50,
3600,0,56,6,50,
3601,0,56,6,50,
3602,0,58,7,51,
3603,0,56,6,50,
3604,0,58,7,51,
3605,0,58,7,51,
3606,0,59,7,52,
3607,0,59,7,52,
3608,0,60,7,53,
3609,0,59,6,53,
3610,0,59,6,53,
3611,0,61,7,54,
3612,0,59,6,53,
3613,0,60,7,53,
3614,0,61,7,54,
3615,0,61,6,55,
3616,0,62,7,55,
3617,0,64,7,57,
3618,0,62,6,56,
3619,0,61,6,55,
3620,0,63,7,56,
3621,0,65,8,57,
3622,0,63,6,57,
3623,0,63,7,56,
3624,0,65,7,58,
3625,0,63,6,57,
3626,0,65,7,58,
3627,0,64,6,58,
3628,0,64,6,58,
3629,0,66,7,59,
3630,0,65,6,59,
3631,0,66,7,59,
3632,0,66,6,60,
3633,0,65,6,59,
3634,0,67,7,60,
3635,0,68,7,61,
3636,0,51,1,50,
3637,0,28,,28,
3638,0,4,,4,
