window-id,queue-size-CL,queue-size-LL,10.0.0.13:34983 -> 10.0.1.13:3000,10.0.1.13:3000 -> 10.0.0.13:34983,10.0.0.13:58897 -> 10.0.1.13:1000
0,0,43,11,32,
1,0,35,8,27,
2,0,31,9,22,
3,0,28,9,19,
4,0,27,8,19,
5,0,26,8,18,
6,0,25,8,17,
7,0,27,9,18,
8,0,27,11,16,
9,0,28,12,16,
10,0,31,13,18,
11,0,27,12,15,
12,0,29,13,16,
13,0,29,12,17,
14,0,30,13,17,
15,0,30,12,18,
16,0,32,13,19,
17,0,29,12,17,
18,0,31,13,18,
19,0,28,11,17,
20,0,29,13,16,
21,0,29,12,17,
22,0,29,13,16,
23,0,29,13,16,
24,0,31,13,18,
25,0,30,13,17,
26,0,30,13,17,
27,0,29,11,18,
28,0,31,13,18,
29,0,30,12,18,
30,0,29,12,17,
31,0,30,12,18,
32,0,31,13,18,
33,0,30,12,18,
34,0,31,14,17,
35,0,30,11,19,
36,0,30,13,17,
37,0,31,13,18,
38,0,26,11,15,
39,0,28,13,15,
40,0,29,13,16,
41,0,28,13,15,
42,0,30,13,17,
43,0,27,10,17,
44,0,25,7,18,
45,0,23,6,17,
46,0,23,6,17,
47,0,24,7,17,
48,0,24,7,17,
49,0,24,6,18,
50,0,22,6,16,
51,0,22,7,15,
52,0,22,6,16,
53,0,26,7,19,
54,0,24,6,18,
55,0,24,7,17,
56,0,23,7,16,
57,0,21,6,15,
58,0,26,7,19,
59,0,24,7,17,
60,0,24,6,18,
61,0,24,7,17,
62,0,25,7,18,
63,0,25,7,18,
64,0,24,7,17,
65,0,23,7,16,
66,0,21,6,15,
67,0,24,7,17,
68,0,23,7,16,
69,0,24,7,17,
70,0,24,6,18,
71,0,24,6,18,
72,0,23,7,16,
73,0,22,6,16,
74,0,22,7,15,
75,0,23,7,16,
76,0,22,6,16,
77,0,24,6,18,
78,0,24,7,17,
79,0,22,6,16,
80,0,25,7,18,
81,0,24,7,17,
82,0,23,6,17,
83,0,23,6,17,
84,0,21,6,15,
85,0,24,7,17,
86,0,24,7,17,
87,0,23,7,16,
88,0,23,6,17,
89,0,25,6,19,
90,0,24,7,17,
91,0,22,6,16,
92,0,23,7,16,
93,0,23,6,17,
94,0,23,7,16,
95,0,25,7,18,
96,0,25,7,18,
97,0,24,6,18,
98,0,22,6,16,
99,0,24,7,17,
100,0,23,6,17,
101,0,24,7,17,
102,0,23,6,17,
103,0,24,7,17,
104,0,22,6,16,
105,0,23,7,16,
106,0,24,7,17,
107,0,22,6,16,
108,0,21,6,15,
109,0,25,8,17,
110,0,24,6,18,
111,0,23,6,17,
112,0,23,7,16,
113,0,24,7,17,
114,0,22,6,16,
115,0,23,6,17,
116,0,26,7,19,
117,0,23,6,17,
118,0,23,7,16,
119,0,24,6,18,
120,0,23,7,16,
121,0,23,6,17,
122,0,22,6,16,
123,0,23,7,16,
124,0,25,7,18,
125,0,23,6,17,
126,0,22,6,16,
127,0,26,8,18,
128,0,24,6,18,
129,0,23,6,17,
130,0,22,7,15,
131,0,23,7,16,
132,0,21,6,15,
133,0,25,8,17,
134,0,26,9,17,
135,0,22,6,16,
136,0,24,7,17,
137,0,26,7,19,
138,0,24,6,18,
139,0,23,7,16,
140,0,23,6,17,
141,0,24,6,18,
142,0,26,7,19,
143,0,22,6,16,
144,0,24,7,17,
145,0,21,6,15,
146,0,23,7,16,
147,0,22,7,15,
148,0,22,7,15,
149,0,23,7,16,
150,0,21,6,15,
151,0,25,7,18,
152,0,23,6,17,
153,0,22,6,16,
154,0,24,7,17,
155,0,22,6,16,
156,0,24,7,17,
157,0,25,7,18,
158,0,22,6,16,
159,0,23,7,16,
160,0,24,6,18,
161,0,24,6,18,
162,0,23,6,17,
163,0,25,7,18,
164,0,23,7,16,
165,0,24,7,17,
166,0,22,7,15,
167,0,25,6,19,
168,0,23,6,17,
169,0,26,7,19,
170,0,24,6,18,
171,0,23,7,16,
172,0,24,7,17,
173,0,22,6,16,
174,0,25,7,18,
175,0,24,6,18,
176,0,24,7,17,
177,0,25,7,18,
178,0,24,6,18,
179,0,23,7,16,
180,0,23,6,17,
181,0,22,6,16,
182,0,23,6,17,
183,0,25,7,18,
184,0,24,6,18,
185,0,25,7,18,
186,0,24,6,18,
187,0,26,7,19,
188,0,24,6,18,
189,0,23,7,16,
190,0,24,7,17,
191,0,22,6,16,
192,0,23,7,16,
193,0,22,6,16,
194,0,26,7,19,
195,0,23,6,17,
196,0,26,7,19,
197,0,24,6,18,
198,0,22,6,16,
199,0,24,7,17,
200,0,22,7,15,
201,0,22,7,15,
202,0,23,7,16,
203,0,23,8,15,
204,0,23,6,17,
205,0,22,6,16,
206,0,24,7,17,
207,0,23,7,16,
208,0,23,6,17,
209,0,22,6,16,
210,0,23,6,17,
211,0,25,7,18,
212,0,24,6,18,
213,0,23,6,17,
214,0,23,7,16,
215,0,22,6,16,
216,0,22,7,15,
217,0,22,6,16,
218,0,24,7,17,
219,0,21,6,15,
220,0,27,7,20,
221,0,24,6,18,
222,0,23,6,17,
223,0,26,7,19,
224,0,25,7,18,
225,0,27,9,18,
226,0,24,6,18,
227,0,24,7,17,
228,0,23,7,16,
229,0,23,7,16,
230,0,21,6,15,
231,0,23,7,16,
232,0,26,7,19,
233,0,23,6,17,
234,0,25,7,18,
235,0,24,6,18,
236,0,23,7,16,
237,0,24,7,17,
238,0,22,6,16,
239,0,21,6,15,
240,0,23,7,16,
241,0,21,6,15,
242,0,25,7,18,
243,0,23,6,17,
244,0,23,7,16,
245,0,23,6,17,
246,0,22,6,16,
247,0,26,8,18,
248,0,23,6,17,
249,0,23,7,16,
250,0,24,6,18,
251,0,25,6,19,
252,0,23,6,17,
253,0,24,7,17,
254,0,23,6,17,
255,0,25,8,17,
256,0,22,6,16,
257,0,23,7,16,
258,0,21,6,15,
259,0,23,7,16,
260,0,22,5,17,
261,0,24,7,17,
262,0,23,7,16,
263,0,23,6,17,
264,0,22,6,16,
265,0,25,7,18,
266,0,23,6,17,
267,0,24,7,17,
268,0,23,6,17,
269,0,22,6,16,
270,0,21,6,15,
271,0,23,7,16,
272,0,23,6,17,
273,0,24,6,18,
274,0,23,7,16,
275,0,24,7,17,
276,0,22,6,16,
277,0,24,7,17,
278,0,23,7,16,
279,0,23,6,17,
280,0,25,6,19,
281,0,24,6,18,
282,0,24,7,17,
283,0,22,6,16,
284,0,21,6,15,
285,0,23,7,16,
286,0,22,6,16,
287,0,22,7,15,
288,0,23,6,17,
289,0,23,6,17,
290,0,23,7,16,
291,0,23,6,17,
292,0,24,7,17,
293,0,22,6,16,
294,0,24,7,17,
295,0,23,7,16,
296,0,23,6,17,
297,0,25,7,18,
298,0,23,6,17,
299,0,23,7,16,
300,0,23,6,17,
301,0,21,6,15,
302,0,25,7,18,
303,0,24,6,18,
304,0,23,6,17,
305,0,23,7,16,
306,0,24,7,17,
307,0,23,6,17,
308,0,23,7,16,
309,0,26,8,18,
310,0,23,6,17,
311,0,24,7,17,
312,0,22,6,16,
313,0,23,6,17,
314,0,26,9,17,
315,0,26,8,18,
316,0,24,7,17,
317,0,23,6,17,
318,0,24,7,17,
319,0,24,6,18,
320,0,24,8,16,
321,0,23,7,16,
322,0,24,7,17,
323,0,23,7,16,
324,0,22,6,16,
325,0,21,6,15,
326,0,26,7,19,
327,0,24,7,17,
328,0,23,6,17,
329,0,22,6,16,
330,0,23,6,17,
331,0,25,7,18,
332,0,23,6,17,
333,0,23,7,16,
334,0,23,6,17,
335,0,25,6,19,
336,0,24,7,17,
337,0,24,7,17,
338,0,25,7,18,
339,0,24,7,17,
340,0,23,6,17,
341,0,24,7,17,
342,0,22,6,16,
343,0,24,7,17,
344,0,23,6,17,
345,0,22,6,16,
346,0,24,8,16,
347,0,24,8,16,
348,0,25,7,18,
349,0,24,6,18,
350,0,24,7,17,
351,0,23,7,16,
352,0,21,6,15,
353,0,24,7,17,
354,0,21,6,15,
355,0,24,7,17,
356,0,23,6,17,
357,0,24,8,16,
358,0,23,7,16,
359,0,24,7,17,
360,0,22,6,16,
361,0,25,7,18,
362,0,23,6,17,
363,0,21,6,15,
364,0,24,7,17,
365,0,24,6,18,
366,0,24,7,17,
367,0,25,7,18,
368,0,24,7,17,
369,0,22,6,16,
370,0,22,7,15,
371,0,23,7,16,
372,0,23,6,17,
373,0,23,6,17,
374,0,23,6,17,
375,0,23,6,17,
376,0,24,8,16,
377,0,24,7,17,
378,0,23,6,17,
379,0,23,7,16,
380,0,24,6,18,
381,0,23,6,17,
382,0,24,7,17,
383,0,24,7,17,
384,0,24,8,16,
385,0,23,6,17,
386,0,27,8,19,
387,0,23,6,17,
388,0,24,8,16,
389,0,23,6,17,
390,0,25,7,18,
391,0,24,6,18,
392,0,23,6,17,
393,0,23,7,16,
394,0,21,6,15,
395,0,22,7,15,
396,0,22,6,16,
397,0,21,6,15,
398,0,24,7,17,
399,0,22,6,16,
400,0,25,7,18,
401,0,23,6,17,
402,0,24,7,17,
403,0,22,6,16,
404,0,23,7,16,
405,0,23,6,17,
406,0,24,8,16,
407,0,23,8,15,
408,0,23,6,17,
409,0,22,6,16,
410,0,25,7,18,
411,0,23,6,17,
412,0,22,6,16,
413,0,24,7,17,
414,0,23,6,17,
415,0,23,7,16,
416,0,24,6,18,
417,0,25,7,18,
418,0,24,6,18,
419,0,24,7,17,
420,0,22,6,16,
421,0,22,6,16,
422,0,22,6,16,
423,0,26,8,18,
424,0,23,6,17,
425,0,23,7,16,
426,0,23,6,17,
427,0,25,6,19,
428,0,23,6,17,
429,0,25,7,18,
430,0,23,6,17,
431,0,22,6,16,
432,0,23,7,16,
433,0,24,7,17,
434,0,23,6,17,
435,0,23,7,16,
436,0,24,7,17,
437,0,27,8,19,
438,0,26,6,20,
439,0,24,6,18,
440,0,23,6,17,
441,0,26,8,18,
442,0,22,6,16,
443,0,22,6,16,
444,0,22,7,15,
445,0,25,7,18,
446,0,24,6,18,
447,0,23,6,17,
448,0,25,7,18,
449,0,25,8,17,
450,0,24,7,17,
451,0,22,6,16,
452,0,21,6,15,
453,0,22,7,15,
454,0,21,6,15,
455,0,22,7,15,
456,0,23,6,17,
457,0,22,6,16,
458,0,25,7,18,
459,0,24,7,17,
460,0,23,7,16,
461,0,24,7,17,
462,0,22,6,16,
463,0,23,6,17,
464,0,25,7,18,
465,0,23,6,17,
466,0,25,7,18,
467,0,24,6,18,
468,0,22,6,16,
469,0,21,6,15,
470,0,24,7,17,
471,0,22,6,16,
472,0,23,7,16,
473,0,23,6,17,
474,0,22,6,16,
475,0,24,7,17,
476,0,23,6,17,
477,0,22,6,16,
478,0,25,7,18,
479,0,25,7,18,
480,0,23,6,17,
481,0,23,7,16,
482,0,23,6,17,
483,0,22,6,16,
484,0,22,6,16,
485,0,25,7,18,
486,0,23,6,17,
487,0,22,6,16,
488,0,25,7,18,
489,0,25,7,18,
490,0,24,7,17,
491,0,24,7,17,
492,0,23,6,17,
493,0,21,6,15,
494,0,22,7,15,
495,0,26,7,19,
496,0,23,6,17,
497,0,27,9,18,
498,0,23,7,16,
499,0,23,6,17,
500,0,25,7,18,
501,0,23,7,16,
502,0,23,6,17,
503,0,22,6,16,
504,0,24,6,18,
505,0,22,6,16,
506,0,25,8,17,
507,0,24,7,17,
508,0,24,6,18,
509,0,22,7,15,
510,0,22,7,15,
511,0,24,6,18,
512,0,24,6,18,
513,0,23,6,17,
514,0,22,6,16,
515,0,24,7,17,
516,0,22,6,16,
517,0,23,7,16,
518,0,24,6,18,
519,0,23,6,17,
520,0,23,7,16,
521,0,21,6,15,
522,0,23,7,16,
523,0,22,6,16,
524,0,24,7,17,
525,0,22,6,16,
526,0,23,7,16,
527,0,24,6,18,
528,0,24,7,17,
529,0,23,7,16,
530,0,23,6,17,
531,0,25,7,18,
532,0,24,6,18,
533,0,23,6,17,
534,0,23,7,16,
535,0,23,7,16,
536,0,22,6,16,
537,0,23,7,16,
538,0,22,6,16,
539,0,23,7,16,
540,0,25,8,17,
541,0,23,6,17,
542,0,22,6,16,
543,0,24,7,17,
544,0,25,8,17,
545,0,22,6,16,
546,0,24,7,17,
547,0,29,10,19,
548,0,25,7,18,
549,0,28,9,19,
550,0,28,10,18,
551,0,24,8,16,
552,0,23,8,15,
553,0,24,8,16,
554,0,25,9,16,
555,0,24,9,15,
556,0,23,8,15,
557,0,25,9,16,
558,0,23,8,15,
559,0,23,7,16,
560,0,23,7,16,
561,0,23,6,17,
562,0,25,7,18,
563,0,24,6,18,
564,0,23,7,16,
565,0,23,7,16,
566,0,24,7,17,
567,0,21,6,15,
568,0,22,7,15,
569,0,23,6,17,
570,0,22,6,16,
571,0,23,7,16,
572,0,23,6,17,
573,0,22,6,16,
574,0,24,7,17,
575,0,22,6,16,
576,0,25,7,18,
577,0,24,6,18,
578,0,23,6,17,
579,0,24,7,17,
580,0,23,7,16,
581,0,23,8,15,
582,0,25,7,18,
583,0,23,6,17,
584,0,25,7,18,
585,0,23,7,16,
586,0,23,6,17,
587,0,22,6,16,
588,0,28,9,19,
589,0,24,6,18,
590,0,23,6,17,
591,0,22,7,15,
592,0,23,7,16,
593,0,22,6,16,
594,0,22,7,15,
595,0,23,6,17,
596,0,24,7,17,
597,0,24,7,17,
598,0,23,7,16,
599,0,23,6,17,
600,0,23,7,16,
601,0,24,7,17,
602,0,23,6,17,
603,0,23,6,17,
604,0,25,7,18,
605,0,23,6,17,
606,0,22,6,16,
607,0,24,7,17,
608,0,24,6,18,
609,0,24,7,17,
610,0,24,7,17,
611,0,24,7,17,
612,0,25,7,18,
613,0,22,6,16,
614,0,25,7,18,
615,0,24,7,17,
616,0,22,6,16,
617,0,24,7,17,
618,0,23,6,17,
619,0,26,8,18,
620,0,22,6,16,
621,0,23,7,16,
622,0,24,6,18,
623,0,26,8,18,
624,0,24,6,18,
625,0,24,6,18,
626,0,23,6,17,
627,0,25,7,18,
628,0,24,6,18,
629,0,23,6,17,
630,0,24,7,17,
631,0,24,7,17,
632,0,24,6,18,
633,0,22,6,16,
634,0,24,7,17,
635,0,22,6,16,
636,0,24,7,17,
637,0,22,7,15,
638,0,23,6,17,
639,0,22,6,16,
640,0,24,7,17,
641,0,23,6,17,
642,0,22,6,16,
643,0,24,7,17,
644,0,23,6,17,
645,0,25,7,18,
646,0,24,7,17,
647,0,21,6,15,
648,0,23,7,16,
649,0,22,6,16,
650,0,22,7,15,
651,0,23,6,17,
652,0,22,6,16,
653,0,23,7,16,
654,0,23,6,17,
655,0,22,6,16,
656,0,23,7,16,
657,0,24,7,17,
658,0,23,6,17,
659,0,23,7,16,
660,0,24,6,18,
661,0,25,7,18,
662,0,24,7,17,
663,0,24,6,18,
664,0,22,6,16,
665,0,24,7,17,
666,0,23,6,17,
667,0,23,7,16,
668,0,23,6,17,
669,0,22,6,16,
670,0,26,7,19,
671,0,25,7,18,
672,0,23,6,17,
673,0,23,7,16,
674,0,22,6,16,
675,0,22,7,15,
676,0,22,6,16,
677,0,24,7,17,
678,0,24,6,18,
679,0,28,9,19,
680,0,23,6,17,
681,0,26,7,19,
682,0,25,7,18,
683,0,24,7,17,
684,0,22,6,16,
685,0,22,7,15,
686,0,22,7,15,
687,0,23,7,16,
688,0,25,7,18,
689,0,24,6,18,
690,0,24,6,18,
691,0,23,7,16,
692,0,25,7,18,
693,0,23,6,17,
694,0,24,6,18,
695,0,25,7,18,
696,0,23,6,17,
697,0,23,6,17,
698,0,21,6,15,
699,0,23,7,16,
700,0,21,6,15,
701,0,24,7,17,
702,0,24,7,17,
703,0,23,7,16,
704,0,22,6,16,
705,0,24,7,17,
706,0,23,6,17,
707,0,23,7,16,
708,0,25,7,18,
709,0,23,6,17,
710,0,24,8,16,
711,0,23,6,17,
712,0,23,6,17,
713,0,21,6,15,
714,0,23,7,16,
715,0,25,7,18,
716,0,23,7,16,
717,0,23,6,17,
718,0,21,6,15,
719,0,25,7,18,
720,0,24,6,18,
721,0,24,7,17,
722,0,23,7,16,
723,0,23,6,17,
724,0,23,6,17,
725,0,24,6,18,
726,0,24,6,18,
727,0,25,7,18,
728,0,23,6,17,
729,0,26,7,19,
730,0,24,6,18,
731,0,24,7,17,
732,0,24,7,17,
733,0,23,6,17,
734,0,23,7,16,
735,0,23,6,17,
736,0,22,6,16,
737,0,24,7,17,
738,0,23,6,17,
739,0,24,7,17,
740,0,24,7,17,
741,0,24,6,18,
742,0,24,6,18,
743,0,24,7,17,
744,0,23,6,17,
745,0,23,6,17,
746,0,24,7,17,
747,0,22,6,16,
748,0,27,7,20,
749,0,23,6,17,
750,0,25,7,18,
751,0,22,6,16,
752,0,23,7,16,
753,0,24,7,17,
754,0,23,6,17,
755,0,23,7,16,
756,0,24,6,18,
757,0,23,6,17,
758,0,23,7,16,
759,0,22,6,16,
760,0,21,6,15,
761,0,23,7,16,
762,0,22,7,15,
763,0,23,8,15,
764,0,24,6,18,
765,0,23,6,17,
766,0,25,7,18,
767,0,23,6,17,
768,0,24,6,18,
769,0,22,6,16,
770,0,26,8,18,
771,0,25,7,18,
772,0,24,6,18,
773,0,25,8,17,
774,0,23,7,16,
775,0,22,6,16,
776,0,23,7,16,
777,0,25,7,18,
778,0,23,7,16,
779,0,23,7,16,
780,0,24,7,17,
781,0,22,6,16,
782,0,23,7,16,
783,0,26,7,19,
784,0,24,6,18,
785,0,24,7,17,
786,0,22,6,16,
787,0,21,6,15,
788,0,23,7,16,
789,0,21,6,15,
790,0,22,7,15,
791,0,23,6,17,
792,0,23,7,16,
793,0,26,8,18,
794,0,23,6,17,
795,0,23,7,16,
796,0,23,6,17,
797,0,22,6,16,
798,0,25,7,18,
799,0,25,7,18,
800,0,25,7,18,
801,0,22,6,16,
802,0,22,6,16,
803,0,23,7,16,
804,0,24,6,18,
805,0,21,6,15,
806,0,26,7,19,
807,0,24,6,18,
808,0,24,6,18,
809,0,23,7,16,
810,0,26,7,19,
811,0,24,6,18,
812,0,25,7,18,
813,0,23,6,17,
814,0,24,7,17,
815,0,25,7,18,
816,0,24,6,18,
817,0,23,6,17,
818,0,24,7,17,
819,0,24,6,18,
820,0,22,6,16,
821,0,23,6,17,
822,0,25,7,18,
823,0,23,6,17,
824,0,23,7,16,
825,0,23,6,17,
826,0,22,7,15,
827,0,24,7,17,
828,0,23,6,17,
829,0,24,7,17,
830,0,22,6,16,
831,0,25,7,18,
832,0,22,6,16,
833,0,23,7,16,
834,0,24,6,18,
835,0,23,6,17,
836,0,23,7,16,
837,0,25,8,17,
838,0,21,6,15,
839,0,23,7,16,
840,0,21,6,15,
841,0,24,7,17,
842,0,23,6,17,
843,0,24,7,17,
844,0,24,7,17,
845,0,23,7,16,
846,0,24,6,18,
847,0,24,7,17,
848,0,23,6,17,
849,0,23,7,16,
850,0,23,6,17,
851,0,22,6,16,
852,0,26,8,18,
853,0,25,7,18,
854,0,24,6,18,
855,0,23,6,17,
856,0,23,7,16,
857,0,21,6,15,
858,0,22,7,15,
859,0,22,6,16,
860,0,22,7,15,
861,0,25,8,17,
862,0,22,6,16,
863,0,25,7,18,
864,0,24,6,18,
865,0,23,6,17,
866,0,25,7,18,
867,0,24,7,17,
868,0,23,7,16,
869,0,24,7,17,
870,0,23,6,17,
871,0,25,7,18,
872,0,24,6,18,
873,0,24,7,17,
874,0,22,6,16,
875,0,22,6,16,
876,0,23,7,16,
877,0,23,6,17,
878,0,23,7,16,
879,0,25,7,18,
880,0,23,6,17,
881,0,25,7,18,
882,0,23,6,17,
883,0,22,6,16,
884,0,24,7,17,
885,0,23,6,17,
886,0,24,7,17,
887,0,22,6,16,
888,0,23,6,17,
889,0,28,11,17,
890,0,30,12,18,
891,0,27,9,18,
892,0,29,11,18,
893,0,28,11,17,
894,0,33,14,19,
895,0,30,12,18,
896,0,28,11,17,
897,0,31,13,18,
898,0,31,13,18,
899,0,29,13,16,
900,0,32,13,19,
901,0,28,11,17,
902,0,30,13,17,
903,0,29,13,16,
904,0,30,13,17,
905,0,31,11,20,
906,0,24,8,16,
907,0,29,12,17,
908,0,28,13,15,
909,0,29,13,16,
910,0,31,12,19,
911,0,31,13,18,
912,0,29,11,17,1
913,0,21,6,15,
914,0,25,7,18,
915,0,25,7,18,
916,0,24,6,18,
917,0,22,6,16,
918,0,25,7,18,
919,0,25,6,19,
920,0,26,8,17,1
921,0,24,6,18,
922,0,23,6,17,
923,0,24,7,17,
924,0,25,7,18,
925,0,24,7,17,
926,0,25,8,17,
927,0,23,7,15,1
928,0,22,6,16,
929,0,23,8,15,
930,0,22,7,15,
931,0,23,6,17,
932,0,24,7,17,
933,0,23,6,17,
934,0,25,8,17,
935,0,22,6,16,
936,0,25,7,18,
937,0,24,7,17,
938,0,23,6,17,
939,0,23,6,17,
940,0,23,7,16,
941,0,23,6,17,
942,0,26,7,18,1
943,0,22,6,16,
944,0,25,7,18,
945,0,22,6,16,
946,0,24,7,17,
947,0,22,6,16,
948,0,25,7,18,
949,0,25,6,19,
950,0,24,7,17,
951,0,25,7,18,
952,0,25,8,17,
953,0,22,6,16,
954,0,27,7,20,
955,0,24,7,17,
956,0,24,6,18,
957,0,23,6,17,
958,0,25,7,17,1
959,0,23,7,16,
960,0,22,6,16,
961,0,25,7,18,
962,0,22,6,16,
963,0,21,6,15,
964,0,24,7,17,
965,0,24,6,18,
966,0,24,6,18,
967,0,24,8,16,
968,0,23,7,16,
969,0,21,6,15,
970,0,25,7,18,
971,0,24,6,18,
972,0,22,6,16,
973,0,24,7,17,
974,0,24,6,18,
975,0,22,7,15,
976,0,24,6,18,
977,0,22,6,16,
978,0,24,7,17,
979,0,22,6,16,
980,0,23,7,16,
981,0,24,6,18,
982,0,25,8,17,
983,0,23,6,17,
984,0,23,7,16,
985,0,23,7,16,
986,0,23,6,17,
987,0,24,7,17,
988,0,26,7,18,1
989,0,24,7,17,
990,0,22,6,16,
991,0,25,7,18,
992,0,24,6,18,
993,0,24,6,18,
994,0,23,7,16,
995,0,22,6,16,
996,0,23,7,16,
997,0,21,5,16,
998,0,23,7,16,
999,0,25,7,18,
1000,0,25,6,19,
1001,0,23,6,17,
1002,0,25,7,18,
1003,0,23,6,17,
1004,0,23,7,16,
1005,0,24,6,18,
1006,0,24,6,18,
1007,0,22,6,16,
1008,0,25,7,18,
1009,0,23,6,17,
1010,0,23,6,17,
1011,0,24,7,17,
1012,0,22,7,15,
1013,0,22,6,16,
1014,0,22,7,15,
1015,0,23,6,17,
1016,0,22,6,16,
1017,0,25,7,18,
1018,0,23,6,16,1
1019,0,24,7,17,
1020,0,24,7,17,
1021,0,23,6,17,
1022,0,23,6,17,
1023,0,25,7,18,
1024,0,24,7,17,
1025,0,23,7,16,
1026,0,21,6,15,
1027,0,24,7,17,
1028,0,23,7,16,
1029,0,26,7,19,
1030,0,25,8,17,
1031,0,23,7,16,
1032,0,23,6,17,
1033,0,22,6,16,
1034,0,25,7,18,
1035,0,26,7,19,
1036,0,24,6,18,
1037,0,23,6,17,
1038,0,24,7,17,
1039,0,23,6,17,
1040,0,22,6,16,
1041,0,22,7,15,
1042,0,23,6,17,
1043,0,23,7,16,
1044,0,25,7,18,
1045,0,23,7,16,
1046,0,23,7,16,
1047,0,24,7,17,
1048,0,23,6,17,
1049,0,24,7,16,1
1050,0,24,6,18,
1051,0,23,7,16,
1052,0,23,6,17,
1053,0,26,7,19,
1054,0,23,6,17,
1055,0,23,7,16,
1056,0,21,6,15,
1057,0,22,7,15,
1058,0,22,6,16,
1059,0,22,7,15,
1060,0,23,6,17,
1061,0,23,6,17,
1062,0,24,6,18,
1063,0,22,6,16,
1064,0,24,7,17,
1065,0,22,6,16,
1066,0,23,7,16,
1067,0,24,6,18,
1068,0,24,7,17,
1069,0,24,6,18,
1070,0,22,6,16,
1071,0,25,7,18,
1072,0,24,6,18,
1073,0,26,8,18,
1074,0,23,6,17,
1075,0,23,7,16,
1076,0,22,6,16,
1077,0,22,7,15,
1078,0,22,6,16,
1079,0,23,7,15,1
1080,0,26,8,18,
1081,0,23,6,17,
1082,0,22,6,16,
1083,0,24,7,17,
1084,0,24,6,18,
1085,0,23,7,16,
1086,0,22,7,15,
1087,0,22,6,16,
1088,0,21,6,15,
1089,0,25,7,18,
1090,0,23,6,17,
1091,0,22,6,16,
1092,0,24,7,17,
1093,0,23,6,17,
1094,0,23,7,16,
1095,0,23,6,17,
1096,0,22,6,16,
1097,0,25,7,18,
1098,0,24,6,18,
1099,0,23,6,17,
1100,0,23,7,16,
1101,0,21,6,15,
1102,0,24,7,17,
1103,0,24,6,18,
1104,0,23,7,16,
1105,0,22,5,17,
1106,0,25,7,18,
1107,0,23,6,17,
1108,0,22,6,16,
1109,0,25,7,17,1
1110,0,22,6,16,
1111,0,25,7,18,
1112,0,24,6,18,
1113,0,23,7,16,
1114,0,23,6,17,
1115,0,23,7,16,
1116,0,25,7,18,
1117,0,22,6,16,
1118,0,25,7,18,
1119,0,23,6,17,
1120,0,24,7,17,
1121,0,22,6,16,
1122,0,22,7,15,
1123,0,22,6,16,
1124,0,21,6,15,
1125,0,24,7,17,
1126,0,24,7,17,
1127,0,23,6,17,
1128,0,23,6,17,
1129,0,25,7,18,
1130,0,23,6,17,
1131,0,23,7,16,
1132,0,24,6,18,
1133,0,24,7,17,
1134,0,26,8,18,
1135,0,23,6,17,
1136,0,23,7,16,
1137,0,23,7,16,
1138,0,23,6,17,
1139,0,23,7,16,
1140,0,26,8,17,1
1141,0,25,7,18,
1142,0,23,7,16,
1143,0,23,6,17,
1144,0,22,6,16,
1145,0,24,7,17,
1146,0,23,6,17,
1147,0,25,7,18,
1148,0,22,6,16,
1149,0,25,8,17,
1150,0,24,7,17,
1151,0,24,6,18,
1152,0,23,6,17,
1153,0,21,6,15,
1154,0,23,7,16,
1155,0,22,6,16,
1156,0,24,7,17,
1157,0,21,6,15,
1158,0,24,7,17,
1159,0,24,6,18,
1160,0,26,7,19,
1161,0,24,6,18,
1162,0,23,6,17,
1163,0,22,6,16,
1164,0,23,7,16,
1165,0,23,6,17,
1166,0,25,7,18,
1167,0,23,6,17,
1168,0,25,7,18,
1169,0,23,7,16,
1170,0,26,7,18,1
1171,0,24,7,17,
1172,0,25,7,18,
1173,0,21,5,16,
1174,0,23,7,16,
1175,0,21,6,15,
1176,0,24,7,17,
1177,0,23,6,17,
1178,0,24,8,16,
1179,0,23,6,17,
1180,0,23,7,16,
1181,0,23,6,17,
1182,0,23,6,17,
1183,0,22,7,15,
1184,0,22,6,16,
1185,0,21,6,15,
1186,0,26,8,18,
1187,0,24,6,18,
1188,0,23,6,17,
1189,0,23,7,16,
1190,0,23,7,16,
1191,0,23,6,17,
1192,0,23,6,17,
1193,0,22,7,15,
1194,0,22,6,16,
1195,0,21,6,15,
1196,0,25,7,18,
1197,0,26,7,19,
1198,0,24,6,18,
1199,0,24,7,17,
1200,0,23,6,16,1
1201,0,25,7,18,
1202,0,22,6,16,
1203,0,23,7,16,
1204,0,21,6,15,
1205,0,25,7,18,
1206,0,23,6,17,
1207,0,23,7,16,
1208,0,23,6,17,
1209,0,22,6,16,
1210,0,25,7,18,
1211,0,22,6,16,
1212,0,23,7,16,
1213,0,25,7,18,
1214,0,23,6,17,
1215,0,23,8,15,
1216,0,25,6,19,
1217,0,25,7,18,
1218,0,23,6,17,
1219,0,24,7,17,
1220,0,22,6,16,
1221,0,21,6,15,
1222,0,22,7,15,
1223,0,22,6,16,
1224,0,22,7,15,
1225,0,24,7,17,
1226,0,24,7,17,
1227,0,25,7,18,
1228,0,22,6,16,
1229,0,26,9,17,
1230,0,24,7,17,
1231,0,26,7,18,1
1232,0,26,8,18,
1233,0,24,6,18,
1234,0,24,7,17,
1235,0,22,6,16,
1236,0,21,6,15,
1237,0,22,7,15,
1238,0,26,7,19,
1239,0,24,6,18,
1240,0,24,7,17,
1241,0,24,6,18,
1242,0,21,6,15,
1243,0,23,6,17,
1244,0,25,7,18,
1245,0,23,6,17,
1246,0,23,7,16,
1247,0,22,6,16,
1248,0,25,7,18,
1249,0,23,6,17,
1250,0,21,6,15,
1251,0,23,7,16,
1252,0,23,6,17,
1253,0,24,6,18,
1254,0,23,7,16,
1255,0,24,8,16,
1256,0,24,7,17,
1257,0,23,7,16,
1258,0,21,6,15,
1259,0,23,7,16,
1260,0,22,6,16,
1261,0,23,7,15,1
1262,0,24,7,17,
1263,0,23,6,17,
1264,0,23,6,17,
1265,0,23,7,16,
1266,0,23,6,17,
1267,0,23,7,16,
1268,0,25,7,18,
1269,0,23,6,17,
1270,0,24,6,18,
1271,0,22,6,16,
1272,0,24,7,17,
1273,0,23,6,17,
1274,0,23,7,16,
1275,0,23,6,17,
1276,0,22,6,16,
1277,0,25,7,18,
1278,0,23,6,17,
1279,0,23,7,16,
1280,0,21,6,15,
1281,0,22,7,15,
1282,0,22,6,16,
1283,0,21,6,15,
1284,0,24,7,17,
1285,0,22,6,16,
1286,0,23,6,17,
1287,0,24,7,17,
1288,0,23,7,16,
1289,0,24,8,16,
1290,0,24,7,17,
1291,0,23,6,16,1
1292,0,24,7,17,
1293,0,23,7,16,
1294,0,23,6,17,
1295,0,21,6,15,
1296,0,24,7,17,
1297,0,21,6,15,
1298,0,23,7,16,
1299,0,21,6,15,
1300,0,22,7,15,
1301,0,23,6,17,
1302,0,24,7,17,
1303,0,23,7,16,
1304,0,23,6,17,
1305,0,25,7,18,
1306,0,23,6,17,
1307,0,24,7,17,
1308,0,23,6,17,
1309,0,25,7,18,
1310,0,22,6,16,
1311,0,23,7,16,
1312,0,23,6,17,
1313,0,22,6,16,
1314,0,23,7,16,
1315,0,25,8,17,
1316,0,23,6,17,
1317,0,23,6,17,
1318,0,24,7,17,
1319,0,23,6,17,
1320,0,23,7,16,
1321,0,23,6,17,
1322,0,24,7,16,1
1323,0,24,7,17,
1324,0,26,6,20,
1325,0,24,6,18,
1326,0,23,6,17,
1327,0,23,7,16,
1328,0,22,6,16,
1329,0,22,7,15,
1330,0,22,6,16,
1331,0,21,6,15,
1332,0,24,7,17,
1333,0,23,6,17,
1334,0,24,6,18,
1335,0,25,7,18,
1336,0,24,7,17,
1337,0,23,7,16,
1338,0,25,8,17,
1339,0,24,6,18,
1340,0,23,6,17,
1341,0,26,8,18,
1342,0,24,6,18,
1343,0,22,6,16,
1344,0,24,7,17,
1345,0,23,6,17,
1346,0,24,8,16,
1347,0,22,6,16,
1348,0,21,6,15,
1349,0,23,7,16,
1350,0,24,7,17,
1351,0,22,6,16,
1352,0,22,6,15,1
1353,0,24,8,16,
1354,0,24,7,17,
1355,0,23,6,17,
1356,0,23,7,16,
1357,0,23,6,17,
1358,0,24,7,17,
1359,0,25,7,18,
1360,0,24,6,18,
1361,0,23,6,17,
1362,0,22,6,16,
1363,0,22,7,15,
1364,0,22,6,16,
1365,0,22,7,15,
1366,0,24,7,17,
1367,0,22,6,16,
1368,0,25,8,17,
1369,0,24,6,18,
1370,0,23,6,17,
1371,0,25,7,18,
1372,0,23,6,17,
1373,0,21,6,15,
1374,0,22,7,15,
1375,0,23,6,17,
1376,0,24,6,18,
1377,0,22,6,16,
1378,0,23,7,16,
1379,0,24,7,17,
1380,0,22,6,16,
1381,0,24,7,17,
1382,0,25,7,17,1
1383,0,23,7,16,
1384,0,23,6,17,
1385,0,24,6,18,
1386,0,23,6,17,
1387,0,23,7,16,
1388,0,25,8,17,
1389,0,24,6,18,
1390,0,22,6,16,
1391,0,23,7,16,
1392,0,23,6,17,
1393,0,23,7,16,
1394,0,23,6,17,
1395,0,25,7,18,
1396,0,23,6,17,
1397,0,23,7,16,
1398,0,23,6,17,
1399,0,24,7,17,
1400,0,25,7,18,
1401,0,32,12,20,
1402,0,30,13,17,
1403,0,29,12,17,
1404,0,29,12,17,
1405,0,30,12,18,
1406,0,30,13,17,
1407,0,30,12,18,
1408,0,31,12,19,
1409,0,31,13,18,
1410,0,28,9,19,
1411,0,26,8,18,
1412,0,23,6,17,
1413,0,25,9,15,1
1414,0,25,7,18,
1415,0,23,6,17,
1416,0,26,7,19,
1417,0,23,7,16,
1418,0,22,6,16,
1419,0,24,7,17,
1420,0,23,6,17,
1421,0,24,7,17,
1422,0,24,6,18,
1423,0,23,6,17,
1424,0,25,7,18,
1425,0,26,7,19,
1426,0,23,6,17,
1427,0,25,7,18,
1428,0,22,6,16,
1429,0,25,7,18,
1430,0,23,6,17,
1431,0,25,7,18,
1432,0,24,6,18,
1433,0,23,6,17,
1434,0,26,7,19,
1435,0,24,6,18,
1436,0,22,6,16,
1437,0,24,7,17,
1438,0,23,6,17,
1439,0,24,7,17,
1440,0,25,7,18,
1441,0,24,7,17,
1442,0,22,6,16,
1443,0,27,8,18,1
1444,0,23,6,17,
1445,0,21,6,15,
1446,0,23,7,16,
1447,0,21,6,15,
1448,0,23,7,16,
1449,0,24,6,18,
1450,0,22,6,16,
1451,0,23,7,16,
1452,0,21,5,16,
1453,0,23,7,16,
1454,0,27,7,20,
1455,0,23,7,16,
1456,0,23,7,16,
1457,0,24,7,17,
1458,0,23,6,17,
1459,0,26,8,18,
1460,0,24,6,18,
1461,0,24,6,18,
1462,0,23,7,16,
1463,0,23,6,17,
1464,0,23,6,17,
1465,0,23,6,17,
1466,0,24,7,17,
1467,0,23,7,16,
1468,0,23,6,17,
1469,0,24,6,18,
1470,0,24,6,18,
1471,0,25,8,17,
1472,0,22,6,16,
1473,0,22,7,15,
1474,0,24,7,16,1
1475,0,23,6,17,
1476,0,24,7,17,
1477,0,24,6,18,
1478,0,22,6,16,
1479,0,24,8,16,
1480,0,22,7,15,
1481,0,23,6,17,
1482,0,22,6,16,
1483,0,22,7,15,
1484,0,23,6,17,
1485,0,23,6,17,
1486,0,24,7,17,
1487,0,22,6,16,
1488,0,24,7,17,
1489,0,23,7,16,
1490,0,24,7,17,
1491,0,22,7,15,
1492,0,22,6,16,
1493,0,25,7,18,
1494,0,24,6,18,
1495,0,24,7,17,
1496,0,24,6,18,
1497,0,27,9,18,
1498,0,23,6,17,
1499,0,24,7,17,
1500,0,25,7,18,
1501,0,23,6,17,
1502,0,24,7,17,
1503,0,22,7,15,
1504,0,23,7,15,1
1505,0,22,6,16,
1506,0,24,6,18,
1507,0,24,7,17,
1508,0,24,6,18,
1509,0,25,7,18,
1510,0,22,6,16,
1511,0,24,7,17,
1512,0,24,7,17,
1513,0,23,6,17,
1514,0,24,6,18,
1515,0,26,7,19,
1516,0,24,7,17,
1517,0,24,6,18,
1518,0,23,6,17,
1519,0,24,7,17,
1520,0,23,7,16,
1521,0,22,6,16,
1522,0,22,7,15,
1523,0,22,6,16,
1524,0,22,6,16,
1525,0,22,7,15,
1526,0,23,6,17,
1527,0,22,6,16,
1528,0,23,7,16,
1529,0,23,7,16,
1530,0,23,7,16,
1531,0,23,6,17,
1532,0,25,8,17,
1533,0,26,6,20,
1534,0,25,6,18,1
1535,0,24,8,16,
1536,0,23,7,16,
1537,0,24,7,17,
1538,0,22,6,16,
1539,0,23,7,16,
1540,0,23,6,17,
1541,0,22,6,16,
1542,0,25,7,18,
1543,0,23,6,17,
1544,0,23,7,16,
1545,0,25,7,18,
1546,0,23,6,17,
1547,0,24,7,17,
1548,0,22,6,16,
1549,0,23,7,16,
1550,0,25,7,18,
1551,0,24,6,18,
1552,0,24,7,17,
1553,0,21,5,16,
1554,0,25,7,18,
1555,0,22,7,15,
1556,0,23,6,17,
1557,0,22,6,16,
1558,0,24,7,17,
1559,0,23,6,17,
1560,0,22,6,16,
1561,0,24,7,17,
1562,0,22,6,16,
1563,0,23,7,16,
1564,0,24,7,17,
1565,0,25,6,18,1
1566,0,24,7,17,
1567,0,23,6,17,
1568,0,23,6,17,
1569,0,21,6,15,
1570,0,25,7,18,
1571,0,24,7,17,
1572,0,24,6,18,
1573,0,24,7,17,
1574,0,23,7,16,
1575,0,22,6,16,
1576,0,22,7,15,
1577,0,23,7,16,
1578,0,21,6,15,
1579,0,24,7,17,
1580,0,23,6,17,
1581,0,24,8,16,
1582,0,23,6,17,
1583,0,22,6,16,
1584,0,25,7,18,
1585,0,23,6,17,
1586,0,22,6,16,
1587,0,25,7,18,
1588,0,24,7,17,
1589,0,23,6,17,
1590,0,25,7,18,
1591,0,26,7,19,
1592,0,23,6,17,
1593,0,22,6,16,
1594,0,25,7,18,
1595,0,26,7,18,1
1596,0,25,7,18,
1597,0,25,8,17,
1598,0,25,7,18,
1599,0,22,6,16,
1600,0,25,8,17,
1601,0,23,6,17,
1602,0,23,6,17,
1603,0,23,7,16,
1604,0,24,6,18,
1605,0,25,7,18,
1606,0,22,6,16,
1607,0,22,6,16,
1608,0,24,7,17,
1609,0,23,6,17,
1610,0,25,7,18,
1611,0,23,7,16,
1612,0,26,8,18,
1613,0,23,7,16,
1614,0,24,6,18,
1615,0,23,6,17,
1616,0,23,7,16,
1617,0,21,6,15,
1618,0,22,7,15,
1619,0,22,6,16,
1620,0,21,6,15,
1621,0,25,7,18,
1622,0,23,6,17,
1623,0,23,7,16,
1624,0,23,6,17,
1625,0,25,7,17,1
1626,0,24,7,17,
1627,0,24,7,17,
1628,0,24,6,18,
1629,0,22,6,16,
1630,0,25,7,18,
1631,0,24,7,17,
1632,0,23,7,16,
1633,0,23,6,17,
1634,0,22,6,16,
1635,0,24,7,17,
1636,0,24,6,18,
1637,0,24,7,17,
1638,0,24,6,18,
1639,0,22,6,16,
1640,0,22,7,15,
1641,0,23,6,17,
1642,0,24,6,18,
1643,0,22,6,16,
1644,0,23,7,16,
1645,0,24,8,16,
1646,0,23,7,16,
1647,0,23,6,17,
1648,0,22,6,16,
1649,0,23,7,16,
1650,0,24,6,18,
1651,0,24,8,16,
1652,0,25,7,18,
1653,0,23,6,17,
1654,0,25,7,18,
1655,0,23,6,17,
1656,0,27,7,19,1
1657,0,24,6,18,
1658,0,24,6,18,
1659,0,22,6,16,
1660,0,24,7,17,
1661,0,25,7,18,
1662,0,23,7,16,
1663,0,24,6,18,
1664,0,23,6,17,
1665,0,23,6,17,
1666,0,22,7,15,
1667,0,22,6,16,
1668,0,21,6,15,
1669,0,24,7,17,
1670,0,23,6,17,
1671,0,24,8,16,
1672,0,23,7,16,
1673,0,23,6,17,
1674,0,23,6,17,
1675,0,24,7,17,
1676,0,22,6,16,
1677,0,23,6,17,
1678,0,25,7,18,
1679,0,24,7,17,
1680,0,23,7,16,
1681,0,23,6,17,
1682,0,23,7,16,
1683,0,25,7,18,
1684,0,23,6,17,
1685,0,24,7,17,
1686,0,23,6,16,1
1687,0,25,7,18,
1688,0,26,8,18,
1689,0,22,6,16,
1690,0,22,7,15,
1691,0,24,7,17,
1692,0,23,6,17,
1693,0,23,6,17,
1694,0,23,7,16,
1695,0,24,7,17,
1696,0,22,6,16,
1697,0,24,7,17,
1698,0,23,6,17,
1699,0,22,7,15,
1700,0,23,6,17,
1701,0,25,6,19,
1702,0,24,7,17,
1703,0,24,6,18,
1704,0,24,7,17,
1705,0,25,7,18,
1706,0,22,6,16,
1707,0,24,7,17,
1708,0,23,6,17,
1709,0,23,6,17,
1710,0,23,7,16,
1711,0,24,6,18,
1712,0,25,7,18,
1713,0,23,6,17,
1714,0,22,6,16,
1715,0,24,7,17,
1716,0,27,7,19,1
1717,0,24,6,18,
1718,0,22,6,16,
1719,0,24,7,17,
1720,0,23,6,17,
1721,0,25,7,18,
1722,0,24,7,17,
1723,0,24,7,17,
1724,0,23,7,16,
1725,0,23,6,17,
1726,0,23,6,17,
1727,0,21,6,15,
1728,0,24,7,17,
1729,0,23,6,17,
1730,0,23,7,16,
1731,0,23,7,16,
1732,0,24,7,17,
1733,0,22,6,16,
1734,0,24,7,17,
1735,0,22,6,16,
1736,0,23,7,16,
1737,0,22,7,15,
1738,0,24,7,17,
1739,0,23,6,17,
1740,0,23,6,17,
1741,0,23,7,16,
1742,0,24,7,17,
1743,0,22,6,16,
1744,0,26,7,19,
1745,0,24,6,18,
1746,0,23,6,17,
1747,0,25,7,17,1
1748,0,24,6,18,
1749,0,23,7,16,
1750,0,21,6,15,
1751,0,23,7,16,
1752,0,23,6,17,
1753,0,22,6,16,
1754,0,21,6,15,
1755,0,25,7,18,
1756,0,23,6,17,
1757,0,23,7,16,
1758,0,23,6,17,
1759,0,23,6,17,
1760,0,23,7,16,
1761,0,23,6,17,
1762,0,23,7,16,
1763,0,25,7,18,
1764,0,24,7,17,
1765,0,23,6,17,
1766,0,22,6,16,
1767,0,24,7,17,
1768,0,25,6,19,
1769,0,24,6,18,
1770,0,25,8,17,
1771,0,23,6,17,
1772,0,23,6,17,
1773,0,25,7,18,
1774,0,22,6,16,
1775,0,24,7,17,
1776,0,23,6,17,
1777,0,26,7,18,1
1778,0,22,6,16,
1779,0,26,8,18,
1780,0,26,7,19,
1781,0,24,6,18,
1782,0,22,6,16,
1783,0,22,7,15,
1784,0,24,7,17,
1785,0,23,6,17,
1786,0,23,6,17,
1787,0,23,6,17,
1788,0,24,7,17,
1789,0,23,6,17,
1790,0,22,6,16,
1791,0,24,7,17,
1792,0,25,7,18,
1793,0,24,6,18,
1794,0,23,6,17,
1795,0,22,7,15,
1796,0,22,6,16,
1797,0,21,6,15,
1798,0,25,7,18,
1799,0,23,6,17,
1800,0,23,7,16,
1801,0,22,6,16,
1802,0,23,7,16,
1803,0,23,6,17,
1804,0,23,7,16,
1805,0,25,7,18,
1806,0,23,6,17,
1807,0,25,7,17,1
1808,0,23,6,17,
1809,0,22,6,16,
1810,0,23,7,16,
1811,0,22,6,16,
1812,0,24,8,16,
1813,0,23,6,17,
1814,0,23,7,16,
1815,0,24,7,17,
1816,0,25,6,19,
1817,0,23,6,17,
1818,0,23,7,16,
1819,0,23,6,17,
1820,0,24,6,18,
1821,0,26,9,17,
1822,0,24,7,17,
1823,0,24,7,17,
1824,0,22,7,15,
1825,0,24,7,17,
1826,0,23,6,17,
1827,0,25,7,18,
1828,0,21,6,15,
1829,0,24,7,17,
1830,0,24,7,17,
1831,0,24,6,18,
1832,0,24,6,18,
1833,0,22,6,16,
1834,0,25,7,18,
1835,0,25,8,17,
1836,0,22,6,16,
1837,0,24,7,17,
1838,0,24,7,17,
1839,0,26,7,19,
1840,0,24,6,18,
1841,0,22,6,16,
1842,0,24,8,16,
1843,0,22,6,16,
1844,0,24,7,17,
1845,0,23,6,17,
1846,0,23,7,16,
1847,0,24,6,18,
1848,0,23,6,17,
1849,0,23,7,16,
1850,0,22,6,16,
1851,0,22,7,15,
1852,0,22,6,16,
1853,0,26,8,18,
1854,0,23,6,17,
1855,0,23,7,16,
1856,0,22,6,16,
1857,0,24,7,17,
1858,0,23,6,17,
1859,0,23,7,16,
1860,0,24,7,17,
1861,0,24,7,17,
1862,0,22,6,16,
1863,0,22,6,16,
1864,0,22,6,16,
1865,0,25,7,18,
1866,0,23,6,17,
1867,0,23,7,16,
1868,0,23,7,16,
1869,0,23,6,17,
1870,0,22,6,16,
1871,0,25,7,18,
1872,0,24,6,18,
1873,0,23,6,17,
1874,0,23,7,16,
1875,0,24,7,17,
1876,0,23,6,17,
1877,0,23,7,16,
1878,0,24,7,17,
1879,0,21,6,15,
1880,0,26,7,19,
1881,0,24,6,18,
1882,0,24,7,17,
1883,0,26,8,18,
1884,0,23,6,17,
1885,0,23,7,16,
1886,0,22,6,16,
1887,0,21,6,15,
1888,0,23,7,16,
1889,0,22,6,16,
1890,0,21,6,15,
1891,0,26,8,18,
1892,0,24,7,17,
1893,0,24,6,18,
1894,0,24,7,17,
1895,0,23,7,16,
1896,0,24,7,17,
1897,0,23,6,17,
1898,0,24,6,18,
1899,0,22,6,16,
1900,0,26,7,19,
1901,0,24,6,18,
1902,0,24,7,17,
1903,0,22,7,15,
1904,0,23,7,16,
1905,0,22,6,16,
1906,0,22,7,15,
1907,0,23,6,17,
1908,0,23,7,16,
1909,0,23,6,17,
1910,0,24,7,17,
1911,0,23,6,17,
1912,0,23,7,16,
1913,0,23,6,17,
1914,0,23,7,16,
1915,0,25,7,18,
1916,0,23,6,17,
1917,0,23,6,17,
1918,0,21,6,15,
1919,0,24,7,17,
1920,0,22,6,16,
1921,0,22,7,15,
1922,0,23,7,16,
1923,0,26,7,19,
1924,0,23,6,17,
1925,0,24,7,17,
1926,0,24,6,18,
1927,0,23,6,17,
1928,0,24,7,17,
1929,0,24,6,18,
1930,0,23,6,17,
1931,0,24,7,17,
1932,0,22,6,16,
1933,0,24,6,18,
1934,0,24,8,16,
1935,0,24,6,18,
1936,0,23,6,17,
1937,0,25,7,18,
1938,0,24,6,18,
1939,0,23,6,17,
1940,0,24,7,17,
1941,0,23,6,17,
1942,0,24,7,17,
1943,0,22,6,16,
1944,0,24,8,16,
1945,0,21,6,15,
1946,0,25,7,18,
1947,0,23,6,17,
1948,0,22,6,16,
1949,0,24,7,17,
1950,0,24,6,18,
1951,0,24,7,17,
1952,0,25,8,17,
1953,0,22,6,16,
1954,0,23,7,16,
1955,0,22,5,17,
1956,0,28,10,18,
1957,0,25,8,17,
1958,0,23,7,16,
1959,0,24,7,17,
1960,0,24,6,18,
1961,0,23,7,16,
1962,0,23,7,16,
1963,0,21,6,15,
1964,0,24,7,17,
1965,0,24,6,18,
1966,0,23,6,17,
1967,0,25,7,18,
1968,0,23,6,17,
1969,0,24,7,17,
1970,0,24,7,17,
1971,0,21,6,15,
1972,0,25,7,18,
1973,0,23,6,17,
1974,0,22,6,16,
1975,0,25,7,18,
1976,0,23,6,17,
1977,0,23,7,16,
1978,0,24,7,17,
1979,0,22,6,16,
1980,0,25,7,18,
1981,0,24,6,18,
1982,0,24,7,17,
1983,0,23,6,17,
1984,0,26,8,18,
1985,0,23,7,16,
1986,0,24,7,17,
1987,0,22,6,16,
1988,0,24,7,17,
1989,0,23,7,16,
1990,0,23,6,17,
1991,0,22,6,16,
1992,0,24,7,17,
1993,0,23,6,17,
1994,0,22,6,16,
1995,0,25,7,18,
1996,0,23,6,17,
1997,0,24,7,17,
1998,0,22,6,16,
1999,0,21,6,15,
2000,0,23,7,16,
2001,0,21,6,15,
2002,0,22,7,15,
2003,0,23,6,17,
2004,0,22,6,16,
2005,0,23,7,16,
2006,0,23,6,17,
2007,0,22,6,16,
2008,0,24,7,17,
2009,0,22,6,16,
2010,0,25,7,18,
2011,0,24,6,18,
2012,0,23,7,16,
2013,0,22,6,16,
2014,0,22,7,15,
2015,0,22,6,16,
2016,0,21,6,15,
2017,0,24,7,17,
2018,0,23,6,17,
2019,0,24,7,17,
2020,0,23,7,16,
2021,0,24,7,17,
2022,0,23,6,17,
2023,0,23,7,16,
2024,0,26,8,18,
2025,0,23,6,17,
2026,0,23,7,16,
2027,0,23,6,17,
2028,0,23,6,17,
2029,0,23,7,16,
2030,0,21,6,15,
2031,0,26,7,19,
2032,0,22,5,17,
2033,0,24,7,17,
2034,0,23,7,16,
2035,0,24,7,17,
2036,0,23,7,16,
2037,0,22,6,16,
2038,0,24,7,17,
2039,0,21,6,15,
2040,0,25,7,18,
2041,0,23,6,17,
2042,0,23,7,16,
2043,0,24,7,17,
2044,0,24,6,18,
2045,0,23,7,16,
2046,0,24,6,18,
2047,0,25,7,18,
2048,0,23,6,17,
2049,0,22,6,16,
2050,0,23,7,16,
2051,0,22,6,16,
2052,0,22,7,15,
2053,0,24,6,18,
2054,0,23,6,17,
2055,0,25,8,17,
2056,0,22,6,16,
2057,0,23,7,16,
2058,0,23,6,17,
2059,0,25,6,19,
2060,0,24,8,16,
2061,0,24,6,18,
2062,0,24,7,17,
2063,0,22,6,16,
2064,0,21,6,15,
2065,0,23,7,16,
2066,0,22,6,16,
2067,0,21,6,15,
2068,0,24,7,17,
2069,0,23,6,17,
2070,0,23,7,16,
2071,0,23,6,17,
2072,0,23,6,17,
2073,0,27,8,19,
2074,0,24,7,17,
2075,0,23,7,16,
2076,0,23,6,17,
2077,0,23,6,17,
2078,0,24,7,17,
2079,0,24,6,18,
2080,0,24,7,17,
2081,0,22,6,16,
2082,0,22,6,16,
2083,0,24,7,17,
2084,0,23,6,17,
2085,0,23,7,16,
2086,0,24,6,18,
2087,0,24,7,17,
2088,0,22,6,16,
2089,0,22,7,15,
2090,0,23,7,16,
2091,0,21,6,15,
2092,0,24,7,17,
2093,0,23,6,17,
2094,0,22,6,16,
2095,0,23,7,16,
2096,0,24,7,17,
2097,0,24,6,18,
2098,0,23,7,16,
2099,0,25,7,18,
2100,0,23,6,17,
2101,0,23,7,16,
2102,0,22,6,16,
2103,0,21,6,15,
2104,0,27,7,20,
2105,0,23,6,17,
2106,0,25,7,18,
2107,0,22,6,16,
2108,0,23,7,16,
2109,0,25,7,18,
2110,0,24,7,17,
2111,0,23,6,17,
2112,0,26,7,19,
2113,0,23,6,17,
2114,0,22,6,16,
2115,0,23,7,16,
2116,0,23,7,16,
2117,0,24,7,17,
2118,0,22,6,16,
2119,0,24,7,17,
2120,0,24,6,18,
2121,0,23,6,17,
2122,0,24,7,17,
2123,0,22,6,16,
2124,0,24,7,17,
2125,0,22,6,16,
2126,0,26,8,18,
2127,0,23,7,16,
2128,0,22,7,15,
2129,0,23,7,16,
2130,0,22,6,16,
2131,0,22,7,15,
2132,0,24,7,17,
2133,0,22,6,16,
2134,0,30,13,17,
2135,0,31,13,18,
2136,0,29,12,17,
2137,0,30,13,17,
2138,0,32,13,19,
2139,0,31,13,18,
2140,0,28,12,16,
2141,0,30,13,17,
2142,0,30,13,17,
2143,0,30,13,17,
2144,0,29,12,17,
2145,0,30,13,17,
2146,0,30,13,17,
2147,0,30,12,18,
2148,0,31,13,18,
2149,0,31,13,18,
2150,0,31,13,18,
2151,0,31,13,18,
2152,0,30,13,17,
2153,0,29,12,17,
2154,0,30,12,18,
2155,0,31,13,18,
2156,0,30,13,17,
2157,0,29,13,16,
2158,0,29,13,16,
2159,0,29,13,16,
2160,0,30,13,17,
2161,0,30,12,18,
2162,0,29,12,17,
2163,0,30,13,17,
2164,0,28,12,16,
2165,0,30,13,17,
2166,0,28,12,16,
2167,0,29,12,17,
2168,0,29,12,17,
2169,0,29,12,17,
2170,0,30,13,17,
2171,0,30,13,17,
2172,0,30,13,17,
2173,0,29,12,17,
2174,0,29,13,16,
2175,0,29,12,17,
2176,0,29,12,17,
2177,0,31,14,17,
2178,0,30,13,17,
2179,0,30,13,17,
2180,0,28,12,16,
2181,0,29,13,16,
2182,0,32,13,19,
2183,0,31,13,18,
2184,0,30,13,17,
2185,0,30,13,17,
2186,0,29,13,16,
2187,0,29,13,16,
2188,0,28,12,16,
2189,0,30,13,17,
2190,0,30,13,17,
2191,0,30,13,17,
2192,0,29,13,16,
2193,0,28,12,16,
2194,0,29,13,16,
2195,0,28,12,16,
2196,0,30,13,17,
2197,0,30,13,17,
2198,0,29,12,17,
2199,0,29,13,16,
2200,0,28,12,16,
2201,0,30,13,17,
2202,0,32,13,19,
2203,0,31,13,18,
2204,0,31,13,18,
2205,0,30,13,17,
2206,0,28,12,16,
2207,0,31,13,18,
2208,0,29,13,16,
2209,0,28,12,16,
2210,0,30,14,16,
2211,0,30,13,17,
2212,0,30,13,17,
2213,0,30,13,17,
2214,0,28,12,16,
2215,0,29,13,16,
2216,0,28,12,16,
2217,0,29,13,16,
2218,0,30,13,17,
2219,0,29,12,17,
2220,0,30,13,17,
2221,0,29,13,16,
2222,0,29,13,16,
2223,0,31,14,17,
2224,0,30,13,17,
2225,0,30,12,18,
2226,0,31,13,18,
2227,0,31,13,18,
2228,0,30,13,17,
2229,0,29,11,18,
2230,0,31,13,18,
2231,0,28,12,16,
2232,0,30,13,17,
2233,0,27,8,19,
2234,0,26,7,19,
2235,0,24,7,17,
2236,0,24,7,17,
2237,0,24,7,17,
2238,0,23,6,17,
2239,0,23,7,16,
2240,0,22,6,16,
2241,0,21,6,15,
2242,0,24,7,17,
2243,0,22,6,16,
2244,0,21,6,15,
2245,0,24,7,17,
2246,0,22,6,16,
2247,0,24,7,17,
2248,0,23,7,16,
2249,0,22,6,16,
2250,0,24,7,17,
2251,0,26,6,20,
2252,0,24,6,18,
2253,0,23,6,17,
2254,0,23,7,16,
2255,0,21,6,15,
2256,0,23,7,16,
2257,0,22,7,15,
2258,0,23,6,17,
2259,0,22,6,16,
2260,0,25,7,18,
2261,0,23,6,17,
2262,0,24,7,17,
2263,0,22,6,16,
2264,0,25,7,18,
2265,0,22,6,16,
2266,0,23,8,15,
2267,0,23,8,15,
2268,0,21,6,15,
2269,0,26,7,19,
2270,0,22,5,17,
2271,0,24,7,17,
2272,0,24,7,17,
2273,0,24,6,18,
2274,0,22,6,16,
2275,0,25,7,18,
2276,0,23,6,17,
2277,0,24,8,16,
2278,0,24,6,18,
2279,0,24,6,18,
2280,0,23,7,16,
2281,0,21,6,15,
2282,0,23,7,16,
2283,0,22,6,16,
2284,0,22,7,15,
2285,0,23,6,17,
2286,0,22,6,16,
2287,0,24,7,17,
2288,0,23,6,17,
2289,0,22,6,16,
2290,0,24,7,17,
2291,0,22,6,16,
2292,0,23,7,16,
2293,0,24,6,18,
2294,0,23,6,17,
2295,0,24,7,17,
2296,0,25,7,18,
2297,0,24,8,16,
2298,0,23,6,17,
2299,0,22,6,16,
2300,0,23,7,16,
2301,0,23,6,17,
2302,0,27,7,20,
2303,0,24,6,18,
2304,0,25,8,17,
2305,0,22,6,16,
2306,0,21,6,15,
2307,0,24,7,17,
2308,0,22,6,16,
2309,0,21,6,15,
2310,0,24,7,17,
2311,0,23,6,17,
2312,0,23,7,16,
2313,0,23,6,17,
2314,0,22,6,16,
2315,0,24,8,16,
2316,0,24,7,17,
2317,0,22,6,16,
2318,0,25,7,18,
2319,0,24,6,18,
2320,0,24,7,17,
2321,0,22,6,16,
2322,0,21,6,15,
2323,0,22,7,15,
2324,0,25,7,18,
2325,0,23,7,16,
2326,0,24,6,18,
2327,0,24,7,17,
2328,0,24,7,17,
2329,0,24,7,17,
2330,0,22,6,16,
2331,0,21,6,15,
2332,0,24,7,17,
2333,0,22,6,16,
2334,0,23,6,17,
2335,0,22,6,16,
2336,0,25,7,18,
2337,0,24,7,17,
2338,0,24,7,17,
2339,0,22,6,16,
2340,0,24,7,17,
2341,0,23,6,17,
2342,0,23,7,16,
2343,0,24,6,18,
2344,0,23,6,17,
2345,0,24,7,17,
2346,0,22,6,16,
2347,0,23,7,16,
2348,0,22,7,15,
2349,0,23,6,17,
2350,0,24,6,18,
2351,0,25,7,18,
2352,0,24,6,18,
2353,0,24,7,17,
2354,0,25,7,18,
2355,0,26,7,19,
2356,0,23,6,17,
2357,0,25,8,17,
2358,0,23,6,17,
2359,0,23,7,16,
2360,0,23,6,17,
2361,0,21,6,15,
2362,0,24,7,17,
2363,0,21,6,15,
2364,0,23,7,16,
2365,0,21,6,15,
2366,0,22,7,15,
2367,0,23,6,17,
2368,0,23,7,16,
2369,0,24,7,17,
2370,0,24,7,17,
2371,0,23,6,17,
2372,0,22,6,16,
2373,0,25,7,18,
2374,0,24,6,18,
2375,0,24,7,17,
2376,0,23,7,16,
2377,0,24,6,18,
2378,0,22,6,16,
2379,0,24,7,17,
2380,0,23,6,17,
2381,0,22,6,16,
2382,0,25,7,18,
2383,0,24,7,17,
2384,0,24,6,18,
2385,0,23,6,17,
2386,0,24,7,17,
2387,0,23,6,17,
2388,0,23,7,16,
2389,0,22,7,15,
2390,0,24,6,18,
2391,0,25,6,19,
2392,0,23,6,17,
2393,0,22,6,16,
2394,0,24,7,17,
2395,0,21,6,15,
2396,0,23,8,15,
2397,0,22,6,16,
2398,0,22,7,15,
2399,0,22,6,16,
2400,0,22,6,16,
2401,0,27,7,20,
2402,0,24,6,18,
2403,0,24,7,17,
2404,0,25,7,18,
2405,0,24,7,17,
2406,0,25,8,17,
2407,0,24,7,17,
2408,0,24,7,17,
2409,0,23,6,17,
2410,0,26,7,19,
2411,0,24,6,18,
2412,0,25,7,18,
2413,0,23,6,17,
2414,0,23,7,16,
2415,0,21,6,15,
2416,0,22,7,15,
2417,0,26,7,19,
2418,0,26,7,19,
2419,0,24,6,18,
2420,0,25,6,19,
2421,0,25,7,18,
2422,0,24,7,17,
2423,0,23,6,17,
2424,0,23,6,17,
2425,0,24,7,17,
2426,0,24,7,17,
2427,0,23,5,18,
2428,0,25,7,18,
2429,0,23,6,17,
2430,0,24,7,17,
2431,0,24,6,18,
2432,0,23,6,17,
2433,0,23,7,16,
2434,0,23,6,17,
2435,0,23,6,17,
2436,0,25,7,18,
2437,0,24,6,18,
2438,0,23,7,16,
2439,0,25,7,18,
2440,0,24,6,18,
2441,0,24,8,16,
2442,0,23,7,16,
2443,0,21,6,15,
2444,0,24,7,17,
2445,0,26,7,19,
2446,0,23,6,17,
2447,0,22,6,16,
2448,0,25,7,18,
2449,0,24,7,17,
2450,0,22,6,16,
2451,0,25,7,18,
2452,0,23,6,17,
2453,0,24,7,17,
2454,0,22,6,16,
2455,0,23,7,16,
2456,0,21,5,16,
2457,0,25,7,18,
2458,0,23,6,17,
2459,0,22,6,16,
2460,0,23,7,16,
2461,0,24,7,17,
2462,0,23,6,17,
2463,0,23,7,16,
2464,0,24,6,18,
2465,0,23,6,17,
2466,0,24,7,17,
2467,0,24,6,18,
2468,0,24,7,17,
2469,0,22,6,16,
2470,0,24,7,17,
2471,0,23,6,17,
2472,0,23,7,16,
2473,0,25,7,18,
2474,0,23,6,17,
2475,0,24,7,17,
2476,0,22,6,16,
2477,0,21,6,15,
2478,0,24,7,17,
2479,0,22,7,15,
2480,0,25,6,19,
2481,0,24,7,17,
2482,0,24,7,17,
2483,0,25,7,18,
2484,0,24,6,18,
2485,0,23,6,17,
2486,0,22,6,16,
2487,0,22,7,15,
2488,0,22,6,16,
2489,0,24,7,17,
2490,0,24,7,17,
2491,0,22,6,16,
2492,0,24,7,17,
2493,0,22,6,16,
2494,0,21,6,15,
2495,0,24,7,17,
2496,0,22,6,16,
2497,0,26,8,18,
2498,0,24,6,18,
2499,0,25,7,18,
2500,0,25,7,18,
2501,0,23,7,16,
2502,0,23,6,17,
2503,0,22,6,16,
2504,0,25,7,18,
2505,0,23,7,16,
2506,0,25,7,18,
2507,0,23,6,17,
2508,0,24,6,18,
2509,0,24,8,16,
2510,0,21,6,15,
2511,0,23,7,16,
2512,0,22,6,16,
2513,0,21,6,15,
2514,0,25,7,18,
2515,0,23,8,15,
2516,0,23,6,17,
2517,0,22,6,16,
2518,0,24,7,17,
2519,0,23,6,17,
2520,0,23,7,16,
2521,0,23,6,17,
2522,0,22,6,16,
2523,0,26,7,19,
2524,0,24,6,18,
2525,0,24,7,17,
2526,0,23,7,16,
2527,0,21,6,15,
2528,0,23,7,16,
2529,0,24,6,18,
2530,0,24,6,18,
2531,0,22,6,16,
2532,0,26,7,19,
2533,0,23,6,17,
2534,0,22,6,16,
2535,0,24,7,17,
2536,0,23,6,17,
2537,0,23,7,16,
2538,0,23,6,17,
2539,0,22,6,16,
2540,0,24,7,17,
2541,0,23,6,17,
2542,0,22,6,16,
2543,0,24,7,17,
2544,0,24,7,17,
2545,0,24,6,18,
2546,0,24,6,18,
2547,0,26,7,19,
2548,0,22,6,16,
2549,0,25,7,18,
2550,0,24,7,17,
2551,0,25,6,19,
2552,0,24,6,18,
2553,0,24,7,17,
2554,0,22,6,16,
2555,0,25,7,18,
2556,0,23,6,17,
2557,0,22,6,16,
2558,0,23,7,16,
2559,0,23,6,17,
2560,0,22,6,16,
2561,0,26,7,19,
2562,0,24,6,18,
2563,0,23,6,17,
2564,0,23,7,16,
2565,0,23,7,16,
2566,0,24,6,18,
2567,0,24,7,17,
2568,0,23,6,17,
2569,0,22,6,16,
2570,0,25,7,18,
2571,0,24,6,18,
2572,0,23,6,17,
2573,0,23,7,16,
2574,0,24,6,18,
2575,0,23,6,17,
2576,0,25,7,18,
2577,0,25,6,19,
2578,0,24,6,18,
2579,0,22,6,16,
2580,0,25,7,18,
2581,0,24,6,18,
2582,0,23,6,17,
2583,0,22,6,16,
2584,0,23,7,16,
2585,0,22,6,16,
2586,0,22,7,15,
2587,0,24,7,17,
2588,0,25,9,16,
2589,0,31,14,17,
2590,0,30,13,17,
2591,0,31,13,18,
2592,0,28,11,17,
2593,0,31,13,18,
2594,0,29,12,17,
2595,0,31,13,18,
2596,0,28,12,16,
2597,0,30,13,17,
2598,0,29,12,17,
2599,0,32,13,19,
2600,0,30,13,17,
2601,0,29,13,16,
2602,0,29,13,16,
2603,0,29,13,16,
2604,0,29,11,18,
2605,0,27,11,16,
2606,0,23,7,16,
2607,0,23,7,16,
2608,0,22,6,16,
2609,0,22,7,15,
2610,0,23,7,16,
2611,0,21,6,15,
2612,0,24,7,17,
2613,0,23,6,17,
2614,0,22,6,16,
2615,0,24,7,17,
2616,0,24,7,17,
2617,0,23,6,17,
2618,0,23,7,16,
2619,0,22,5,17,
2620,0,25,7,18,
2621,0,23,6,17,
2622,0,23,7,16,
2623,0,21,6,15,
2624,0,22,7,15,
2625,0,26,7,19,
2626,0,24,8,16,
2627,0,23,6,17,
2628,0,22,6,16,
2629,0,24,7,17,
2630,0,22,6,16,
2631,0,23,8,15,
2632,0,22,6,16,
2633,0,21,6,15,
2634,0,22,7,15,
2635,0,23,6,17,
2636,0,22,6,16,
2637,0,24,7,17,
2638,0,22,6,16,
2639,0,23,7,16,
2640,0,23,6,17,
2641,0,23,7,16,
2642,0,26,7,19,
2643,0,24,6,18,
2644,0,23,6,17,
2645,0,22,6,16,
2646,0,25,7,18,
2647,0,24,6,18,
2648,0,23,7,16,
2649,0,23,6,17,
2650,0,22,6,16,
2651,0,26,7,19,
2652,0,24,6,18,
2653,0,24,6,18,
2654,0,24,7,17,
2655,0,23,7,16,
2656,0,22,6,16,
2657,0,22,6,16,
2658,0,22,7,15,
2659,0,23,6,17,
2660,0,24,7,17,
2661,0,23,6,17,
2662,0,24,7,17,
2663,0,22,6,16,
2664,0,24,7,17,
2665,0,22,6,16,
2666,0,24,7,17,
2667,0,26,7,19,
2668,0,23,7,16,
2669,0,25,7,18,
2670,0,21,6,15,
2671,0,24,7,17,
2672,0,23,6,17,
2673,0,22,6,16,
2674,0,24,7,17,
2675,0,23,6,17,
2676,0,23,7,16,
2677,0,23,6,17,
2678,0,22,6,16,
2679,0,27,9,18,
2680,0,22,6,16,
2681,0,24,6,18,
2682,0,23,7,16,
2683,0,21,6,15,
2684,0,22,7,15,
2685,0,22,6,16,
2686,0,23,8,15,
2687,0,24,7,17,
2688,0,25,7,18,
2689,0,24,6,18,
2690,0,24,6,18,
2691,0,22,6,16,
2692,0,23,7,16,
2693,0,22,6,16,
2694,0,24,7,17,
2695,0,24,6,18,
2696,0,22,6,16,
2697,0,25,7,18,
2698,0,22,6,16,
2699,0,21,6,15,
2700,0,23,7,16,
2701,0,22,7,15,
2702,0,23,6,17,
2703,0,22,6,16,
2704,0,24,7,17,
2705,0,24,7,17,
2706,0,23,6,17,
2707,0,23,6,17,
2708,0,24,6,18,
2709,0,22,6,16,
2710,0,24,7,17,
2711,0,22,6,16,
2712,0,22,7,15,
2713,0,23,6,17,
2714,0,22,6,16,
2715,0,24,7,17,
2716,0,25,7,18,
2717,0,23,6,17,
2718,0,24,6,18,
2719,0,22,6,16,
2720,0,23,7,16,
2721,0,25,7,18,
2722,0,24,6,18,
2723,0,24,7,17,
2724,0,22,6,16,
2725,0,22,6,16,
2726,0,23,6,17,
2727,0,22,7,15,
2728,0,24,7,17,
2729,0,23,7,16,
2730,0,25,7,18,
2731,0,24,8,16,
2732,0,23,7,16,
2733,0,24,7,17,
2734,0,26,7,19,
2735,0,24,6,18,
2736,0,23,6,17,
2737,0,24,7,17,
2738,0,24,7,17,
2739,0,22,6,16,
2740,0,22,7,15,
2741,0,22,6,16,
2742,0,21,6,15,
2743,0,25,7,18,
2744,0,26,8,18,
2745,0,22,6,16,
2746,0,24,7,17,
2747,0,24,6,18,
2748,0,24,7,17,
2749,0,22,6,16,
2750,0,22,6,16,
2751,0,25,7,18,
2752,0,23,7,16,
2753,0,22,7,15,
2754,0,23,6,17,
2755,0,23,6,17,
2756,0,23,7,16,
2757,0,23,6,17,
2758,0,22,6,16,
2759,0,24,7,17,
2760,0,23,6,17,
2761,0,16,4,12,
2762,0,14,4,10,
2763,0,26,6,20,
2764,0,26,6,20,
2765,0,26,7,19,
2766,0,27,7,20,
2767,0,25,6,19,
2768,0,32,7,25,
2769,0,32,6,26,
2770,0,35,8,27,
2771,0,34,7,27,
2772,0,36,7,29,
2773,0,38,7,31,
2774,0,36,6,30,
2775,0,36,6,30,
2776,0,39,7,32,
2777,0,40,7,33,
2778,0,39,6,33,
2779,0,43,8,35,
2780,0,41,6,35,
2781,0,40,6,34,
2782,0,42,7,35,
2783,0,41,6,35,
2784,0,43,7,36,
2785,0,42,6,36,
2786,0,44,7,37,
2787,0,44,6,38,
2788,0,44,7,37,
2789,0,46,7,39,
2790,0,44,6,38,
2791,0,48,7,41,
2792,0,46,6,40,
2793,0,46,6,40,
2794,0,49,7,42,
2795,0,48,6,42,
2796,0,48,7,41,
2797,0,46,6,40,
2798,0,50,7,43,
2799,0,48,6,42,
2800,0,50,7,43,
2801,0,49,6,43,
2802,0,52,7,45,
2803,0,51,6,45,
2804,0,51,7,44,
2805,0,52,6,46,
2806,0,51,6,45,
2807,0,52,7,45,
2808,0,55,7,48,
2809,0,53,6,47,
2810,0,53,6,47,
2811,0,55,7,48,
2812,0,54,7,47,
2813,0,55,6,49,
2814,0,54,6,48,
2815,0,56,7,49,
2816,0,55,6,49,
2817,0,56,7,49,
2818,0,56,7,49,
2819,0,57,6,51,
2820,0,57,6,51,
2821,0,57,7,50,
2822,0,58,6,52,
2823,0,59,7,52,
2824,0,57,6,51,
2825,0,61,7,54,
2826,0,59,6,53,
2827,0,59,7,52,
2828,0,60,6,54,
2829,0,60,6,54,
2830,0,60,7,53,
2831,0,60,6,54,
2832,0,60,6,54,
2833,0,62,7,55,
2834,0,61,6,55,
2835,0,62,7,55,
2836,0,62,6,56,
2837,0,61,6,55,
2838,0,65,7,58,
2839,0,63,6,57,
2840,0,64,7,57,
2841,0,62,6,56,
2842,0,65,7,58,
2843,0,65,7,58,
2844,0,64,7,57,
2845,0,65,7,58,
2846,0,64,6,58,
2847,0,67,7,60,
2848,0,65,6,59,
2849,0,65,6,59,
2850,0,68,7,61,
2851,0,66,6,60,
2852,0,66,7,59,
2853,0,66,6,60,
2854,0,68,7,61,
2855,0,66,6,60,
2856,0,67,7,60,
2857,0,68,6,62,
2858,0,67,6,61,
2859,0,69,7,62,
2860,0,68,6,62,
2861,0,74,10,64,
2862,0,69,6,63,
2863,0,69,7,62,
2864,0,68,6,62,
2865,0,72,8,64,
2866,0,70,6,64,
2867,0,69,6,63,
2868,0,71,7,64,
2869,0,70,6,64,
2870,0,72,7,65,
2871,0,71,7,64,
2872,0,71,6,65,
2873,0,72,7,65,
2874,0,73,7,66,
2875,0,72,6,66,
2876,0,71,6,65,
2877,0,74,7,67,
2878,0,73,6,67,
2879,0,73,7,66,
2880,0,73,6,67,
2881,0,72,6,66,
2882,0,75,7,68,
2883,0,73,6,67,
2884,0,75,7,68,
2885,0,73,6,67,
2886,0,77,8,69,
2887,0,77,7,70,
2888,0,75,7,68,
2889,0,77,7,70,
2890,0,75,6,69,
2891,0,76,7,69,
2892,0,76,6,70,
2893,0,75,6,69,
2894,0,78,7,71,
2895,0,76,6,70,
2896,0,78,7,71,
2897,0,76,6,70,
2898,0,77,7,70,
2899,0,77,6,71,
2900,0,77,6,71,
2901,0,79,7,72,
2902,0,79,7,72,
2903,0,78,7,71,
2904,0,79,6,73,
2905,0,80,7,73,
2906,0,79,6,73,
2907,0,79,7,72,
2908,0,79,6,73,
2909,0,79,6,73,
2910,0,81,7,74,
2911,0,80,6,74,
2912,0,80,7,73,
2913,0,80,6,74,
2914,0,81,6,75,
2915,0,82,7,75,
2916,0,80,6,74,
2917,0,81,7,74,
2918,0,81,7,74,
2919,0,82,7,75,
2920,0,82,6,76,
2921,0,82,7,75,
2922,0,83,7,76,
2923,0,82,6,76,
2924,0,82,7,75,
2925,0,83,7,76,
2926,0,81,6,75,
2927,0,84,7,77,
2928,0,82,7,75,
2929,0,81,6,75,
2930,0,72,7,65,
2931,0,59,6,53,
2932,0,53,7,46,
2933,0,52,6,46,
2934,0,45,6,39,
2935,0,36,6,30,
2936,0,27,6,21,
2937,0,23,6,17,
2938,0,25,7,18,
2939,0,39,6,33,
2940,0,39,6,33,
2941,0,41,7,34,
2942,0,41,6,35,
2943,0,42,7,35,
2944,0,41,6,35,
2945,0,43,7,36,
2946,0,43,6,37,
2947,0,43,7,36,
2948,0,44,6,38,
2949,0,43,6,37,
2950,0,46,7,39,
2951,0,45,6,39,
2952,0,49,9,40,
2953,0,45,6,39,
2954,0,47,7,40,
2955,0,49,8,41,
2956,0,48,6,42,
2957,0,48,7,41,
2958,0,50,9,41,
2959,0,49,7,42,
2960,0,51,7,44,
2961,0,51,7,44,
2962,0,49,6,43,
2963,0,52,7,45,
2964,0,53,8,45,
2965,0,51,6,45,
2966,0,51,6,45,
2967,0,53,7,46,
2968,0,51,6,45,
2969,0,54,7,47,
2970,0,52,6,46,
2971,0,55,7,48,
2972,0,54,6,48,
2973,0,54,7,47,
2974,0,55,6,49,
2975,0,54,6,48,
2976,0,56,7,49,
2977,0,57,7,50,
2978,0,56,7,49,
2979,0,56,6,50,
2980,0,57,6,51,
2981,0,57,7,50,
2982,0,58,7,51,
2983,0,59,7,52,
2984,0,57,6,51,
2985,0,59,7,52,
2986,0,59,6,53,
2987,0,59,7,52,
2988,0,59,6,53,
2989,0,60,7,53,
2990,0,60,7,53,
2991,0,60,6,54,
2992,0,59,6,53,
2993,0,62,7,55,
2994,0,63,7,56,
2995,0,61,6,55,
2996,0,62,7,55,
2997,0,62,6,56,
2998,0,62,6,56,
2999,0,62,7,55,
3000,0,63,6,57,
3001,0,62,6,56,
3002,0,64,7,57,
3003,0,64,6,58,
3004,0,64,7,57,
3005,0,64,6,58,
3006,0,63,6,57,
3007,0,67,7,60,
3008,0,65,6,59,
3009,0,64,6,58,
3010,0,67,7,60,
3011,0,66,6,60,
3012,0,67,8,59,
3013,0,66,7,59,
3014,0,67,6,61,
3015,0,66,6,60,
3016,0,69,7,62,
3017,0,67,6,61,
3018,0,67,6,61,
3019,0,69,7,62,
3020,0,69,8,61,
3021,0,68,6,62,
3022,0,68,6,62,
3023,0,70,7,63,
3024,0,68,6,62,
3025,0,71,7,64,
3026,0,69,6,63,
3027,0,71,7,64,
3028,0,70,6,64,
3029,0,70,7,63,
3030,0,71,6,65,
3031,0,70,6,64,
3032,0,71,7,64,
3033,0,72,7,65,
3034,0,72,6,66,
3035,0,71,6,65,
3036,0,73,7,66,
3037,0,72,6,66,
3038,0,72,7,65,
3039,0,72,6,66,
3040,0,74,7,67,
3041,0,74,7,67,
3042,0,73,6,67,
3043,0,78,10,68,
3044,0,73,6,67,
3045,0,76,7,69,
3046,0,74,7,67,
3047,0,76,7,69,
3048,0,74,6,68,
3049,0,75,7,68,
3050,0,76,7,69,
3051,0,75,6,69,
3052,0,76,7,69,
3053,0,76,6,70,
3054,0,76,6,70,
3055,0,77,8,69,
3056,0,77,6,71,
3057,0,76,6,70,
3058,0,78,7,71,
3059,0,76,6,70,
3060,0,77,7,70,
3061,0,78,6,72,
3062,0,77,6,71,
3063,0,80,7,73,
3064,0,78,6,72,
3065,0,77,6,71,
3066,0,80,7,73,
3067,0,78,6,72,
3068,0,81,7,74,
3069,0,79,6,73,
3070,0,80,7,73,
3071,0,80,6,74,
3072,0,81,7,74,
3073,0,81,7,74,
3074,0,81,7,74,
3075,0,80,6,74,
3076,0,82,7,75,
3077,0,81,6,75,
3078,0,81,7,74,
3079,0,81,6,75,
3080,0,81,6,75,
3081,0,83,7,76,
3082,0,81,6,75,
3083,0,83,7,76,
3084,0,81,6,75,
3085,0,84,7,77,
3086,0,82,6,76,
3087,0,82,7,75,
3088,0,83,7,76,
3089,0,81,6,75,
3090,0,84,7,77,
3091,0,73,6,67,
3092,0,60,6,54,
3093,0,54,7,47,
3094,0,52,6,46,
3095,0,47,7,40,
3096,0,36,5,31,
3097,0,29,7,22,
3098,0,23,6,17,
3099,0,24,6,18,
3100,0,39,7,32,
3101,0,40,7,33,
3102,0,41,7,34,
3103,0,40,6,34,
3104,0,43,7,36,
3105,0,42,6,36,
3106,0,42,7,35,
3107,0,43,7,36,
3108,0,42,6,36,
3109,0,46,7,39,
3110,0,44,6,38,
3111,0,44,6,38,
3112,0,46,7,39,
3113,0,46,6,40,
3114,0,46,7,39,
3115,0,47,7,40,
3116,0,48,7,41,
3117,0,46,6,40,
3118,0,50,7,43,
3119,0,47,6,41,
3120,0,51,8,43,
3121,0,51,7,44,
3122,0,50,6,44,
3123,0,50,7,43,
3124,0,50,6,44,
3125,0,51,7,44,
3126,0,53,8,45,
3127,0,52,6,46,
3128,0,51,6,45,
3129,0,53,7,46,
3130,0,53,6,47,
3131,0,55,7,48,
3132,0,53,6,47,
3133,0,54,7,47,
3134,0,59,10,49,
3135,0,60,13,47,
3136,0,62,13,49,
3137,0,61,12,49,
3138,0,63,13,50,
3139,0,63,13,50,
3140,0,62,13,49,
3141,0,63,13,50,
3142,0,63,13,50,
3143,0,64,13,51,
3144,0,65,13,52,
3145,0,65,13,52,
3146,0,64,13,51,
3147,0,64,13,51,
3148,0,65,13,52,
3149,0,65,13,52,
3150,0,66,13,53,
3151,0,67,13,54,
3152,0,67,13,54,
3153,0,65,12,53,
3154,0,68,13,55,
3155,0,68,13,55,
3156,0,68,13,55,
3157,0,69,13,56,
3158,0,69,13,56,
3159,0,69,13,56,
3160,0,67,12,55,
3161,0,70,13,57,
3162,0,70,13,57,
3163,0,70,13,57,
3164,0,71,13,58,
3165,0,71,13,58,
3166,0,71,13,58,
3167,0,70,13,57,
3168,0,71,13,58,
3169,0,71,13,58,
3170,0,71,13,58,
3171,0,73,13,60,
3172,0,73,13,60,
3173,0,73,13,60,
3174,0,73,13,60,
3175,0,74,13,61,
3176,0,73,13,60,
3177,0,73,13,60,
3178,0,75,13,62,
3179,0,74,12,62,
3180,0,75,13,62,
3181,0,75,13,62,
3182,0,75,13,62,
3183,0,76,13,63,
3184,0,76,13,63,
3185,0,76,13,63,
3186,0,75,13,62,
3187,0,76,13,63,
3188,0,76,13,63,
3189,0,77,14,63,
3190,0,77,13,64,
3191,0,78,13,65,
3192,0,78,13,65,
3193,0,77,13,64,
3194,0,77,13,64,
3195,0,78,13,65,
3196,0,78,13,65,
3197,0,79,13,66,
3198,0,78,12,66,
3199,0,80,13,67,
3200,0,80,13,67,
3201,0,80,13,67,
3202,0,80,13,67,
3203,0,81,13,68,
3204,0,81,13,68,
3205,0,80,12,68,
3206,0,81,13,68,
3207,0,81,13,68,
3208,0,82,13,69,
3209,0,82,13,69,
3210,0,82,13,69,
3211,0,82,13,69,
3212,0,81,12,69,
3213,0,82,13,69,
3214,0,83,13,70,
3215,0,83,13,70,
3216,0,83,13,70,
3217,0,84,13,71,
3218,0,84,13,71,
3219,0,83,13,70,
3220,0,83,13,70,
3221,0,84,13,71,
3222,0,84,13,71,
3223,0,85,13,72,
3224,0,85,13,72,
3225,0,85,13,72,
3226,0,85,13,72,
3227,0,85,13,72,
3228,0,85,13,72,
3229,0,84,12,72,
3230,0,86,13,73,
3231,0,87,13,74,
3232,0,87,13,74,
3233,0,86,13,73,
3234,0,86,13,73,
3235,0,86,13,73,
3236,0,87,13,74,
3237,0,88,13,75,
3238,0,88,13,75,
3239,0,88,13,75,
3240,0,88,13,75,
3241,0,89,13,76,
3242,0,89,13,76,
3243,0,88,13,75,
3244,0,89,13,76,
3245,0,88,12,76,
3246,0,89,13,76,
3247,0,88,13,75,
3248,0,88,13,75,
3249,0,88,13,75,
3250,0,88,13,75,
3251,0,86,13,73,
3252,0,75,13,62,
3253,0,64,13,51,
3254,0,61,13,48,
3255,0,56,12,44,
3256,0,49,11,38,
3257,0,40,12,28,
3258,0,35,13,22,
3259,0,34,13,21,
3260,0,44,13,31,
3261,0,45,12,33,
3262,0,47,13,34,
3263,0,47,13,34,
3264,0,48,13,35,
3265,0,48,13,35,
3266,0,48,13,35,
3267,0,49,13,36,
3268,0,49,12,37,
3269,0,51,13,38,
3270,0,51,13,38,
3271,0,52,13,39,
3272,0,52,13,39,
3273,0,52,13,39,
3274,0,54,13,41,
3275,0,52,12,40,
3276,0,54,13,41,
3277,0,54,13,41,
3278,0,55,13,42,
3279,0,55,13,42,
3280,0,56,13,43,
3281,0,56,13,43,
3282,0,55,12,43,
3283,0,57,13,44,
3284,0,57,13,44,
3285,0,58,13,45,
3286,0,58,13,45,
3287,0,58,13,45,
3288,0,59,13,46,
3289,0,58,12,46,
3290,0,60,13,47,
3291,0,60,13,47,
3292,0,60,13,47,
3293,0,61,13,48,
3294,0,61,13,48,
3295,0,62,13,49,
3296,0,60,12,48,
3297,0,62,13,49,
3298,0,62,13,49,
3299,0,63,13,50,
3300,0,63,13,50,
3301,0,63,13,50,
3302,0,63,13,50,
3303,0,63,12,51,
3304,0,64,13,51,
3305,0,65,13,52,
3306,0,65,13,52,
3307,0,65,13,52,
3308,0,66,13,53,
3309,0,66,13,53,
3310,0,65,12,53,
3311,0,67,13,54,
3312,0,67,13,54,
3313,0,67,13,54,
3314,0,68,13,55,
3315,0,68,13,55,
3316,0,68,13,55,
3317,0,67,12,55,
3318,0,69,13,56,
3319,0,69,13,56,
3320,0,69,13,56,
3321,0,70,13,57,
3322,0,70,13,57,
3323,0,70,13,57,
3324,0,69,13,56,
3325,0,70,13,57,
3326,0,71,13,58,
3327,0,71,13,58,
3328,0,72,13,59,
3329,0,72,13,59,
3330,0,72,13,59,
3331,0,71,13,58,
3332,0,72,13,59,
3333,0,72,13,59,
3334,0,72,13,59,
3335,0,73,13,60,
3336,0,74,13,61,
3337,0,74,13,61,
3338,0,73,13,60,
3339,0,74,13,61,
3340,0,74,13,61,
3341,0,75,13,62,
3342,0,75,13,62,
3343,0,76,13,63,
3344,0,76,13,63,
3345,0,75,13,62,
3346,0,71,8,63,
3347,0,70,6,64,
3348,0,70,7,63,
3349,0,69,6,63,
3350,0,72,9,63,
3351,0,71,6,65,
3352,0,72,7,65,
3353,0,71,7,64,
3354,0,71,6,65,
3355,0,70,6,64,
3356,0,73,7,66,
3357,0,71,6,65,
3358,0,72,7,65,
3359,0,72,6,66,
3360,0,72,6,66,
3361,0,75,7,68,
3362,0,73,6,67,
3363,0,72,6,66,
3364,0,75,7,68,
3365,0,73,6,67,
3366,0,76,7,69,
3367,0,74,7,67,
3368,0,75,6,69,
3369,0,74,6,68,
3370,0,77,7,70,
3371,0,75,6,69,
3372,0,74,6,68,
3373,0,77,7,70,
3374,0,75,6,69,
3375,0,76,7,69,
3376,0,76,7,69,
3377,0,77,6,71,
3378,0,76,6,70,
3379,0,79,7,72,
3380,0,77,6,71,
3381,0,76,6,70,
3382,0,79,7,72,
3383,0,80,7,73,
3384,0,78,7,71,
3385,0,78,6,72,
3386,0,77,6,71,
3387,0,80,7,73,
3388,0,80,7,73,
3389,0,78,6,72,
3390,0,80,7,73,
3391,0,78,6,72,
3392,0,80,7,73,
3393,0,80,6,74,
3394,0,80,7,73,
3395,0,81,7,74,
3396,0,79,6,73,
3397,0,83,7,76,
3398,0,81,6,75,
3399,0,80,6,74,
3400,0,82,7,75,
3401,0,81,6,75,
3402,0,82,7,75,
3403,0,82,6,76,
3404,0,81,6,75,
3405,0,83,7,76,
3406,0,83,7,76,
3407,0,83,7,76,
3408,0,81,6,75,
3409,0,83,7,76,
3410,0,83,7,76,
3411,0,82,7,75,
3412,0,76,6,70,
3413,0,65,7,58,
3414,0,53,6,47,
3415,0,54,7,47,
3416,0,49,7,42,
3417,0,39,6,33,
3418,0,31,7,24,
3419,0,24,6,18,
3420,0,24,6,18,
3421,0,34,7,27,
3422,0,38,6,32,
3423,0,42,7,35,
3424,0,40,7,33,
3425,0,41,6,35,
3426,0,42,7,35,
3427,0,42,7,35,
3428,0,43,6,37,
3429,0,42,6,36,
3430,0,45,7,38,
3431,0,43,6,37,
3432,0,45,7,38,
3433,0,45,6,39,
3434,0,45,6,39,
3435,0,48,7,41,
3436,0,46,6,40,
3437,0,46,6,40,
3438,0,48,7,41,
3439,0,47,6,41,
3440,0,49,7,42,
3441,0,49,6,43,
3442,0,49,7,42,
3443,0,50,7,43,
3444,0,50,6,44,
3445,0,49,6,43,
3446,0,52,7,45,
3447,0,50,6,44,
3448,0,53,7,46,
3449,0,52,6,46,
3450,0,52,7,45,
3451,0,54,7,47,
3452,0,52,6,46,
3453,0,55,7,48,
3454,0,54,6,48,
3455,0,53,6,47,
3456,0,54,7,47,
3457,0,55,7,48,
3458,0,55,6,49,
3459,0,56,7,49,
3460,0,55,6,49,
3461,0,57,7,50,
3462,0,56,6,50,
3463,0,56,6,50,
3464,0,58,7,51,
3465,0,57,6,51,
3466,0,58,7,51,
3467,0,58,6,52,
3468,0,57,6,51,
3469,0,60,7,53,
3470,0,58,6,52,
3471,0,60,7,53,
3472,0,59,6,53,
3473,0,61,7,54,
3474,0,60,7,53,
3475,0,61,6,55,
3476,0,60,6,54,
3477,0,62,7,55,
3478,0,60,6,54,
3479,0,63,7,56,
3480,0,62,7,55,
3481,0,62,6,56,
3482,0,63,6,57,
3483,0,63,7,56,
3484,0,63,6,57,
3485,0,62,6,56,
3486,0,65,7,58,
3487,0,64,6,58,
3488,0,64,7,57,
3489,0,65,6,59,
3490,0,64,6,58,
3491,0,67,7,60,
3492,0,65,6,59,
3493,0,65,6,59,
3494,0,67,7,60,
3495,0,65,6,59,
3496,0,66,7,59,
3497,0,69,9,60,
3498,0,67,6,61,
3499,0,66,6,60,
3500,0,68,7,61,
3501,0,67,6,61,
3502,0,69,7,62,
3503,0,69,7,62,
3504,0,68,7,61,
3505,0,69,6,63,
3506,0,70,7,63,
3507,0,68,6,62,
3508,0,70,7,63,
3509,0,71,7,64,
3510,0,69,6,63,
3511,0,71,7,64,
3512,0,69,6,63,
3513,0,72,7,65,
3514,0,71,6,65,
3515,0,71,7,64,
3516,0,71,6,65,
3517,0,71,6,65,
3518,0,74,7,67,
3519,0,72,6,66,
3520,0,73,7,66,
3521,0,72,6,66,
3522,0,75,7,68,
3523,0,73,6,67,
3524,0,73,7,66,
3525,0,74,6,68,
3526,0,73,6,67,
3527,0,75,7,68,
3528,0,73,6,67,
3529,0,75,7,68,
3530,0,74,6,68,
3531,0,75,7,68,
3532,0,75,6,69,
3533,0,75,7,68,
3534,0,76,7,69,
3535,0,78,8,70,
3536,0,78,7,71,
3537,0,76,6,70,
3538,0,75,6,69,
3539,0,77,7,70,
3540,0,78,7,71,
3541,0,77,7,70,
3542,0,77,6,71,
3543,0,76,6,70,
3544,0,79,7,72,
3545,0,78,6,72,
3546,0,77,6,71,
3547,0,79,7,72,
3548,0,79,6,73,
3549,0,79,7,72,
3550,0,79,6,73,
3551,0,80,7,73,
3552,0,78,6,72,
3553,0,81,7,74,
3554,0,80,6,74,
3555,0,79,6,73,
3556,0,81,7,74,
3557,0,80,6,74,
3558,0,81,7,74,
3559,0,81,6,75,
3560,0,80,6,74,
3561,0,82,7,75,
3562,0,81,6,75,
3563,0,82,7,75,
3564,0,81,6,75,
3565,0,83,7,76,
3566,0,82,7,75,
3567,0,82,6,76,
3568,0,81,6,75,
3569,0,82,7,75,
3570,0,83,7,76,
3571,0,82,6,76,
3572,0,82,7,75,
3573,0,80,7,73,
3574,0,67,6,61,
3575,0,56,7,49,
3576,0,54,7,47,
3577,0,49,6,43,
3578,0,42,6,36,
3579,0,33,7,26,
3580,0,26,6,20,
3581,0,23,6,17,
3582,0,31,7,24,
3583,0,39,6,33,
3584,0,39,6,33,
3585,0,41,7,34,
3586,0,40,6,34,
3587,0,42,7,35,
3588,0,44,9,35,
3589,0,42,6,36,
3590,0,42,6,36,
3591,0,46,8,38,
3592,0,45,7,38,
3593,0,43,6,37,
3594,0,46,7,39,
3595,0,44,6,38,
3596,0,47,7,40,
3597,0,46,7,39,
3598,0,48,7,41,
3599,0,47,7,40,
3600,0,49,7,42,
3601,0,48,6,42,
3602,0,48,6,42,
3603,0,50,7,43,
3604,0,49,6,43,
3605,0,50,7,43,
3606,0,50,6,44,
3607,0,50,6,44,
3608,0,52,7,45,
3609,0,51,7,44,
3610,0,52,7,45,
3611,0,51,6,45,
3612,0,53,7,46,
3613,0,53,6,47,
3614,0,53,7,46,
3615,0,54,6,48,
3616,0,53,6,47,
3617,0,55,7,48,
3618,0,57,7,50,
3619,0,55,7,48,
3620,0,55,6,49,
3621,0,55,6,49,
3622,0,56,7,49,
3623,0,56,6,50,
3624,0,57,7,50,
3625,0,58,7,51,
3626,0,56,6,50,
3627,0,60,7,53,
3628,0,58,6,52,
3629,0,57,6,51,
3630,0,61,8,53,
3631,0,59,6,53,
3632,0,59,7,52,
3633,0,61,7,54,
3634,0,59,6,53,
3635,0,62,7,55,
3636,0,45,1,44,
3637,0,22,,22,
