window-id,queue-size-CL,queue-size-LL,10.0.0.13:39063 -> 10.0.1.13:3000,10.0.1.13:3000 -> 10.0.0.13:39063,10.0.0.13:58713 -> 10.0.1.13:1000
0,0,27,6,21,
1,0,38,8,30,
2,0,40,6,34,
3,0,35,6,29,
4,0,31,7,24,
5,0,30,6,24,
6,0,28,7,21,
7,0,24,5,19,
8,0,23,7,16,
9,0,22,7,15,
10,0,21,6,15,
11,0,19,6,13,
12,0,19,7,12,
13,0,19,6,13,
14,0,21,7,14,
15,0,20,6,14,
16,0,22,7,15,
17,0,21,7,14,
18,0,19,7,12,
19,0,20,7,13,
20,0,18,4,14,
21,0,17,4,13,
22,0,19,4,15,
23,0,16,4,12,
24,0,15,3,12,
25,0,18,4,14,
26,0,17,3,14,
27,0,14,3,11,
28,0,17,4,13,
29,0,15,4,11,
30,0,14,3,11,
31,0,17,4,13,
32,0,16,3,13,
33,0,18,4,14,
34,0,15,3,12,
35,0,17,4,13,
36,0,17,3,14,
37,0,16,3,13,
38,0,16,4,12,
39,0,16,3,13,
40,0,15,3,12,
41,0,19,4,15,
42,0,18,3,15,
43,0,16,4,12,
44,0,18,4,14,
45,0,16,3,13,
46,0,17,3,14,
47,0,17,5,12,
48,0,15,3,12,
49,0,15,3,12,
50,0,16,4,12,
51,0,16,4,12,
52,0,15,3,12,
53,0,19,5,14,
54,0,16,3,13,
55,0,19,4,15,
56,0,20,4,16,
57,0,14,3,11,
58,0,18,4,14,
59,0,15,3,12,
60,0,14,3,11,
61,0,18,4,14,
62,0,17,3,14,
63,0,18,3,15,
64,0,15,4,11,
65,0,16,3,13,
66,0,18,4,14,
67,0,17,4,13,
68,0,16,4,12,
69,0,16,3,13,
70,0,13,3,10,
71,0,16,4,12,
72,0,16,3,13,
73,0,16,3,13,
74,0,18,4,14,
75,0,15,3,12,
76,0,15,3,12,
77,0,18,5,13,
78,0,17,3,14,
79,0,15,3,12,
80,0,17,5,12,
81,0,17,4,13,
82,0,17,3,14,
83,0,17,3,14,
84,0,17,4,13,
85,0,15,3,12,
86,0,15,3,12,
87,0,19,4,15,
88,0,15,3,12,
89,0,16,4,12,
90,0,16,3,13,
91,0,16,3,13,
92,0,16,4,12,
93,0,16,3,13,
94,0,13,3,10,
95,0,16,4,12,
96,0,16,4,12,
97,0,17,4,13,
98,0,20,4,16,
99,0,18,3,15,
100,0,15,3,12,
101,0,16,4,12,
102,0,17,3,14,
103,0,17,3,14,
104,0,17,3,14,
105,0,17,4,13,
106,0,16,3,13,
107,0,18,5,13,
108,0,19,4,15,
109,0,14,3,11,
110,0,17,4,13,
111,0,18,5,13,
112,0,15,3,12,
113,0,15,3,12,
114,0,18,5,13,
115,0,19,4,15,
116,0,14,3,11,
117,0,20,6,14,
118,0,17,3,14,
119,0,16,3,13,
120,0,19,4,15,
121,0,15,4,11,
122,0,17,4,13,
123,0,16,3,13,
124,0,16,3,13,
125,0,16,4,12,
126,0,16,3,13,
127,0,16,3,13,
128,0,19,4,15,
129,0,17,3,14,
130,0,16,3,13,
131,0,20,6,14,
132,0,16,3,13,
133,0,15,3,12,
134,0,17,4,13,
135,0,16,5,11,
136,0,16,3,13,
137,0,16,3,13,
138,0,17,5,12,
139,0,16,3,13,
140,0,17,4,13,
141,0,18,4,14,
142,0,19,4,15,
143,0,17,3,14,
144,0,18,4,14,
145,0,16,3,13,
146,0,15,3,12,
147,0,15,5,10,
148,0,16,3,13,
149,0,17,3,14,
150,0,19,4,15,
151,0,18,4,14,
152,0,20,4,16,
153,0,16,3,13,
154,0,17,3,14,
155,0,17,4,13,
156,0,18,4,14,
157,0,13,3,10,
158,0,17,4,13,
159,0,16,3,13,
160,0,16,3,13,
161,0,18,4,14,
162,0,15,3,12,
163,0,17,4,13,
164,0,17,3,14,
165,0,13,3,10,
166,0,15,4,11,
167,0,15,3,12,
168,0,18,4,14,
169,0,18,3,15,
170,0,14,3,11,
171,0,17,4,13,
172,0,16,4,12,
173,0,17,3,14,
174,0,17,3,14,
175,0,18,5,13,
176,0,16,3,13,
177,0,18,4,14,
178,0,19,4,15,
179,0,17,3,14,
180,0,14,3,11,
181,0,18,6,12,
182,0,17,3,14,
183,0,16,3,13,
184,0,17,4,13,
185,0,16,3,13,
186,0,17,3,14,
187,0,13,3,10,
188,0,15,4,11,
189,0,17,3,14,
190,0,17,3,14,
191,0,14,3,11,
192,0,16,4,12,
193,0,16,3,13,
194,0,16,3,13,
195,0,19,4,15,
196,0,16,4,12,
197,0,15,3,12,
198,0,16,4,12,
199,0,15,3,12,
200,0,15,3,12,
201,0,18,4,14,
202,0,19,6,13,
203,0,18,4,14,
204,0,17,5,12,
205,0,19,6,13,
206,0,18,5,13,
207,0,19,5,14,
208,0,20,5,15,
209,0,18,5,13,
210,0,17,4,13,
211,0,18,4,14,
212,0,17,4,13,
213,0,14,4,10,
214,0,16,4,12,
215,0,19,4,15,
216,0,15,4,11,
217,0,16,4,12,
218,0,16,4,12,
219,0,17,3,14,
220,0,16,3,13,
221,0,17,4,13,
222,0,19,4,15,
223,0,19,4,15,
224,0,16,3,13,
225,0,14,3,11,
226,0,17,4,13,
227,0,15,3,12,
228,0,19,4,15,
229,0,17,3,14,
230,0,16,3,13,
231,0,17,4,13,
232,0,15,3,12,
233,0,17,4,13,
234,0,17,4,13,
235,0,17,4,13,
236,0,17,3,14,
237,0,17,4,13,
238,0,18,4,14,
239,0,19,4,15,
240,0,15,3,12,
241,0,15,3,12,
242,0,19,5,14,
243,0,19,4,15,
244,0,15,3,12,
245,0,15,3,12,
246,0,17,4,13,
247,0,16,3,13,
248,0,19,4,15,
249,0,17,4,13,
250,0,16,3,13,
251,0,13,3,10,
252,0,17,4,13,
253,0,16,3,13,
254,0,16,3,13,
255,0,17,4,13,
256,0,17,3,14,
257,0,15,4,11,
258,0,17,4,13,
259,0,18,4,14,
260,0,17,4,13,
261,0,16,3,13,
262,0,16,5,11,
263,0,15,3,12,
264,0,15,3,12,
265,0,19,4,15,
266,0,17,3,14,
267,0,14,3,11,
268,0,17,4,13,
269,0,15,4,11,
270,0,14,3,11,
271,0,19,4,15,
272,0,17,3,14,
273,0,17,3,14,
274,0,18,4,14,
275,0,15,3,12,
276,0,16,3,13,
277,0,16,3,13,
278,0,18,4,14,
279,0,17,3,14,
280,0,14,3,11,
281,0,17,4,13,
282,0,14,3,11,
283,0,15,3,12,
284,0,18,4,14,
285,0,16,3,13,
286,0,19,4,15,
287,0,17,3,14,
288,0,17,5,12,
289,0,16,3,13,
290,0,18,4,14,
291,0,16,3,13,
292,0,19,4,15,
293,0,15,4,11,
294,0,17,4,13,
295,0,17,4,13,
296,0,16,3,13,
297,0,18,4,14,
298,0,16,3,13,
299,0,18,4,14,
300,0,18,4,14,
301,0,20,5,15,
302,0,17,3,14,
303,0,16,4,12,
304,0,18,4,14,
305,0,17,3,14,
306,0,17,3,14,
307,0,14,4,10,
308,0,16,3,13,
309,0,14,3,11,
310,0,14,3,11,
311,0,17,4,13,
312,0,17,3,14,
313,0,17,3,14,
314,0,17,4,13,
315,0,16,3,13,
316,0,16,3,13,
317,0,18,4,14,
318,0,17,4,13,
319,0,17,3,14,
320,0,16,3,13,
321,0,19,4,15,
322,0,17,3,14,
323,0,15,3,12,
324,0,18,6,12,
325,0,16,3,13,
326,0,17,3,14,
327,0,15,4,11,
328,0,15,3,12,
329,0,16,4,12,
330,0,17,3,14,
331,0,14,3,11,
332,0,16,4,12,
333,0,14,3,11,
334,0,19,5,14,
335,0,17,3,14,
336,0,16,3,13,
337,0,19,4,15,
338,0,18,4,14,
339,0,15,3,12,
340,0,15,4,11,
341,0,17,3,14,
342,0,17,3,14,
343,0,16,3,13,
344,0,17,5,12,
345,0,15,3,12,
346,0,15,3,12,
347,0,19,4,15,
348,0,17,3,14,
349,0,15,4,11,
350,0,17,4,13,
351,0,16,3,13,
352,0,16,3,13,
353,0,18,4,14,
354,0,16,3,13,
355,0,14,3,11,
356,0,17,4,13,
357,0,17,4,13,
358,0,17,3,14,
359,0,15,3,12,
360,0,16,4,12,
361,0,16,4,12,
362,0,15,3,12,
363,0,16,4,12,
364,0,18,4,14,
365,0,17,3,14,
366,0,16,3,13,
367,0,17,4,13,
368,0,16,3,13,
369,0,13,3,10,
370,0,16,4,12,
371,0,17,3,14,
372,0,18,4,14,
373,0,17,4,13,
374,0,17,4,13,
375,0,18,4,14,
376,0,17,3,14,
377,0,16,3,13,
378,0,19,4,15,
379,0,16,3,13,
380,0,17,4,13,
381,0,16,3,13,
382,0,14,3,11,
383,0,17,4,13,
384,0,15,3,12,
385,0,18,4,14,
386,0,19,4,15,
387,0,16,3,13,
388,0,18,5,13,
389,0,17,4,13,
390,0,16,3,13,
391,0,19,4,15,
392,0,15,3,12,
393,0,17,3,14,
394,0,17,3,14,
395,0,19,4,15,
396,0,17,3,14,
397,0,17,3,14,
398,0,16,4,12,
399,0,15,3,12,
400,0,19,4,15,
401,0,17,3,14,
402,0,17,3,14,
403,0,16,4,12,
404,0,16,3,13,
405,0,18,4,14,
406,0,15,3,12,
407,0,14,3,11,
408,0,18,4,14,
409,0,17,3,14,
410,0,17,4,13,
411,0,18,4,14,
412,0,15,3,12,
413,0,15,3,12,
414,0,16,4,12,
415,0,17,4,13,
416,0,17,3,14,
417,0,17,5,12,
418,0,15,3,12,
419,0,16,4,12,
420,0,15,4,11,
421,0,19,4,15,
422,0,17,3,14,
423,0,17,3,14,
424,0,17,4,13,
425,0,17,4,13,
426,0,16,3,13,
427,0,17,4,13,
428,0,15,3,12,
429,0,14,3,11,
430,0,15,3,12,
431,0,18,4,14,
432,0,17,3,14,
433,0,14,3,11,
434,0,16,4,12,
435,0,15,4,11,
436,0,14,3,11,
437,0,18,4,14,
438,0,17,3,14,
439,0,16,3,13,
440,0,15,4,11,
441,0,15,3,12,
442,0,18,4,14,
443,0,17,3,14,
444,0,15,3,12,
445,0,19,5,14,
446,0,17,3,14,
447,0,16,3,13,
448,0,19,4,15,
449,0,15,3,12,
450,0,15,3,12,
451,0,16,4,12,
452,0,15,3,12,
453,0,16,3,13,
454,0,16,3,13,
455,0,18,4,14,
456,0,17,3,14,
457,0,14,3,11,
458,0,19,5,14,
459,0,17,4,13,
460,0,14,3,11,
461,0,18,4,14,
462,0,17,3,14,
463,0,16,3,13,
464,0,18,4,14,
465,0,15,3,12,
466,0,15,3,12,
467,0,15,3,12,
468,0,16,4,12,
469,0,16,3,13,
470,0,16,3,13,
471,0,21,5,16,
472,0,15,3,12,
473,0,15,3,12,
474,0,18,5,13,
475,0,18,4,14,
476,0,13,3,10,
477,0,16,5,11,
478,0,21,7,14,
479,0,20,6,14,
480,0,19,7,12,
481,0,20,7,13,
482,0,20,6,14,
483,0,21,7,14,
484,0,22,7,15,
485,0,19,6,13,
486,0,19,6,13,
487,0,20,6,14,
488,0,21,7,14,
489,0,21,7,14,
490,0,19,6,13,
491,0,18,5,13,
492,0,21,7,14,
493,0,19,7,12,
494,0,19,6,13,
495,0,19,6,13,
496,0,19,6,13,
497,0,21,7,14,
498,0,20,7,13,
499,0,19,6,13,
500,0,18,5,13,
501,0,18,7,11,
502,0,18,7,11,
503,0,20,7,13,
504,0,21,7,14,
505,0,21,6,15,
506,0,20,7,13,
507,0,19,6,13,
508,0,19,6,13,
509,0,20,7,13,
510,0,18,5,13,
511,0,17,7,10,
512,0,18,6,12,
513,0,20,7,13,
514,0,20,7,13,
515,0,22,7,15,
516,0,21,7,14,
517,0,20,6,14,
518,0,21,7,14,
519,0,19,5,14,
520,0,18,7,11,
521,0,18,5,13,
522,0,19,6,13,
523,0,21,7,14,
524,0,20,7,13,
525,0,21,6,15,
526,0,22,7,15,
527,0,20,6,14,
528,0,19,6,13,
529,0,18,7,11,
530,0,18,6,12,
531,0,20,7,13,
532,0,21,7,14,
533,0,20,6,14,
534,0,19,7,12,
535,0,12,3,9,
540,0,16,5,11,
541,0,20,5,15,
542,0,15,4,11,
543,0,16,4,12,
544,0,16,3,13,
545,0,18,4,14,
546,0,17,3,14,
547,0,13,3,10,
548,0,17,4,13,
549,0,17,3,14,
550,0,15,4,11,
551,0,17,4,13,
552,0,14,3,11,
553,0,14,3,11,
554,0,18,4,14,
555,0,17,3,14,
556,0,16,3,13,
557,0,16,4,12,
558,0,17,3,14,
559,0,14,3,11,
560,0,15,3,12,
561,0,16,4,12,
562,0,17,3,14,
563,0,17,3,14,
564,0,17,4,13,
565,0,17,5,12,
566,0,16,3,13,
567,0,13,3,10,
568,0,18,5,13,
569,0,16,3,13,
570,0,16,3,13,
571,0,19,4,15,
572,0,16,5,11,
573,0,15,3,12,
574,0,18,4,14,
575,0,17,5,12,
576,0,16,4,12,
577,0,16,3,13,
578,0,16,3,13,
579,0,16,4,12,
580,0,14,3,11,
581,0,15,4,11,
582,0,15,3,12,
583,0,15,3,12,
584,0,19,4,15,
585,0,17,3,14,
586,0,18,4,14,
587,0,17,4,13,
588,0,16,3,13,
589,0,16,3,13,
590,0,17,4,13,
591,0,17,3,14,
592,0,16,4,12,
593,0,16,3,13,
594,0,16,4,12,
595,0,19,4,15,
596,0,17,3,14,
597,0,16,4,12,
598,0,16,3,13,
599,0,16,4,12,
600,0,19,4,15,
601,0,14,3,11,
602,0,17,4,13,
603,0,17,3,14,
604,0,16,3,13,
605,0,15,4,11,
606,0,18,4,14,
607,0,14,3,11,
608,0,15,3,12,
609,0,17,5,12,
610,0,17,3,14,
611,0,18,4,14,
612,0,18,3,15,
613,0,14,3,11,
614,0,16,4,12,
615,0,18,4,14,
616,0,17,3,14,
617,0,13,3,10,
618,0,17,4,13,
619,0,17,3,14,
620,0,16,3,13,
621,0,19,4,15,
622,0,17,3,14,
623,0,14,3,11,
624,0,17,4,13,
625,0,16,3,13,
626,0,19,5,14,
627,0,14,3,11,
628,0,18,4,14,
629,0,14,3,11,
630,0,14,3,11,
631,0,16,4,12,
632,0,18,4,14,
633,0,18,3,15,
634,0,14,3,11,
635,0,17,4,13,
636,0,16,3,13,
637,0,16,3,13,
638,0,18,4,14,
639,0,15,3,12,
640,0,15,3,12,
641,0,18,4,14,
642,0,16,3,13,
643,0,18,4,14,
644,0,15,3,12,
645,0,15,3,12,
646,0,19,4,15,
647,0,16,3,13,
648,0,16,4,12,
649,0,15,3,12,
650,0,15,3,12,
651,0,17,4,13,
652,0,16,3,13,
653,0,16,3,13,
654,0,19,4,15,
655,0,16,4,12,
656,0,17,5,12,
657,0,18,4,14,
658,0,17,3,14,
659,0,13,3,10,
660,0,15,4,11,
661,0,17,3,14,
662,0,18,5,13,
663,0,15,3,12,
664,0,17,4,13,
665,0,17,3,14,
666,0,16,3,13,
667,0,19,4,15,
668,0,18,3,15,
669,0,14,3,11,
670,0,17,4,13,
671,0,16,3,13,
672,0,16,4,12,
673,0,17,4,13,
674,0,16,3,13,
675,0,17,3,14,
676,0,17,4,13,
677,0,15,3,12,
678,0,16,3,13,
679,0,16,3,13,
680,0,18,4,14,
681,0,17,3,14,
682,0,15,4,11,
683,0,16,3,13,
684,0,15,3,12,
685,0,18,4,14,
686,0,18,4,14,
687,0,19,6,13,
688,0,18,4,14,
689,0,16,3,13,
690,0,16,3,13,
691,0,19,4,15,
692,0,15,3,12,
693,0,15,4,11,
694,0,18,4,14,
695,0,17,3,14,
696,0,16,3,13,
697,0,17,4,13,
698,0,16,3,13,
699,0,14,3,11,
700,0,15,4,11,
701,0,15,3,12,
702,0,18,4,14,
703,0,17,3,14,
704,0,19,4,15,
705,0,15,3,12,
706,0,15,3,12,
707,0,17,4,13,
708,0,18,4,14,
709,0,17,3,14,
710,0,17,4,13,
711,0,16,3,13,
712,0,15,3,12,
713,0,18,4,14,
714,0,18,4,14,
715,0,15,3,12,
716,0,17,4,13,
717,0,15,3,12,
718,0,17,4,13,
719,0,17,3,14,
720,0,16,4,12,
721,0,15,3,12,
722,0,15,3,12,
723,0,19,4,15,
724,0,17,3,14,
725,0,14,3,11,
726,0,18,4,14,
727,0,14,3,11,
728,0,15,3,12,
729,0,16,4,12,
730,0,17,3,14,
731,0,18,4,14,
732,0,16,4,12,
733,0,15,3,12,
734,0,19,4,15,
735,0,18,5,13,
736,0,16,3,13,
737,0,16,3,13,
738,0,17,4,13,
739,0,17,3,14,
740,0,17,3,14,
741,0,14,3,11,
742,0,16,4,12,
743,0,18,4,14,
744,0,16,3,13,
745,0,19,4,15,
746,0,15,4,11,
747,0,16,5,11,
748,0,17,4,13,
749,0,18,4,14,
750,0,18,4,14,
751,0,17,4,13,
752,0,16,3,13,
753,0,16,4,12,
754,0,19,4,15,
755,0,17,4,13,
756,0,16,3,13,
757,0,16,4,12,
758,0,17,3,14,
759,0,17,3,14,
760,0,16,3,13,
761,0,16,4,12,
762,0,16,3,13,
763,0,16,3,13,
764,0,19,4,15,
765,0,17,3,14,
766,0,14,3,11,
767,0,18,4,14,
768,0,19,5,14,
769,0,17,3,14,
770,0,15,4,11,
771,0,16,3,13,
772,0,14,3,11,
773,0,14,3,11,
774,0,16,4,12,
775,0,17,4,13,
776,0,18,4,14,
777,0,18,5,13,
778,0,16,3,13,
779,0,17,4,13,
780,0,17,3,14,
781,0,17,5,12,
782,0,15,4,11,
783,0,14,3,11,
784,0,17,4,13,
785,0,16,3,13,
786,0,16,3,13,
787,0,18,4,14,
788,0,15,3,12,
789,0,16,3,13,
790,0,17,4,13,
791,0,17,3,14,
792,0,19,4,15,
793,0,14,3,11,
794,0,17,4,13,
795,0,17,3,14,
796,0,16,3,13,
797,0,16,4,12,
798,0,15,3,12,
799,0,18,4,14,
800,0,15,3,12,
801,0,15,3,12,
802,0,13,3,10,
803,0,16,4,12,
804,0,17,4,13,
805,0,18,4,14,
806,0,17,3,14,
807,0,18,4,14,
808,0,16,4,12,
809,0,18,4,14,
810,0,16,3,13,
811,0,16,3,13,
812,0,17,4,13,
813,0,15,3,12,
814,0,14,3,11,
815,0,16,4,12,
816,0,18,4,14,
817,0,17,3,14,
818,0,14,3,11,
819,0,17,4,13,
820,0,17,3,14,
821,0,16,3,13,
822,0,19,4,15,
823,0,17,4,13,
824,0,16,3,13,
825,0,16,3,13,
826,0,19,4,15,
827,0,14,3,11,
828,0,14,3,11,
829,0,18,4,14,
830,0,16,3,13,
831,0,16,4,12,
832,0,16,3,13,
833,0,14,3,11,
834,0,18,4,14,
835,0,15,3,12,
836,0,18,4,14,
837,0,17,3,14,
838,0,21,6,15,
839,0,15,3,12,
840,0,16,4,12,
841,0,18,4,14,
842,0,17,3,14,
843,0,18,4,14,
844,0,16,5,11,
845,0,18,4,14,
846,0,15,3,12,
847,0,18,4,14,
848,0,16,3,13,
849,0,16,3,13,
850,0,13,3,10,
851,0,16,4,12,
852,0,16,3,13,
853,0,16,3,13,
854,0,18,4,14,
855,0,15,3,12,
856,0,15,3,12,
857,0,19,4,15,
858,0,17,3,14,
859,0,19,4,15,
860,0,16,4,12,
861,0,17,3,14,
862,0,17,3,14,
863,0,17,3,14,
864,0,15,4,11,
865,0,16,3,13,
866,0,14,3,11,
867,0,14,3,11,
868,0,17,4,13,
869,0,18,4,14,
870,0,15,3,12,
871,0,17,4,13,
872,0,16,3,13,
873,0,16,3,13,
874,0,19,4,15,
875,0,17,4,13,
876,0,14,3,11,
877,0,16,4,12,
878,0,17,3,14,
879,0,15,3,12,
880,0,15,4,11,
881,0,16,3,13,
882,0,17,3,14,
883,0,16,3,13,
884,0,18,4,14,
885,0,19,5,14,
886,0,17,3,14,
887,0,17,3,14,
888,0,17,4,13,
889,0,20,6,14,
890,0,16,4,12,
891,0,18,5,13,
892,0,21,7,14,
893,0,18,7,11,
894,0,18,6,12,
895,0,20,7,13,
896,0,20,6,14,
897,0,22,7,15,
898,0,21,7,14,
899,0,21,5,16,
900,0,19,6,13,
901,0,19,6,13,
902,0,20,7,13,
903,0,19,6,13,
904,0,19,6,13,
905,0,19,7,12,
906,0,19,5,14,
907,0,19,6,13,
908,0,20,7,13,
909,0,18,5,13,
910,0,17,6,11,
911,0,17,6,11,
912,0,18,5,13,
913,0,18,4,13,1
914,0,18,4,14,
915,0,18,3,15,
916,0,16,3,13,
917,0,18,4,14,
918,0,16,3,13,
919,0,16,3,13,
920,0,17,4,12,1
921,0,16,3,13,
922,0,16,5,11,
923,0,15,3,12,
924,0,15,3,12,
925,0,18,4,14,
926,0,17,4,13,
927,0,19,4,15,
928,0,21,4,16,1
929,0,14,3,11,
930,0,17,4,13,
931,0,18,5,13,
932,0,18,4,14,
933,0,15,3,12,
934,0,16,4,12,
935,0,14,3,11,
936,0,17,4,13,
937,0,16,3,13,
938,0,16,3,13,
939,0,19,4,15,
940,0,18,3,15,
941,0,15,3,12,
942,0,16,4,12,
943,0,17,3,13,1
944,0,19,4,15,
945,0,19,4,15,
946,0,15,3,12,
947,0,15,4,11,
948,0,16,3,13,
949,0,16,3,13,
950,0,15,4,11,
951,0,14,3,11,
952,0,16,4,12,
953,0,15,3,12,
954,0,15,3,12,
955,0,17,4,13,
956,0,18,4,14,
957,0,18,3,15,
958,0,19,4,14,1
959,0,17,4,13,
960,0,16,3,13,
961,0,16,3,13,
962,0,18,4,14,
963,0,18,4,14,
964,0,15,3,12,
965,0,17,4,13,
966,0,17,4,13,
967,0,13,3,10,
968,0,18,4,14,
969,0,17,3,14,
970,0,18,3,15,
971,0,16,4,12,
972,0,16,3,13,
973,0,16,3,13,
974,0,17,4,13,
975,0,17,5,12,
976,0,17,4,13,
977,0,16,3,13,
978,0,16,3,13,
979,0,19,4,15,
980,0,17,3,14,
981,0,17,4,13,
982,0,16,3,13,
983,0,17,4,13,
984,0,18,4,14,
985,0,15,3,12,
986,0,16,4,12,
987,0,17,4,13,
988,0,17,3,14,
989,0,20,4,15,1
990,0,17,3,14,
991,0,15,4,11,
992,0,18,4,14,
993,0,16,3,13,
994,0,16,4,12,
995,0,17,4,13,
996,0,16,3,13,
997,0,17,5,12,
998,0,17,4,13,
999,0,19,7,12,
1000,0,20,6,14,
1001,0,22,7,15,
1002,0,18,7,11,
1003,0,20,7,13,
1004,0,21,7,14,
1005,0,20,6,14,
1006,0,22,7,15,
1007,0,21,7,14,
1008,0,18,6,12,
1009,0,20,7,13,
1010,0,21,7,14,
1011,0,18,6,12,
1012,0,18,7,11,
1013,0,19,6,13,
1014,0,18,7,11,
1015,0,19,6,13,
1016,0,21,7,14,
1017,0,21,7,14,
1018,0,21,6,15,
1019,0,23,7,15,1
1020,0,19,7,12,
1021,0,20,6,14,
1022,0,18,5,13,
1023,0,21,7,14,
1024,0,21,7,14,
1025,0,19,6,13,
1026,0,18,5,13,
1027,0,21,7,14,
1028,0,18,6,12,
1029,0,18,6,12,
1030,0,19,6,13,
1031,0,21,7,14,
1032,0,21,6,15,
1033,0,22,7,15,
1034,0,22,7,15,
1035,0,20,6,14,
1036,0,19,6,13,
1037,0,18,7,11,
1038,0,18,6,12,
1039,0,20,7,13,
1040,0,20,6,14,
1041,0,21,7,14,
1042,0,19,7,12,
1043,0,18,6,12,
1044,0,21,7,14,
1045,0,20,6,14,
1046,0,19,4,15,
1047,0,16,3,13,
1048,0,15,4,11,
1049,0,16,3,13,
1050,0,17,3,13,1
1051,0,17,4,13,
1052,0,14,3,11,
1053,0,18,4,14,
1054,0,17,3,14,
1055,0,14,3,11,
1056,0,15,3,12,
1057,0,16,4,12,
1058,0,15,3,12,
1059,0,15,3,12,
1060,0,19,4,15,
1061,0,17,3,14,
1062,0,15,3,12,
1063,0,16,4,12,
1064,0,17,3,14,
1065,0,19,4,15,
1066,0,18,4,14,
1067,0,15,3,12,
1068,0,16,3,13,
1069,0,19,4,15,
1070,0,17,3,14,
1071,0,18,4,14,
1072,0,17,4,13,
1073,0,15,3,12,
1074,0,18,4,14,
1075,0,17,3,14,
1076,0,14,3,11,
1077,0,16,4,12,
1078,0,15,3,12,
1079,0,18,4,14,
1080,0,19,3,15,1
1081,0,14,3,11,
1082,0,18,4,14,
1083,0,17,4,13,
1084,0,14,3,11,
1085,0,18,4,14,
1086,0,17,3,14,
1087,0,16,3,13,
1088,0,17,4,13,
1089,0,15,3,12,
1090,0,16,3,13,
1091,0,15,3,12,
1092,0,18,4,14,
1093,0,17,3,14,
1094,0,14,3,11,
1095,0,18,4,14,
1096,0,14,3,11,
1097,0,14,3,11,
1098,0,18,4,14,
1099,0,17,3,14,
1100,0,17,4,13,
1101,0,17,3,14,
1102,0,17,4,13,
1103,0,16,3,13,
1104,0,16,4,12,
1105,0,17,3,14,
1106,0,17,3,14,
1107,0,16,3,13,
1108,0,17,5,12,
1109,0,16,3,13,
1110,0,18,4,13,1
1111,0,19,5,14,
1112,0,15,3,12,
1113,0,17,4,13,
1114,0,17,4,13,
1115,0,15,3,12,
1116,0,15,3,12,
1117,0,18,5,13,
1118,0,17,3,14,
1119,0,19,4,15,
1120,0,16,4,12,
1121,0,17,4,13,
1122,0,16,3,13,
1123,0,16,3,13,
1124,0,18,4,14,
1125,0,16,3,13,
1126,0,14,3,11,
1127,0,19,5,14,
1128,0,17,4,13,
1129,0,15,4,11,
1130,0,17,4,13,
1131,0,16,3,13,
1132,0,18,4,14,
1133,0,17,4,13,
1134,0,17,3,14,
1135,0,16,3,13,
1136,0,16,3,13,
1137,0,17,4,13,
1138,0,7,1,6,
1140,0,3,2,1,
1141,0,16,4,11,1
1142,0,17,5,12,
1143,0,15,3,12,
1144,0,14,3,11,
1145,0,15,4,11,
1146,0,14,3,11,
1147,0,13,4,9,
1148,0,15,4,11,
1149,0,13,3,10,
1150,0,13,3,10,
1151,0,16,4,12,
1152,0,15,3,12,
1153,0,13,3,10,
1154,0,15,4,11,
1155,0,14,3,11,
1156,0,13,3,10,
1157,0,14,4,10,
1158,0,12,3,9,
1159,0,15,4,11,
1160,0,13,3,10,
1161,0,14,4,10,
1162,0,14,3,11,
1163,0,15,3,12,
1164,0,14,4,10,
1165,0,15,5,10,
1166,0,14,3,11,
1167,0,12,3,9,
1168,0,17,5,12,
1169,0,13,3,10,
1170,0,15,5,10,
1171,0,18,5,12,1
1172,0,15,3,12,
1173,0,15,3,12,
1174,0,16,4,12,
1175,0,14,3,11,
1176,0,14,3,11,
1177,0,14,4,10,
1178,0,14,4,10,
1179,0,16,5,11,
1180,0,13,3,10,
1181,0,14,4,10,
1182,0,14,4,10,
1183,0,14,3,11,
1184,0,14,4,10,
1185,0,14,4,10,
1186,0,14,3,11,
1187,0,15,3,12,
1188,0,15,4,11,
1189,0,14,3,11,
1190,0,15,5,10,
1191,0,14,4,10,
1192,0,15,4,11,
1193,0,12,3,9,
1194,0,15,4,11,
1195,0,14,3,11,
1196,0,14,3,11,
1197,0,12,3,9,
1198,0,17,6,11,
1199,0,14,3,11,
1200,0,13,3,10,
1201,0,17,5,11,1
1202,0,14,4,10,
1203,0,14,3,11,
1204,0,15,4,11,
1205,0,17,4,13,
1206,0,15,3,12,
1207,0,15,3,12,
1208,0,16,5,11,
1209,0,14,3,11,
1210,0,15,4,11,
1211,0,15,4,11,
1212,0,15,4,11,
1213,0,13,3,10,
1214,0,14,4,10,
1215,0,14,4,10,
1216,0,14,3,11,
1217,0,13,3,10,
1218,0,14,4,10,
1219,0,14,3,11,
1220,0,15,3,12,
1221,0,15,4,11,
1222,0,14,3,11,
1223,0,14,4,10,
1224,0,14,4,10,
1225,0,14,3,11,
1226,0,12,3,9,
1227,0,15,4,11,
1228,0,16,4,12,
1229,0,16,4,12,
1230,0,14,3,11,
1231,0,15,4,11,
1232,0,14,3,10,1
1233,0,14,4,10,
1234,0,13,3,10,
1235,0,13,4,9,
1236,0,17,4,13,
1237,0,13,3,10,
1238,0,17,4,13,
1239,0,14,3,11,
1240,0,14,3,11,
1241,0,15,4,11,
1242,0,14,4,10,
1243,0,13,3,10,
1244,0,13,4,9,
1245,0,14,3,11,
1246,0,12,3,9,
1247,0,13,3,10,
1248,0,16,5,11,
1249,0,15,3,12,
1250,0,15,4,11,
1251,0,15,5,10,
1252,0,14,3,11,
1253,0,14,4,10,
1254,0,14,3,11,
1255,0,14,4,10,
1256,0,14,3,11,
1257,0,12,3,9,
1258,0,16,4,12,
1259,0,15,4,11,
1260,0,14,3,11,
1261,0,14,4,10,
1262,0,15,3,11,1
1263,0,14,3,11,
1264,0,12,3,9,
1265,0,15,4,11,
1266,0,12,3,9,
1267,0,17,4,13,
1268,0,15,4,11,
1269,0,14,3,11,
1270,0,16,4,12,
1271,0,13,3,10,
1272,0,13,3,10,
1273,0,15,4,11,
1274,0,14,3,11,
1275,0,13,3,10,
1276,0,14,4,10,
1277,0,14,3,11,
1278,0,15,3,12,
1279,0,13,3,10,
1280,0,14,4,10,
1281,0,14,3,11,
1282,0,12,3,9,
1283,0,16,4,12,
1284,0,12,3,9,
1285,0,16,4,12,
1286,0,14,3,11,
1287,0,14,3,11,
1288,0,16,4,12,
1289,0,14,4,10,
1290,0,15,4,11,
1291,0,13,3,10,
1292,0,16,4,11,1
1293,0,15,4,11,
1294,0,17,5,12,
1295,0,15,4,11,
1296,0,14,3,11,
1297,0,14,3,11,
1298,0,15,4,11,
1299,0,15,4,11,
1300,0,12,3,9,
1301,0,14,4,10,
1302,0,14,4,10,
1303,0,14,3,11,
1304,0,12,3,9,
1305,0,16,4,12,
1306,0,14,3,11,
1307,0,14,3,11,
1308,0,16,4,12,
1309,0,14,4,10,
1310,0,13,3,10,
1311,0,15,4,11,
1312,0,14,3,11,
1313,0,13,3,10,
1314,0,15,5,10,
1315,0,14,3,11,
1316,0,15,3,12,
1317,0,13,3,10,
1318,0,14,4,10,
1319,0,17,6,11,
1320,0,14,4,10,
1321,0,14,3,11,
1322,0,13,4,9,
1323,0,15,4,10,1
1324,0,15,4,11,
1325,0,14,3,11,
1326,0,13,3,10,
1327,0,14,3,11,
1328,0,16,4,12,
1329,0,16,4,12,
1330,0,13,3,10,
1331,0,15,4,11,
1332,0,14,3,11,
1333,0,12,3,9,
1334,0,13,3,10,
1335,0,14,4,10,
1336,0,14,3,11,
1337,0,12,3,9,
1338,0,17,4,13,
1339,0,14,3,11,
1340,0,14,3,11,
1341,0,16,4,12,
1342,0,13,3,10,
1343,0,14,4,10,
1344,0,16,4,12,
1345,0,15,3,12,
1346,0,12,3,9,
1347,0,17,4,13,
1348,0,14,3,11,
1349,0,15,3,12,
1350,0,15,4,11,
1351,0,14,3,11,
1352,0,16,4,12,
1353,0,15,4,10,1
1354,0,13,3,10,
1355,0,13,4,9,
1356,0,13,3,10,
1357,0,15,4,11,
1358,0,15,4,11,
1359,0,13,4,9,
1360,0,17,4,13,
1361,0,14,3,11,
1362,0,15,3,12,
1363,0,14,4,10,
1364,0,13,3,10,
1365,0,14,3,11,
1366,0,12,3,9,
1367,0,15,4,11,
1368,0,13,3,10,
1369,0,16,4,12,
1370,0,14,3,11,
1371,0,14,3,11,
1372,0,13,4,9,
1373,0,15,4,11,
1374,0,15,4,11,
1375,0,14,4,10,
1376,0,13,3,10,
1377,0,15,4,11,
1378,0,14,3,11,
1379,0,14,3,11,
1380,0,14,3,11,
1381,0,15,4,11,
1382,0,14,3,11,
1383,0,15,4,11,
1384,0,16,3,12,1
1385,0,13,3,10,
1386,0,15,4,11,
1387,0,17,6,11,
1388,0,17,7,10,
1389,0,17,6,11,
1390,0,17,7,10,
1391,0,18,7,11,
1392,0,17,6,11,
1393,0,17,6,11,
1394,0,17,7,10,
1395,0,19,7,12,
1396,0,17,6,11,
1397,0,17,6,11,
1398,0,18,7,11,
1399,0,17,6,11,
1400,0,17,7,10,
1401,0,18,7,11,
1402,0,16,6,10,
1403,0,19,7,12,
1404,0,16,6,10,
1405,0,19,7,12,
1406,0,18,7,11,
1407,0,16,5,11,
1408,0,18,7,11,
1409,0,19,7,12,
1410,0,18,7,11,
1411,0,19,7,12,
1412,0,17,6,11,
1413,0,19,7,12,
1414,0,18,7,10,1
1415,0,18,6,12,
1416,0,19,7,12,
1417,0,18,6,12,
1418,0,15,4,11,
1419,0,15,4,11,
1420,0,15,4,11,
1421,0,13,3,10,
1422,0,14,3,11,
1423,0,14,4,10,
1424,0,15,3,12,
1425,0,13,3,10,
1426,0,14,3,11,
1427,0,13,4,9,
1428,0,15,3,12,
1429,0,16,4,12,
1430,0,14,3,11,
1431,0,15,4,11,
1432,0,13,3,10,
1433,0,13,3,10,
1434,0,15,4,11,
1435,0,14,3,11,
1436,0,12,3,9,
1437,0,17,4,13,
1438,0,14,3,11,
1439,0,15,3,12,
1440,0,14,4,10,
1441,0,12,3,9,
1442,0,16,4,12,
1443,0,13,3,10,
1444,0,15,4,10,1
1445,0,15,4,11,
1446,0,14,3,11,
1447,0,16,5,11,
1448,0,15,3,12,
1449,0,14,3,11,
1450,0,16,4,12,
1451,0,15,4,11,
1452,0,13,3,10,
1453,0,13,3,10,
1454,0,15,4,11,
1455,0,14,3,11,
1456,0,12,3,9,
1457,0,18,5,13,
1458,0,15,3,12,
1459,0,16,3,13,
1460,0,13,3,10,
1461,0,15,4,11,
1462,0,14,3,11,
1463,0,13,3,10,
1464,0,14,4,10,
1465,0,14,4,10,
1466,0,14,3,11,
1467,0,12,3,9,
1468,0,16,4,12,
1469,0,14,3,11,
1470,0,14,3,11,
1471,0,17,5,12,
1472,0,13,3,10,
1473,0,13,3,10,
1474,0,17,5,12,
1475,0,17,4,12,1
1476,0,15,3,12,
1477,0,17,4,13,
1478,0,17,3,14,
1479,0,17,3,14,
1480,0,19,5,14,
1481,0,20,4,16,
1482,0,18,3,15,
1483,0,18,3,15,
1484,0,18,4,14,
1485,0,19,3,16,
1486,0,21,3,18,
1487,0,21,3,18,
1488,0,24,4,20,
1489,0,24,4,20,
1490,0,23,4,19,
1491,0,27,5,22,
1492,0,24,3,21,
1493,0,24,3,21,
1494,0,27,4,23,
1495,0,25,3,22,
1496,0,26,3,23,
1497,0,26,4,22,
1498,0,26,3,23,
1499,0,27,3,24,
1500,0,26,3,23,
1501,0,27,4,23,
1502,0,29,4,25,
1503,0,27,3,24,
1504,0,28,4,24,
1505,0,32,5,26,1
1506,0,28,3,25,
1507,0,31,4,27,
1508,0,28,3,25,
1509,0,30,4,26,
1510,0,32,4,28,
1511,0,29,3,26,
1512,0,33,4,29,
1513,0,31,3,28,
1514,0,30,3,27,
1515,0,33,4,29,
1516,0,32,4,28,
1517,0,32,3,29,
1518,0,33,4,29,
1519,0,32,3,29,
1520,0,32,3,29,
1521,0,33,4,29,
1522,0,33,3,30,
1523,0,32,3,29,
1524,0,34,4,30,
1525,0,34,3,31,
1526,0,34,3,31,
1527,0,33,3,30,
1528,0,36,4,32,
1529,0,35,3,32,
1530,0,34,3,31,
1531,0,36,4,32,
1532,0,35,4,31,
1533,0,36,3,33,
1534,0,36,3,33,
1535,0,38,4,33,1
1536,0,35,3,32,
1537,0,36,4,32,
1538,0,37,3,34,
1539,0,36,3,33,
1540,0,37,4,33,
1541,0,38,4,34,
1542,0,40,5,35,
1543,0,41,6,35,
1544,0,38,4,34,
1545,0,39,4,35,
1546,0,39,5,34,
1547,0,42,5,37,
1548,0,40,4,36,
1549,0,40,4,36,
1550,0,40,4,36,
1551,0,40,4,36,
1552,0,41,4,37,
1553,0,40,4,36,
1554,0,41,4,37,
1555,0,41,4,37,
1556,0,41,4,37,
1557,0,39,4,35,
1558,0,40,3,37,
1559,0,42,4,38,
1560,0,42,4,38,
1561,0,43,4,39,
1562,0,41,3,38,
1563,0,43,4,39,
1564,0,44,4,40,
1565,0,43,4,39,
1566,0,42,3,38,1
1567,0,43,4,39,
1568,0,45,4,41,
1569,0,42,3,39,
1570,0,43,4,39,
1571,0,45,4,41,
1572,0,43,4,39,
1573,0,43,3,40,
1574,0,45,4,41,
1575,0,44,4,40,
1576,0,44,3,41,
1577,0,45,4,41,
1578,0,44,4,40,
1579,0,45,3,42,
1580,0,46,4,42,
1581,0,44,3,41,
1582,0,47,4,43,
1583,0,44,4,40,
1584,0,46,4,42,
1585,0,48,4,44,
1586,0,45,3,42,
1587,0,46,4,42,
1588,0,45,3,42,
1589,0,45,4,41,
1590,0,46,3,43,
1591,0,45,3,42,
1592,0,49,4,45,
1593,0,47,3,44,
1594,0,45,3,42,
1595,0,48,4,44,
1596,0,47,3,43,1
1597,0,47,3,44,
1598,0,50,4,46,
1599,0,48,3,45,
1600,0,48,3,45,
1601,0,47,3,44,
1602,0,48,3,45,
1603,0,50,3,47,
1604,0,48,4,44,
1605,0,50,4,46,
1606,0,50,3,47,
1607,0,49,3,46,
1608,0,49,3,46,
1609,0,50,3,47,
1610,0,50,3,47,
1611,0,50,3,47,
1612,0,50,3,47,
1613,0,49,3,46,
1614,0,49,3,46,
1615,0,49,3,46,
1616,0,51,3,48,
1617,0,50,4,46,
1618,0,51,3,48,
1619,0,51,3,48,
1620,0,49,2,47,
1621,0,51,4,47,
1622,0,51,3,48,
1623,0,50,2,48,
1624,0,52,4,48,
1625,0,51,3,48,
1626,0,53,3,49,1
1627,0,52,3,49,
1628,0,52,3,49,
1629,0,51,3,48,
1630,0,54,3,51,
1631,0,54,3,51,
1632,0,54,3,51,
1633,0,54,3,51,
1634,0,54,3,51,
1635,0,52,2,50,
1636,0,54,3,51,
1637,0,53,3,50,
1638,0,54,3,51,
1639,0,55,3,52,
1640,0,56,3,53,
1641,0,55,3,52,
1642,0,53,3,50,
1643,0,54,2,52,
1644,0,56,3,53,
1645,0,56,3,53,
1646,0,56,3,53,
1647,0,57,3,54,
1648,0,53,2,51,
1649,0,56,3,53,
1650,0,57,3,54,
1651,0,57,3,54,
1652,0,55,2,53,
1653,0,55,3,52,
1654,0,56,3,53,
1655,0,57,3,54,
1656,0,58,3,55,
1657,0,56,3,52,1
1658,0,55,2,53,
1659,0,57,3,54,
1660,0,59,3,56,
1661,0,56,3,53,
1662,0,55,2,53,
1663,0,57,3,54,
1664,0,59,3,56,
1665,0,56,2,54,
1666,0,57,3,54,
1667,0,58,3,55,
1668,0,58,3,55,
1669,0,57,2,55,
1670,0,58,3,55,
1671,0,59,3,56,
1672,0,61,3,58,
1673,0,57,2,55,
1674,0,59,3,56,
1675,0,61,3,58,
1676,0,58,2,56,
1677,0,59,3,56,
1678,0,60,3,57,
1679,0,58,3,55,
1680,0,59,2,57,
1681,0,61,3,58,
1682,0,59,3,56,
1683,0,59,3,56,
1684,0,62,3,59,
1685,0,58,2,56,
1686,0,60,3,57,
1687,0,62,3,58,1
1688,0,61,3,58,
1689,0,62,3,59,
1690,0,63,3,60,
1691,0,61,3,58,
1692,0,61,2,59,
1693,0,63,3,60,
1694,0,60,2,58,
1695,0,63,3,60,
1696,0,64,3,61,
1697,0,61,2,59,
1698,0,64,3,61,
1699,0,61,2,59,
1700,0,63,3,60,
1701,0,64,3,61,
1702,0,62,2,60,
1703,0,65,3,62,
1704,0,63,2,61,
1705,0,64,3,61,
1706,0,62,3,59,
1707,0,63,2,61,
1708,0,65,3,62,
1709,0,63,2,61,
1710,0,65,3,62,
1711,0,63,2,61,
1712,0,66,3,63,
1713,0,62,2,60,
1714,0,64,3,61,
1715,0,63,2,61,
1716,0,65,3,62,
1717,0,67,3,63,1
1718,0,64,2,62,
1719,0,68,3,65,
1720,0,64,2,62,
1721,0,67,3,64,
1722,0,65,2,63,
1723,0,68,3,65,
1724,0,64,2,62,
1725,0,67,3,64,
1726,0,65,2,63,
1727,0,68,3,65,
1728,0,64,2,62,
1729,0,68,3,65,
1730,0,65,2,63,
1731,0,68,3,65,
1732,0,66,2,64,
1733,0,68,3,65,
1734,0,65,2,63,
1735,0,69,3,66,
1736,0,67,2,65,
1737,0,69,3,66,
1738,0,66,2,64,
1739,0,67,3,64,
1740,0,66,2,64,
1741,0,66,3,63,
1742,0,68,2,66,
1743,0,66,2,64,
1744,0,70,3,67,
1745,0,66,2,64,
1746,0,70,3,67,
1747,0,68,2,66,
1748,0,72,3,68,1
1749,0,67,2,65,
1750,0,67,3,64,
1751,0,69,2,67,
1752,0,68,2,66,
1753,0,70,3,67,
1754,0,68,2,66,
1755,0,71,3,68,
1756,0,70,2,68,
1757,0,68,2,66,
1758,0,70,3,67,
1759,0,69,2,67,
1760,0,73,3,70,
1761,0,70,2,68,
1762,0,69,2,67,
1763,0,71,3,68,
1764,0,69,2,67,
1765,0,73,3,70,
1766,0,70,2,68,
1767,0,69,2,67,
1768,0,73,3,70,
1769,0,70,2,68,
1770,0,74,3,71,
1771,0,72,2,70,
1772,0,70,2,68,
1773,0,74,3,71,
1774,0,70,2,68,
1775,0,70,2,68,
1776,0,74,3,71,
1777,0,72,2,70,
1778,0,72,3,68,1
1779,0,72,2,70,
1780,0,71,2,69,
1781,0,75,3,72,
1782,0,73,2,71,
1783,0,71,2,69,
1784,0,74,3,71,
1785,0,74,2,72,
1786,0,72,2,70,
1787,0,75,3,72,
1788,0,74,2,72,
1789,0,72,2,70,
1790,0,75,3,72,
1791,0,74,2,72,
1792,0,72,2,70,
1793,0,76,3,73,
1794,0,72,2,70,
1795,0,73,2,71,
1796,0,75,3,72,
1797,0,74,2,72,
1798,0,72,2,70,
1799,0,75,3,72,
1800,0,74,2,72,
1801,0,72,2,70,
1802,0,65,3,62,
1803,0,56,2,54,
1804,0,48,2,46,
1805,0,47,3,44,
1806,0,44,2,42,
1807,0,41,2,39,
1808,0,39,3,35,1
1809,0,33,2,31,
1810,0,29,2,27,
1811,0,30,3,27,
1812,0,27,3,24,
1813,0,27,2,25,
1814,0,32,3,29,
1815,0,36,3,33,
1816,0,42,3,39,
1817,0,47,3,44,
1818,0,47,3,44,
1819,0,46,3,43,
1820,0,48,3,45,
1821,0,46,3,43,
1822,0,47,3,44,
1823,0,46,3,43,
1824,0,46,3,43,
1825,0,46,3,43,
1826,0,47,4,43,
1827,0,49,3,46,
1828,0,49,3,46,
1829,0,48,3,45,
1830,0,50,3,47,
1831,0,48,3,45,
1832,0,48,3,45,
1833,0,48,3,45,
1834,0,49,4,45,
1835,0,49,3,46,
1836,0,49,3,46,
1837,0,49,3,46,
1838,0,49,3,46,
1839,0,50,3,47,
1840,0,50,3,47,
1841,0,52,4,48,
1842,0,51,3,48,
1843,0,52,3,49,
1844,0,51,3,48,
1845,0,51,3,48,
1846,0,52,3,49,
1847,0,51,3,48,
1848,0,50,3,47,
1849,0,50,4,46,
1850,0,50,2,48,
1851,0,52,4,48,
1852,0,53,3,50,
1853,0,53,3,50,
1854,0,53,3,50,
1855,0,54,3,51,
1856,0,55,3,52,
1857,0,54,3,51,
1858,0,54,3,51,
1859,0,54,3,51,
1860,0,55,3,52,
1861,0,55,3,52,
1862,0,54,3,51,
1863,0,54,3,51,
1864,0,52,3,49,
1865,0,51,2,49,
1866,0,53,4,49,
1867,0,53,3,50,
1868,0,54,3,51,
1869,0,55,3,52,
1870,0,54,3,51,
1871,0,55,3,52,
1872,0,56,3,53,
1873,0,56,3,53,
1874,0,57,3,54,
1875,0,59,3,56,
1876,0,58,3,55,
1877,0,54,2,52,
1878,0,55,3,52,
1879,0,55,3,52,
1880,0,57,3,54,
1881,0,58,3,55,
1882,0,57,3,54,
1883,0,58,3,55,
1884,0,58,3,55,
1885,0,59,3,56,
1886,0,56,2,54,
1887,0,57,3,54,
1888,0,58,3,55,
1889,0,58,3,55,
1890,0,58,3,55,
1891,0,60,3,57,
1892,0,57,3,54,
1893,0,57,2,55,
1894,0,60,3,57,
1895,0,59,3,56,
1896,0,60,3,57,
1897,0,58,2,56,
1898,0,59,3,56,
1899,0,63,3,60,
1900,0,62,3,59,
1901,0,59,3,56,
1902,0,59,2,57,
1903,0,60,3,57,
1904,0,61,3,58,
1905,0,59,3,56,
1906,0,59,2,57,
1907,0,61,3,58,
1908,0,63,3,60,
1909,0,62,3,59,
1910,0,60,2,58,
1911,0,62,3,59,
1912,0,64,3,61,
1913,0,61,2,59,
1914,0,63,3,60,
1915,0,63,3,60,
1916,0,61,3,58,
1917,0,60,2,58,
1918,0,63,3,60,
1919,0,65,3,62,
1920,0,61,2,59,
1921,0,64,3,61,
1922,0,65,3,62,
1923,0,62,2,60,
1924,0,63,3,60,
1925,0,65,3,62,
1926,0,63,2,61,
1927,0,65,3,62,
1928,0,66,3,63,
1929,0,63,2,61,
1930,0,65,3,62,
1931,0,66,3,63,
1932,0,63,2,61,
1933,0,67,3,64,
1934,0,64,2,62,
1935,0,65,3,62,
1936,0,68,3,65,
1937,0,63,2,61,
1938,0,67,3,64,
1939,0,64,2,62,
1940,0,67,3,64,
1941,0,64,2,62,
1942,0,66,3,63,
1943,0,68,3,65,
1944,0,64,2,62,
1945,0,68,3,65,
1946,0,66,3,63,
1947,0,67,2,65,
1948,0,69,3,66,
1949,0,67,2,65,
1950,0,68,3,65,
1951,0,66,2,64,
1952,0,69,3,66,
1953,0,66,2,64,
1954,0,69,3,66,
1955,0,67,3,64,
1956,0,68,2,66,
1957,0,68,3,65,
1958,0,67,2,65,
1959,0,70,3,67,
1960,0,68,2,66,
1961,0,71,3,68,
1962,0,69,2,67,
1963,0,71,3,68,
1964,0,69,2,67,
1965,0,72,3,69,
1966,0,69,2,67,
1967,0,71,3,68,
1968,0,69,2,67,
1969,0,73,3,70,
1970,0,70,2,68,
1971,0,73,3,70,
1972,0,69,2,67,
1973,0,73,3,70,
1974,0,70,2,68,
1975,0,70,3,67,
1976,0,70,2,68,
1977,0,70,2,68,
1978,0,72,3,69,
1979,0,69,2,67,
1980,0,73,3,70,
1981,0,69,2,67,
1982,0,73,3,70,
1983,0,70,2,68,
1984,0,74,3,71,
1985,0,71,2,69,
1986,0,74,3,71,
1987,0,74,2,72,
1988,0,71,2,69,
1989,0,73,3,70,
1990,0,72,2,70,
1991,0,75,3,72,
1992,0,73,2,71,
1993,0,76,3,73,
1994,0,73,2,71,
1995,0,73,3,70,
1996,0,77,3,74,
1997,0,72,2,70,
1998,0,75,3,72,
1999,0,73,2,71,
2000,0,74,3,71,
2001,0,73,2,71,
2002,0,72,2,70,
2003,0,74,3,71,
2004,0,72,2,70,
2005,0,76,3,73,
2006,0,73,2,71,
2007,0,67,3,64,
2008,0,57,2,55,
2009,0,49,2,47,
2010,0,46,3,43,
2011,0,43,2,41,
2012,0,40,2,38,
2013,0,38,3,35,
2014,0,31,2,29,
2015,0,26,3,23,
2016,0,20,2,18,
2017,0,17,3,14,
2018,0,15,3,12,
2019,0,15,3,12,
2020,0,15,3,12,
2021,0,24,4,20,
2022,0,29,3,26,
2023,0,30,3,27,
2024,0,32,4,28,
2025,0,31,3,28,
2026,0,31,4,27,
2027,0,33,4,29,
2028,0,32,3,29,
2029,0,31,3,28,
2030,0,34,4,30,
2031,0,33,3,30,
2032,0,32,3,29,
2033,0,33,4,29,
2034,0,33,3,30,
2035,0,33,3,30,
2036,0,33,3,30,
2037,0,35,4,31,
2038,0,35,4,31,
2039,0,36,4,32,
2040,0,35,3,32,
2041,0,36,4,32,
2042,0,36,3,33,
2043,0,36,3,33,
2044,0,36,4,32,
2045,0,36,3,33,
2046,0,36,3,33,
2047,0,36,3,33,
2048,0,38,4,34,
2049,0,37,3,34,
2050,0,37,4,33,
2051,0,39,4,35,
2052,0,40,5,35,
2053,0,38,4,34,
2054,0,40,4,36,
2055,0,39,3,36,
2056,0,40,4,36,
2057,0,39,4,35,
2058,0,39,3,36,
2059,0,39,3,36,
2060,0,39,3,36,
2061,0,42,5,37,
2062,0,40,3,37,
2063,0,39,3,36,
2064,0,43,4,39,
2065,0,41,3,38,
2066,0,40,3,37,
2067,0,43,4,39,
2068,0,41,3,38,
2069,0,41,3,38,
2070,0,43,4,39,
2071,0,42,3,39,
2072,0,41,3,38,
2073,0,42,4,38,
2074,0,42,3,39,
2075,0,45,4,41,
2076,0,44,4,40,
2077,0,42,3,39,
2078,0,45,4,41,
2079,0,44,3,41,
2080,0,46,4,42,
2081,0,44,3,41,
2082,0,43,3,40,
2083,0,46,4,42,
2084,0,45,3,42,
2085,0,44,3,41,
2086,0,46,4,42,
2087,0,45,4,41,
2088,0,46,4,42,
2089,0,45,3,42,
2090,0,45,3,42,
2091,0,47,4,43,
2092,0,47,4,43,
2093,0,45,3,42,
2094,0,48,4,44,
2095,0,45,3,42,
2096,0,49,4,45,
2097,0,47,4,43,
2098,0,47,3,44,
2099,0,47,3,44,
2100,0,48,4,44,
2101,0,49,4,45,
2102,0,50,4,46,
2103,0,48,3,45,
2104,0,48,3,45,
2105,0,48,4,44,
2106,0,48,3,45,
2107,0,50,4,46,
2108,0,50,4,46,
2109,0,48,3,45,
2110,0,49,4,45,
2111,0,51,4,47,
2112,0,49,3,46,
2113,0,50,3,47,
2114,0,50,4,46,
2115,0,51,3,48,
2116,0,50,3,47,
2117,0,49,3,46,
2118,0,49,3,46,
2119,0,53,4,49,
2120,0,52,3,49,
2121,0,51,3,48,
2122,0,50,3,47,
2123,0,51,3,48,
2124,0,51,3,48,
2125,0,53,4,49,
2126,0,53,3,50,
2127,0,52,3,49,
2128,0,52,3,49,
2129,0,52,3,49,
2130,0,52,4,48,
2131,0,54,3,51,
2132,0,54,3,51,
2133,0,53,3,50,
2134,0,55,3,52,
2135,0,54,3,51,
2136,0,53,3,50,
2137,0,52,3,49,
2138,0,56,3,53,
2139,0,54,3,51,
2140,0,54,3,51,
2141,0,55,4,51,
2142,0,55,3,52,
2143,0,56,3,53,
2144,0,56,3,53,
2145,0,55,3,52,
2146,0,55,3,52,
2147,0,54,3,51,
2148,0,56,3,53,
2149,0,55,3,52,
2150,0,56,3,53,
2151,0,56,3,53,
2152,0,56,3,53,
2153,0,56,3,53,
2154,0,56,3,53,
2155,0,55,3,52,
2156,0,55,3,52,
2157,0,56,3,53,
2158,0,55,3,52,
2159,0,57,3,54,
2160,0,57,3,54,
2161,0,58,3,55,
2162,0,56,3,53,
2163,0,59,3,56,
2164,0,58,3,55,
2165,0,59,3,56,
2166,0,58,3,55,
2167,0,59,3,56,
2168,0,60,3,57,
2169,0,55,2,53,
2170,0,58,4,54,
2171,0,57,2,55,
2172,0,58,3,55,
2173,0,60,3,57,
2174,0,59,3,56,
2175,0,60,3,57,
2176,0,60,3,57,
2177,0,61,3,58,
2178,0,61,3,58,
2179,0,62,3,59,
2180,0,58,2,56,
2181,0,61,3,58,
2182,0,60,3,57,
2183,0,61,3,58,
2184,0,64,3,61,
2185,0,63,3,60,
2186,0,59,2,57,
2187,0,60,3,57,
2188,0,61,3,58,
2189,0,62,3,59,
2190,0,63,3,60,
2191,0,63,3,60,
2192,0,64,3,61,
2193,0,61,2,59,
2194,0,63,3,60,
2195,0,63,3,60,
2196,0,63,3,60,
2197,0,65,3,62,
2198,0,62,2,60,
2199,0,63,3,60,
2200,0,64,3,61,
2201,0,64,3,61,
2202,0,62,3,59,
2203,0,61,2,59,
2204,0,65,3,62,
2205,0,65,3,62,
2206,0,62,2,60,
2207,0,64,3,61,
2208,0,64,3,61,
2209,0,66,3,63,
2210,0,62,2,60,
2211,0,65,3,62,
2212,0,66,3,63,
2213,0,67,3,64,
2214,0,64,2,62,
2215,0,65,3,62,
2216,0,67,3,64,
2217,0,64,2,62,
2218,0,66,3,63,
2219,0,67,3,64,
2220,0,67,3,64,
2221,0,65,2,63,
2222,0,67,3,64,
2223,0,67,3,64,
2224,0,65,2,63,
2225,0,67,3,64,
2226,0,68,3,65,
2227,0,66,3,63,
2228,0,67,3,64,
2229,0,69,3,66,
2230,0,69,3,66,
2231,0,66,2,64,
2232,0,68,3,65,
2233,0,72,3,69,
2234,0,67,2,65,
2235,0,68,3,65,
2236,0,70,3,67,
2237,0,67,2,65,
2238,0,69,3,66,
2239,0,70,3,67,
2240,0,68,2,66,
2241,0,70,3,67,
2242,0,71,3,68,
2243,0,68,2,66,
2244,0,69,3,66,
2245,0,71,3,68,
2246,0,68,2,66,
2247,0,71,3,68,
2248,0,68,2,66,
2249,0,71,3,68,
2250,0,72,3,69,
2251,0,69,2,67,
2252,0,72,3,69,
2253,0,69,2,67,
2254,0,71,3,68,
2255,0,73,3,70,
2256,0,70,2,68,
2257,0,73,3,70,
2258,0,70,2,68,
2259,0,71,3,68,
2260,0,70,3,67,
2261,0,71,3,68,
2262,0,74,3,71,
2263,0,71,2,69,
2264,0,74,3,71,
2265,0,71,2,69,
2266,0,73,3,70,
2267,0,72,3,69,
2268,0,71,2,69,
2269,0,74,3,71,
2270,0,73,2,71,
2271,0,75,3,72,
2272,0,73,2,71,
2273,0,76,3,73,
2274,0,72,2,70,
2275,0,76,3,73,
2276,0,72,2,70,
2277,0,75,3,72,
2278,0,72,2,70,
2279,0,74,3,71,
2280,0,72,2,70,
2281,0,75,3,72,
2282,0,73,2,71,
2283,0,75,3,72,
2284,0,73,2,71,
2285,0,75,3,72,
2286,0,72,2,70,
2287,0,69,3,66,
2288,0,60,2,58,
2289,0,53,3,50,
2290,0,44,2,42,
2291,0,46,3,43,
2292,0,42,2,40,
2293,0,39,3,36,
2294,0,34,2,32,
2295,0,30,3,27,
2296,0,23,2,21,
2297,0,19,3,16,
2298,0,15,3,12,
2299,0,14,3,11,
2300,0,14,3,11,
2301,0,22,4,18,
2302,0,26,3,23,
2303,0,29,3,26,
2304,0,32,4,28,
2305,0,31,3,28,
2306,0,30,3,27,
2307,0,33,4,29,
2308,0,31,3,28,
2309,0,31,3,28,
2310,0,34,4,30,
2311,0,32,3,29,
2312,0,33,3,30,
2313,0,34,4,30,
2314,0,34,4,30,
2315,0,33,3,30,
2316,0,33,3,30,
2317,0,35,4,31,
2318,0,34,3,31,
2319,0,34,4,30,
2320,0,36,4,32,
2321,0,37,4,33,
2322,0,35,3,32,
2323,0,36,4,32,
2324,0,38,4,34,
2325,0,36,3,33,
2326,0,35,3,32,
2327,0,39,4,35,
2328,0,37,3,34,
2329,0,36,3,33,
2330,0,39,4,35,
2331,0,38,3,35,
2332,0,38,3,35,
2333,0,38,4,34,
2334,0,38,3,35,
2335,0,38,3,35,
2336,0,38,3,35,
2337,0,40,4,36,
2338,0,39,3,36,
2339,0,40,4,36,
2340,0,42,4,38,
2341,0,40,3,37,
2342,0,39,3,36,
2343,0,41,4,37,
2344,0,39,3,36,
2345,0,43,4,39,
2346,0,41,3,38,
2347,0,40,3,37,
2348,0,43,4,39,
2349,0,42,4,38,
2350,0,41,3,38,
2351,0,42,4,38,
2352,0,42,3,39,
2353,0,43,3,40,
2354,0,41,3,38,
2355,0,44,4,40,
2356,0,42,3,39,
2357,0,45,4,41,
2358,0,43,3,40,
2359,0,43,4,39,
2360,0,46,4,42,
2361,0,44,3,41,
2362,0,44,3,41,
2363,0,44,4,40,
2364,0,44,3,41,
2365,0,45,3,42,
2366,0,45,4,41,
2367,0,46,4,42,
2368,0,45,3,42,
2369,0,44,3,41,
2370,0,46,4,42,
2371,0,46,3,43,
2372,0,45,3,42,
2373,0,48,4,44,
2374,0,45,3,42,
2375,0,48,5,43,
2376,0,47,3,44,
2377,0,46,3,43,
2378,0,49,4,45,
2379,0,47,3,44,
2380,0,46,3,43,
2381,0,49,4,45,
2382,0,48,3,45,
2383,0,50,5,45,
2384,0,48,3,45,
2385,0,47,3,44,
2386,0,49,4,45,
2387,0,48,4,44,
2388,0,49,3,46,
2389,0,50,4,46,
2390,0,49,4,45,
2391,0,51,5,46,
2392,0,49,3,46,
2393,0,48,3,45,
2394,0,52,4,48,
2395,0,50,3,47,
2396,0,49,3,46,
2397,0,53,5,48,
2398,0,50,3,47,
2399,0,50,3,47,
2400,0,51,4,47,
2401,0,51,3,48,
2402,0,51,3,48,
2403,0,51,4,47,
2404,0,51,3,48,
2405,0,51,3,48,
2406,0,51,3,48,
2407,0,52,4,48,
2408,0,53,4,49,
2409,0,51,3,48,
2410,0,53,4,49,
2411,0,53,3,50,
2412,0,50,3,47,
2413,0,56,4,52,
2414,0,53,3,50,
2415,0,55,3,52,
2416,0,52,3,49,
2417,0,52,3,49,
2418,0,55,4,51,
2419,0,54,3,51,
2420,0,53,3,50,
2421,0,54,3,51,
2422,0,56,4,52,
2423,0,55,3,52,
2424,0,54,3,51,
2425,0,55,3,52,
2426,0,55,3,52,
2427,0,56,4,52,
2428,0,53,3,50,
2429,0,55,3,52,
2430,0,56,3,53,
2431,0,55,3,52,
2432,0,56,3,53,
2433,0,56,3,53,
2434,0,56,3,53,
2435,0,55,3,52,
2436,0,58,4,54,
2437,0,57,3,54,
2438,0,59,3,56,
2439,0,57,3,54,
2440,0,58,3,55,
2441,0,58,3,55,
2442,0,58,3,55,
2443,0,58,3,55,
2444,0,57,3,54,
2445,0,59,3,56,
2446,0,57,3,54,
2447,0,58,3,55,
2448,0,57,3,54,
2449,0,58,4,54,
2450,0,57,3,54,
2451,0,60,4,56,
2452,0,57,2,55,
2453,0,60,4,56,
2454,0,61,3,58,
2455,0,60,3,57,
2456,0,60,3,57,
2457,0,60,3,57,
2458,0,60,3,57,
2459,0,60,3,57,
2460,0,61,3,58,
2461,0,61,3,58,
2462,0,59,3,56,
2463,0,61,3,58,
2464,0,58,2,56,
2465,0,59,3,56,
2466,0,60,3,57,
2467,0,61,3,58,
2468,0,61,3,58,
2469,0,62,3,59,
2470,0,61,3,58,
2471,0,61,3,58,
2472,0,62,3,59,
2473,0,62,3,59,
2474,0,62,3,59,
2475,0,63,3,60,
2476,0,64,3,61,
2477,0,63,3,60,
2478,0,61,3,58,
2479,0,60,2,58,
2480,0,62,3,59,
2481,0,64,3,61,
2482,0,63,3,60,
2483,0,65,3,62,
2484,0,64,3,61,
2485,0,65,3,62,
2486,0,61,2,59,
2487,0,64,3,61,
2488,0,64,3,61,
2489,0,64,3,61,
2490,0,65,3,62,
2491,0,65,3,62,
2492,0,63,2,61,
2493,0,64,3,61,
2494,0,65,3,62,
2495,0,66,3,63,
2496,0,65,3,62,
2497,0,67,3,64,
2498,0,64,2,62,
2499,0,65,3,62,
2500,0,66,3,63,
2501,0,65,3,62,
2502,0,68,3,65,
2503,0,65,2,63,
2504,0,65,3,62,
2505,0,67,3,64,
2506,0,67,3,64,
2507,0,65,2,63,
2508,0,65,3,62,
2509,0,68,3,65,
2510,0,68,3,65,
2511,0,68,3,65,
2512,0,66,2,64,
2513,0,68,3,65,
2514,0,68,3,65,
2515,0,68,3,65,
2516,0,66,2,64,
2517,0,68,3,65,
2518,0,70,3,67,
2519,0,66,2,64,
2520,0,67,3,64,
2521,0,69,3,66,
2522,0,68,3,65,
2523,0,67,2,65,
2524,0,68,3,65,
2525,0,70,3,67,
2526,0,71,3,68,
2527,0,68,2,66,
2528,0,69,3,66,
2529,0,71,3,68,
2530,0,71,3,68,
2531,0,68,2,66,
2532,0,71,3,68,
2533,0,69,3,66,
2534,0,69,2,67,
2535,0,70,3,67,
2536,0,72,3,69,
2537,0,69,2,67,
2538,0,70,3,67,
2539,0,71,3,68,
2540,0,70,2,68,
2541,0,71,3,68,
2542,0,73,3,70,
2543,0,70,2,68,
2544,0,71,3,68,
2545,0,73,3,70,
2546,0,70,2,68,
2547,0,72,3,69,
2548,0,74,3,71,
2549,0,71,2,69,
2550,0,73,3,70,
2551,0,74,3,71,
2552,0,71,2,69,
2553,0,73,3,70,
2554,0,74,3,71,
2555,0,72,2,70,
2556,0,74,3,71,
2557,0,71,2,69,
2558,0,74,3,71,
2559,0,75,3,72,
2560,0,72,2,70,
2561,0,75,3,72,
2562,0,71,2,69,
2563,0,74,3,71,
2564,0,75,3,72,
2565,0,72,2,70,
2566,0,75,3,72,
2567,0,72,2,70,
2568,0,74,3,71,
2569,0,73,3,70,
2570,0,72,2,70,
2571,0,75,3,72,
2572,0,70,2,68,
2573,0,62,3,59,
2574,0,55,3,52,
2575,0,44,2,42,
2576,0,45,3,42,
2577,0,42,2,40,
2578,0,41,3,38,
2579,0,36,2,34,
2580,0,32,3,29,
2581,0,27,3,24,
2582,0,22,3,19,
2583,0,19,3,16,
2584,0,16,3,13,
2585,0,15,3,12,
2586,0,16,3,13,
2587,0,21,4,17,
2588,0,28,3,25,
2589,0,29,3,26,
2590,0,30,4,26,
2591,0,32,4,28,
2592,0,32,4,28,
2593,0,30,3,27,
2594,0,33,4,29,
2595,0,34,4,30,
2596,0,32,3,29,
2597,0,36,5,31,
2598,0,33,3,30,
2599,0,32,3,29,
2600,0,35,4,31,
2601,0,34,3,31,
2602,0,35,4,31,
2603,0,34,3,31,
2604,0,33,3,30,
2605,0,37,4,33,
2606,0,35,3,32,
2607,0,34,3,31,
2608,0,37,4,33,
2609,0,36,3,33,
2610,0,35,3,32,
2611,0,36,4,32,
2612,0,36,3,33,
2613,0,37,3,34,
2614,0,36,3,33,
2615,0,38,4,34,
2616,0,38,4,34,
2617,0,37,3,34,
2618,0,40,4,36,
2619,0,38,3,35,
2620,0,37,3,34,
2621,0,41,4,37,
2622,0,39,4,35,
2623,0,39,4,35,
2624,0,39,4,35,
2625,0,39,3,36,
2626,0,41,4,37,
2627,0,40,3,37,
2628,0,39,3,36,
2629,0,42,4,38,
2630,0,41,3,38,
2631,0,40,3,37,
2632,0,43,4,39,
2633,0,41,3,38,
2634,0,41,3,38,
2635,0,42,4,38,
2636,0,43,4,39,
2637,0,42,3,39,
2638,0,43,4,39,
2639,0,41,3,38,
2640,0,45,4,41,
2641,0,43,3,40,
2642,0,43,3,40,
2643,0,44,4,40,
2644,0,44,4,40,
2645,0,44,3,41,
2646,0,43,3,40,
2647,0,46,5,41,
2648,0,44,3,41,
2649,0,43,3,40,
2650,0,46,4,42,
2651,0,45,3,42,
2652,0,44,3,41,
2653,0,46,4,42,
2654,0,44,3,41,
2655,0,47,4,43,
2656,0,47,5,42,
2657,0,46,3,43,
2658,0,46,3,43,
2659,0,47,4,43,
2660,0,45,3,42,
2661,0,46,4,42,
2662,0,48,4,44,
2663,0,47,3,44,
2664,0,48,4,44,
2665,0,46,3,43,
2666,0,49,4,45,
2667,0,48,3,45,
2668,0,48,3,45,
2669,0,48,4,44,
2670,0,48,3,45,
2671,0,48,3,45,
2672,0,49,4,45,
2673,0,48,3,45,
2674,0,51,4,47,
2675,0,49,3,46,
2676,0,49,3,46,
2677,0,49,4,45,
2678,0,49,3,46,
2679,0,50,3,47,
2680,0,49,3,46,
2681,0,51,4,47,
2682,0,50,4,46,
2683,0,51,4,47,
2684,0,49,3,46,
2685,0,49,3,46,
2686,0,51,4,47,
2687,0,53,4,49,
2688,0,51,3,48,
2689,0,51,3,48,
2690,0,52,4,48,
2691,0,51,3,48,
2692,0,54,4,50,
2693,0,52,4,48,
2694,0,53,4,49,
2695,0,52,3,49,
2696,0,51,3,48,
2697,0,53,4,49,
2698,0,53,3,50,
2699,0,52,3,49,
2700,0,55,4,51,
2701,0,53,3,50,
2702,0,54,4,50,
2703,0,54,4,50,
2704,0,52,3,49,
2705,0,56,4,52,
2706,0,54,3,51,
2707,0,53,3,50,
2708,0,57,5,52,
2709,0,54,3,51,
2710,0,53,3,50,
2711,0,56,4,52,
2712,0,55,3,52,
2713,0,55,3,52,
2714,0,55,4,51,
2715,0,56,4,52,
2716,0,55,3,52,
2717,0,55,3,52,
2718,0,55,3,52,
2719,0,56,4,52,
2720,0,56,3,53,
2721,0,55,3,52,
2722,0,56,3,53,
2723,0,57,3,54,
2724,0,55,3,52,
2725,0,59,4,55,
2726,0,58,3,55,
2727,0,57,3,54,
2728,0,57,3,54,
2729,0,57,3,54,
2730,0,57,4,53,
2731,0,58,3,55,
2732,0,58,3,55,
2733,0,58,3,55,
2734,0,58,3,55,
2735,0,58,3,55,
2736,0,57,3,54,
2737,0,58,3,55,
2738,0,57,3,54,
2739,0,58,4,54,
2740,0,60,3,57,
2741,0,59,3,56,
2742,0,60,3,57,
2743,0,59,3,56,
2744,0,59,3,56,
2745,0,59,3,56,
2746,0,60,3,57,
2747,0,59,3,56,
2748,0,60,3,57,
2749,0,60,3,57,
2750,0,59,4,55,
2751,0,60,4,56,
2752,0,59,3,56,
2753,0,62,3,59,
2754,0,60,3,57,
2755,0,58,3,55,
2756,0,60,4,56,
2757,0,62,3,59,
2758,0,62,3,59,
2759,0,62,3,59,
2760,0,62,3,59,
2761,0,64,3,61,
2762,0,63,3,60,
2763,0,63,3,60,
2764,0,64,3,61,
2765,0,63,3,60,
2766,0,63,3,60,
2767,0,61,3,58,
2768,0,63,3,60,
2769,0,64,3,61,
2770,0,61,2,59,
2771,0,63,4,59,
2772,0,61,2,59,
2773,0,63,3,60,
2774,0,62,3,59,
2775,0,64,3,61,
2776,0,64,3,61,
2777,0,64,3,61,
2778,0,64,3,61,
2779,0,64,3,61,
2780,0,65,3,62,
2781,0,65,3,62,
2782,0,65,3,62,
2783,0,66,3,63,
2784,0,66,3,63,
2785,0,67,3,64,
2786,0,66,3,63,
2787,0,65,3,62,
2788,0,63,2,61,
2789,0,65,3,62,
2790,0,65,3,62,
2791,0,66,3,63,
2792,0,67,3,64,
2793,0,67,3,64,
2794,0,67,3,64,
2795,0,64,2,62,
2796,0,66,4,62,
2797,0,65,2,63,
2798,0,67,3,64,
2799,0,68,3,65,
2800,0,68,3,65,
2801,0,68,3,65,
2802,0,69,3,66,
2803,0,65,2,63,
2804,0,66,3,63,
2805,0,67,3,64,
2806,0,69,3,66,
2807,0,69,3,66,
2808,0,69,3,66,
2809,0,67,3,64,
2810,0,66,2,64,
2811,0,68,3,65,
2812,0,69,3,66,
2813,0,69,3,66,
2814,0,70,3,67,
2815,0,67,2,65,
2816,0,69,3,66,
2817,0,70,3,67,
2818,0,70,3,67,
2819,0,68,2,66,
2820,0,68,3,65,
2821,0,69,3,66,
2822,0,71,3,68,
2823,0,72,3,69,
2824,0,71,3,68,
2825,0,68,2,66,
2826,0,71,3,68,
2827,0,72,3,69,
2828,0,69,3,66,
2829,0,68,2,66,
2830,0,72,3,69,
2831,0,72,3,69,
2832,0,69,2,67,
2833,0,71,3,68,
2834,0,72,3,69,
2835,0,72,3,69,
2836,0,69,2,67,
2837,0,71,3,68,
2838,0,73,3,70,
2839,0,74,3,71,
2840,0,71,3,68,
2841,0,72,3,69,
2842,0,73,3,70,
2843,0,74,3,71,
2844,0,70,2,68,
2845,0,72,3,69,
2846,0,75,3,72,
2847,0,75,3,72,
2848,0,72,2,70,
2849,0,74,3,71,
2850,0,75,3,72,
2851,0,72,2,70,
2852,0,73,3,70,
2853,0,75,3,72,
2854,0,72,2,70,
2855,0,73,3,70,
2856,0,75,3,72,
2857,0,72,3,69,
2858,0,72,2,70,
2859,0,75,3,72,
2860,0,72,2,70,
2861,0,72,3,69,
2862,0,74,3,71,
2863,0,66,3,63,
2864,0,58,2,56,
2865,0,51,3,48,
2866,0,43,3,40,
2867,0,42,2,40,
2868,0,44,3,41,
2869,0,38,2,36,
2870,0,35,3,32,
2871,0,28,3,25,
2872,0,24,3,21,
2873,0,21,3,18,
2874,0,17,3,14,
2875,0,14,3,11,
2876,0,17,4,13,
2877,0,21,4,17,
2878,0,25,3,22,
2879,0,29,3,26,
2880,0,31,4,27,
2881,0,31,4,27,
2882,0,31,3,28,
2883,0,31,3,28,
2884,0,33,4,29,
2885,0,32,4,28,
2886,0,34,5,29,
2887,0,31,3,28,
2888,0,35,4,31,
2889,0,33,3,30,
2890,0,32,3,29,
2891,0,36,4,32,
2892,0,34,3,31,
2893,0,34,3,31,
2894,0,34,4,30,
2895,0,36,4,32,
2896,0,35,3,32,
2897,0,34,3,31,
2898,0,36,4,32,
2899,0,36,3,33,
2900,0,35,3,32,
2901,0,38,5,33,
2902,0,37,4,33,
2903,0,36,3,33,
2904,0,38,4,34,
2905,0,37,4,33,
2906,0,38,4,34,
2907,0,38,3,35,
2908,0,39,4,35,
2909,0,37,3,34,
2910,0,37,3,34,
2911,0,39,4,35,
2912,0,39,3,36,
2913,0,38,3,35,
2914,0,41,4,37,
2915,0,39,3,36,
2916,0,39,3,36,
2917,0,42,4,38,
2918,0,40,3,37,
2919,0,39,3,36,
2920,0,42,4,38,
2921,0,41,3,38,
2922,0,40,3,37,
2923,0,41,4,37,
2924,0,41,3,38,
2925,0,42,4,38,
2926,0,42,3,39,
2927,0,41,3,38,
2928,0,44,4,40,
2929,0,42,4,38,
2930,0,44,4,40,
2931,0,43,3,40,
2932,0,42,3,39,
2933,0,45,4,41,
2934,0,43,3,40,
2935,0,42,3,39,
2936,0,46,4,42,
2937,0,44,3,41,
2938,0,43,3,40,
2939,0,44,4,40,
2940,0,44,3,41,
2941,0,45,3,42,
2942,0,45,4,41,
2943,0,46,4,42,
2944,0,45,3,42,
2945,0,46,4,42,
2946,0,44,3,41,
2947,0,47,4,43,
2948,0,45,3,42,
2949,0,47,4,43,
2950,0,47,4,43,
2951,0,47,4,43,
2952,0,47,3,44,
2953,0,46,3,43,
2954,0,49,4,45,
2955,0,47,4,43,
2956,0,47,4,43,
2957,0,49,4,45,
2958,0,48,3,45,
2959,0,49,4,45,
2960,0,48,3,45,
2961,0,49,4,45,
2962,0,49,4,45,
2963,0,47,3,44,
2964,0,50,4,46,
2965,0,50,4,46,
2966,0,48,3,45,
2967,0,51,4,47,
2968,0,49,3,46,
2969,0,50,4,46,
2970,0,50,3,47,
2971,0,50,4,46,
2972,0,51,4,47,
2973,0,50,3,47,
2974,0,49,3,46,
2975,0,51,4,47,
2976,0,51,3,48,
2977,0,50,3,47,
2978,0,53,4,49,
2979,0,51,3,48,
2980,0,50,3,47,
2981,0,54,5,49,
2982,0,52,3,49,
2983,0,51,3,48,
2984,0,52,4,48,
2985,0,52,3,49,
2986,0,53,4,49,
2987,0,51,3,48,
2988,0,53,4,49,
2989,0,53,3,50,
2990,0,54,4,50,
2991,0,53,3,50,
2992,0,54,4,50,
2993,0,53,4,49,
2994,0,55,4,51,
2995,0,54,3,51,
2996,0,55,4,51,
2997,0,54,4,50,
2998,0,54,3,51,
2999,0,53,3,50,
3000,0,53,3,50,
3001,0,55,4,51,
3002,0,55,3,52,
3003,0,54,3,51,
3004,0,56,4,52,
3005,0,55,3,52,
3006,0,54,3,51,
3007,0,56,4,52,
3008,0,56,4,52,
3009,0,55,3,52,
3010,0,58,4,54,
3011,0,57,4,53,
3012,0,55,3,52,
3013,0,58,4,54,
3014,0,56,3,53,
3015,0,56,3,53,
3016,0,58,4,54,
3017,0,57,4,53,
3018,0,58,4,54,
3019,0,58,4,54,
3020,0,57,4,53,
3021,0,56,4,52,
3022,0,56,3,53,
3023,0,57,3,54,
3024,0,57,3,54,
3025,0,58,4,54,
3026,0,59,3,56,
3027,0,58,3,55,
3028,0,58,3,55,
3029,0,57,3,54,
3030,0,57,3,54,
3031,0,61,4,57,
3032,0,59,3,56,
3033,0,59,3,56,
3034,0,58,3,55,
3035,0,59,4,55,
3036,0,61,4,57,
3037,0,59,3,56,
3038,0,61,3,58,
3039,0,59,3,56,
3040,0,59,3,56,
3041,0,59,3,56,
3042,0,62,4,58,
3043,0,61,3,58,
3044,0,61,3,58,
3045,0,62,3,59,
3046,0,61,3,58,
3047,0,61,3,58,
3048,0,61,3,58,
3049,0,61,3,58,
3050,0,60,3,57,
3051,0,63,4,59,
3052,0,63,3,60,
3053,0,63,3,60,
3054,0,62,3,59,
3055,0,63,3,60,
3056,0,61,3,58,
3057,0,63,3,60,
3058,0,62,3,59,
3059,0,62,3,59,
3060,0,63,3,60,
3061,0,62,3,59,
3062,0,63,3,60,
3063,0,61,3,58,
3064,0,63,4,59,
3065,0,64,4,60,
3066,0,64,3,61,
3067,0,65,3,62,
3068,0,64,3,61,
3069,0,65,3,62,
3070,0,65,3,62,
3071,0,65,3,62,
3072,0,64,3,61,
3073,0,65,3,62,
3074,0,65,3,62,
3075,0,66,3,63,
3076,0,65,3,62,
3077,0,65,3,62,
3078,0,65,3,62,
3079,0,66,3,63,
3080,0,65,3,62,
3081,0,65,3,62,
3082,0,65,3,62,
3083,0,66,3,63,
3084,0,67,3,64,
3085,0,66,3,63,
3086,0,66,3,63,
3087,0,67,3,64,
3088,0,68,3,65,
3089,0,67,3,64,
3090,0,69,3,66,
3091,0,68,3,65,
3092,0,65,2,63,
3093,0,68,4,64,
3094,0,65,2,63,
3095,0,66,3,63,
3096,0,66,3,63,
3097,0,67,3,64,
3098,0,69,3,66,
3099,0,69,3,66,
3100,0,68,3,65,
3101,0,69,3,66,
3102,0,69,3,66,
3103,0,70,3,67,
3104,0,66,2,64,
3105,0,67,3,64,
3106,0,68,3,65,
3107,0,69,3,66,
3108,0,69,3,66,
3109,0,70,3,67,
3110,0,70,3,67,
3111,0,71,3,68,
3112,0,68,3,65,
3113,0,66,2,64,
3114,0,68,3,65,
3115,0,71,3,68,
3116,0,71,3,68,
3117,0,70,3,67,
3118,0,71,3,68,
3119,0,72,3,69,
3120,0,68,2,66,
3121,0,70,3,67,
3122,0,70,3,67,
3123,0,72,3,69,
3124,0,72,3,69,
3125,0,72,3,69,
3126,0,70,2,68,
3127,0,71,3,68,
3128,0,71,3,68,
3129,0,72,3,69,
3130,0,72,3,69,
3131,0,74,3,71,
3132,0,71,3,68,
3133,0,71,2,69,
3134,0,73,3,70,
3135,0,73,3,70,
3136,0,73,3,70,
3137,0,73,3,70,
3138,0,71,2,69,
3139,0,73,3,70,
3140,0,74,3,71,
3141,0,74,3,71,
3142,0,75,3,72,
3143,0,72,2,70,
3144,0,72,3,69,
3145,0,74,3,71,
3146,0,75,3,72,
3147,0,70,2,68,
3148,0,73,3,70,
3149,0,74,3,71,
3150,0,74,3,71,
3151,0,73,3,70,
3152,0,72,3,69,
3153,0,74,3,71,
3154,0,74,3,71,
3155,0,74,3,71,
3156,0,72,2,70,
3157,0,65,3,62,
3158,0,57,3,54,
3159,0,50,3,47,
3160,0,43,3,40,
3161,0,43,3,40,
3162,0,44,3,41,
3163,0,39,3,36,
3164,0,35,3,32,
3165,0,28,2,26,
3166,0,25,3,22,
3167,0,20,3,17,
3168,0,17,4,13,
3169,0,15,3,12,
3170,0,15,3,12,
3171,0,19,4,15,
3172,0,22,4,18,
3173,0,30,3,27,
3174,0,30,3,27,
3175,0,30,4,26,
3176,0,31,3,28,
3177,0,33,4,29,
3178,0,31,3,28,
3179,0,31,3,28,
3180,0,33,5,28,
3181,0,31,3,28,
3182,0,35,4,31,
3183,0,33,3,30,
3184,0,32,3,29,
3185,0,35,4,31,
3186,0,34,3,31,
3187,0,36,4,32,
3188,0,34,3,31,
3189,0,33,3,30,
3190,0,36,4,32,
3191,0,35,4,31,
3192,0,35,3,32,
3193,0,37,4,33,
3194,0,36,3,33,
3195,0,35,3,32,
3196,0,38,4,34,
3197,0,36,3,33,
3198,0,39,4,35,
3199,0,37,3,34,
3200,0,36,3,33,
3201,0,38,4,34,
3202,0,39,4,35,
3203,0,37,3,34,
3204,0,39,4,35,
3205,0,40,5,35,
3206,0,38,3,35,
3207,0,39,4,35,
3208,0,41,5,36,
3209,0,39,3,36,
3210,0,38,3,35,
3211,0,41,4,37,
3212,0,40,3,37,
3213,0,39,3,36,
3214,0,42,4,38,
3215,0,41,3,38,
3216,0,40,3,37,
3217,0,43,4,39,
3218,0,41,3,38,
3219,0,40,3,37,
3220,0,43,4,39,
3221,0,41,3,38,
3222,0,43,4,39,
3223,0,43,5,38,
3224,0,43,4,39,
3225,0,43,3,40,
3226,0,42,3,39,
3227,0,43,4,39,
3228,0,45,4,41,
3229,0,43,3,40,
3230,0,46,4,42,
3231,0,44,3,41,
3232,0,45,4,41,
3233,0,44,4,40,
3234,0,46,4,42,
3235,0,44,3,41,
3236,0,44,3,41,
3237,0,47,4,43,
3238,0,47,5,42,
3239,0,44,3,41,
3240,0,47,4,43,
3241,0,46,3,43,
3242,0,45,3,42,
3243,0,46,4,42,
3244,0,46,3,43,
3245,0,46,3,43,
3246,0,45,3,42,
3247,0,48,4,44,
3248,0,47,3,44,
3249,0,48,4,44,
3250,0,46,3,43,
3251,0,49,4,45,
3252,0,48,3,45,
3253,0,50,4,46,
3254,0,48,3,45,
3255,0,47,3,44,
3256,0,50,4,46,
3257,0,48,3,45,
3258,0,49,4,45,
3259,0,49,3,46,
3260,0,48,3,45,
3261,0,51,4,47,
3262,0,51,4,47,
3263,0,49,3,46,
3264,0,50,3,47,
3265,0,51,4,47,
3266,0,49,3,46,
3267,0,52,4,48,
3268,0,50,4,46,
3269,0,50,4,46,
3270,0,51,5,46,
3271,0,51,3,48,
3272,0,50,3,47,
3273,0,50,3,47,
3274,0,52,4,48,
3275,0,51,3,48,
3276,0,50,3,47,
3277,0,53,4,49,
3278,0,54,4,50,
3279,0,52,3,49,
3280,0,53,4,49,
3281,0,52,4,48,
3282,0,52,3,49,
3283,0,53,3,50,
3284,0,54,4,50,
3285,0,52,3,49,
3286,0,53,4,49,
3287,0,53,3,50,
3288,0,53,3,50,
3289,0,54,4,50,
3290,0,53,3,50,
3291,0,56,4,52,
3292,0,55,4,51,
3293,0,54,4,50,
3294,0,55,4,51,
3295,0,54,3,51,
3296,0,54,3,51,
3297,0,55,4,51,
3298,0,55,3,52,
3299,0,56,4,52,
3300,0,55,4,51,
3301,0,56,4,52,
3302,0,55,3,52,
3303,0,54,3,51,
3304,0,58,4,54,
3305,0,57,4,53,
3306,0,55,3,52,
3307,0,58,4,54,
3308,0,56,3,53,
3309,0,55,3,52,
3310,0,56,4,52,
3311,0,58,4,54,
3312,0,56,3,53,
3313,0,57,4,53,
3314,0,59,5,54,
3315,0,57,3,54,
3316,0,56,3,53,
3317,0,58,4,54,
3318,0,58,3,55,
3319,0,59,4,55,
3320,0,58,3,55,
3321,0,58,4,54,
3322,0,58,3,55,
3323,0,60,4,56,
3324,0,58,4,54,
3325,0,59,3,56,
3326,0,60,4,56,
3327,0,58,3,55,
3328,0,60,4,56,
3329,0,60,3,57,
3330,0,59,3,56,
3331,0,61,4,57,
3332,0,60,3,57,
3333,0,60,3,57,
3334,0,59,3,56,
3335,0,61,4,57,
3336,0,60,3,57,
3337,0,60,3,57,
3338,0,59,3,56,
3339,0,62,4,58,
3340,0,61,3,58,
3341,0,61,3,58,
3342,0,61,3,58,
3343,0,63,4,59,
3344,0,61,3,58,
3345,0,62,3,59,
3346,0,61,3,58,
3347,0,61,4,57,
3348,0,63,4,59,
3349,0,63,3,60,
3350,0,62,3,59,
3351,0,62,3,59,
3352,0,62,4,58,
3353,0,61,3,58,
3354,0,62,3,59,
3355,0,63,3,60,
3356,0,62,3,59,
3357,0,63,3,60,
3358,0,62,3,59,
3359,0,65,4,61,
3360,0,63,3,60,
3361,0,64,3,61,
3362,0,64,3,61,
3363,0,63,3,60,
3364,0,64,3,61,
3365,0,64,3,61,
3366,0,64,3,61,
3367,0,64,4,60,
3368,0,65,3,62,
3369,0,65,3,62,
3370,0,64,3,61,
3371,0,65,3,62,
3372,0,66,3,63,
3373,0,65,3,62,
3374,0,65,3,62,
3375,0,65,3,62,
3376,0,65,3,62,
3377,0,65,3,62,
3378,0,64,3,61,
3379,0,66,4,62,
3380,0,67,3,64,
3381,0,67,3,64,
3382,0,67,3,64,
3383,0,66,3,63,
3384,0,68,3,65,
3385,0,67,3,64,
3386,0,67,3,64,
3387,0,67,3,64,
3388,0,67,3,64,
3389,0,66,3,63,
3390,0,67,3,64,
3391,0,66,3,63,
3392,0,67,3,64,
3393,0,67,3,64,
3394,0,66,3,63,
3395,0,67,3,64,
3396,0,67,3,64,
3397,0,68,4,64,
3398,0,67,3,64,
3399,0,69,4,65,
3400,0,69,3,66,
3401,0,66,2,64,
3402,0,67,4,63,
3403,0,69,3,66,
3404,0,67,2,65,
3405,0,72,4,68,
3406,0,68,3,65,
3407,0,69,3,66,
3408,0,67,2,65,
3409,0,68,4,64,
3410,0,70,4,66,
3411,0,68,2,66,
3412,0,69,3,66,
3413,0,70,4,66,
3414,0,68,2,66,
3415,0,69,3,66,
3416,0,70,3,67,
3417,0,69,3,66,
3418,0,70,3,67,
3419,0,71,3,68,
3420,0,71,3,68,
3421,0,71,3,68,
3422,0,72,3,69,
3423,0,72,3,69,
3424,0,71,3,68,
3425,0,72,3,69,
3426,0,72,3,69,
3427,0,74,3,71,
3428,0,70,2,68,
3429,0,71,3,68,
3430,0,71,3,68,
3431,0,72,3,69,
3432,0,73,3,70,
3433,0,73,3,70,
3434,0,73,3,70,
3435,0,73,3,70,
3436,0,74,3,71,
3437,0,75,3,72,
3438,0,71,2,69,
3439,0,73,3,70,
3440,0,73,3,70,
3441,0,74,3,71,
3442,0,74,3,71,
3443,0,74,3,71,
3444,0,71,2,69,
3445,0,73,3,70,
3446,0,73,3,70,
3447,0,73,3,70,
3448,0,74,3,71,
3449,0,74,3,71,
3450,0,74,3,71,
3451,0,71,2,69,
3452,0,73,3,70,
3453,0,71,3,68,
3454,0,63,3,60,
3455,0,56,3,53,
3456,0,49,3,46,
3457,0,42,2,40,
3458,0,43,3,40,
3459,0,44,3,41,
3460,0,40,3,37,
3461,0,35,3,32,
3462,0,28,3,25,
3463,0,24,3,21,
3464,0,21,3,18,
3465,0,17,3,14,
3466,0,17,4,13,
3467,0,14,3,11,
3468,0,21,4,17,
3469,0,25,3,22,
3470,0,29,3,26,
3471,0,33,5,28,
3472,0,30,3,27,
3473,0,30,3,27,
3474,0,34,6,28,
3475,0,31,3,28,
3476,0,33,4,29,
3477,0,34,4,30,
3478,0,32,3,29,
3479,0,32,3,29,
3480,0,34,4,30,
3481,0,34,4,30,
3482,0,34,4,30,
3483,0,34,4,30,
3484,0,34,3,31,
3485,0,34,3,31,
3486,0,33,3,30,
3487,0,36,4,32,
3488,0,35,3,32,
3489,0,34,3,31,
3490,0,36,4,32,
3491,0,37,4,33,
3492,0,35,3,32,
3493,0,37,4,33,
3494,0,35,3,32,
3495,0,39,4,35,
3496,0,37,3,34,
3497,0,36,3,33,
3498,0,39,4,35,
3499,0,38,3,35,
3500,0,37,3,34,
3501,0,38,4,34,
3502,0,38,3,35,
3503,0,38,3,35,
3504,0,40,4,36,
3505,0,39,4,35,
3506,0,41,4,37,
3507,0,39,3,36,
3508,0,39,3,36,
3509,0,42,4,38,
3510,0,40,3,37,
3511,0,42,4,38,
3512,0,41,3,38,
3513,0,41,4,37,
3514,0,43,4,39,
3515,0,41,3,38,
3516,0,40,3,37,
3517,0,44,4,40,
3518,0,42,3,39,
3519,0,42,3,39,
3520,0,42,4,38,
3521,0,42,3,39,
3522,0,43,3,40,
3523,0,43,4,39,
3524,0,43,3,40,
3525,0,43,3,40,
3526,0,42,3,39,
3527,0,45,4,41,
3528,0,46,5,41,
3529,0,43,3,40,
3530,0,46,4,42,
3531,0,43,3,40,
3532,0,46,5,41,
3533,0,45,3,42,
3534,0,44,3,41,
3535,0,47,4,43,
3536,0,45,3,42,
3537,0,44,3,41,
3538,0,48,4,44,
3539,0,46,3,43,
3540,0,47,4,43,
3541,0,46,3,43,
3542,0,45,3,42,
3543,0,47,4,43,
3544,0,47,3,44,
3545,0,46,3,43,
3546,0,49,4,45,
3547,0,47,3,44,
3548,0,47,3,44,
3549,0,47,4,43,
3550,0,48,3,45,
3551,0,48,3,45,
3552,0,49,4,45,
3553,0,48,4,44,
3554,0,51,5,46,
3555,0,49,3,46,
3556,0,48,3,45,
3557,0,51,4,47,
3558,0,49,3,46,
3559,0,49,3,46,
3560,0,49,4,45,
3561,0,50,3,47,
3562,0,50,3,47,
3563,0,50,4,46,
3564,0,51,4,47,
3565,0,51,5,46,
3566,0,51,4,47,
3567,0,50,4,46,
3568,0,52,4,48,
3569,0,51,4,47,
3570,0,53,4,49,
3571,0,52,4,48,
3572,0,52,4,48,
3573,0,53,4,49,
3574,0,52,3,49,
3575,0,52,3,49,
3576,0,52,4,48,
3577,0,52,3,49,
3578,0,52,3,49,
3579,0,52,4,48,
3580,0,53,3,50,
3581,0,55,4,51,
3582,0,53,3,50,
3583,0,52,3,49,
3584,0,53,4,49,
3585,0,53,3,50,
3586,0,54,4,50,
3587,0,53,3,50,
3588,0,55,4,51,
3589,0,54,3,51,
3590,0,54,4,50,
3591,0,55,4,51,
3592,0,55,4,51,
3593,0,53,3,50,
3594,0,57,4,53,
3595,0,55,4,51,
3596,0,54,3,51,
3597,0,57,4,53,
3598,0,55,3,52,
3599,0,54,3,51,
3600,0,57,4,53,
3601,0,56,3,53,
3602,0,57,4,53,
3603,0,56,4,52,
3604,0,56,3,53,
3605,0,56,3,53,
3606,0,56,4,52,
3607,0,56,3,53,
3608,0,57,3,54,
3609,0,56,3,53,
3610,0,58,4,54,
3611,0,57,3,54,
3612,0,56,3,53,
3613,0,59,4,55,
3614,0,57,3,54,
3615,0,59,4,55,
3616,0,58,3,55,
3617,0,57,3,54,
3618,0,60,4,56,
3619,0,58,3,55,
3620,0,57,3,54,
3621,0,60,4,56,
3622,0,59,3,56,
3623,0,58,3,55,
3624,0,59,4,55,
3625,0,59,3,56,
3626,0,59,4,55,
3627,0,59,4,55,
3628,0,59,3,56,
3629,0,61,4,57,
3630,0,60,3,57,
3631,0,59,3,56,
3632,0,63,5,58,
3633,0,60,3,57,
3634,0,62,4,58,
3635,0,60,3,57,
3636,0,53,1,52,
3637,0,42,,42,
3638,0,29,,29,
3639,0,17,,17,
3640,0,5,,5,
