window-id,queue-size-CL,queue-size-LL,10.0.0.13:58365 -> 10.0.1.13:3000,10.0.1.13:3000 -> 10.0.0.13:58365,10.0.0.13:59551 -> 10.0.1.13:1000
0,0,41,11,30,
1,0,36,12,24,
2,0,34,12,22,
3,0,32,13,19,
4,0,32,12,20,
5,0,30,13,17,
6,0,29,13,16,
7,0,30,13,17,
8,0,26,10,16,
9,0,29,13,16,
10,0,29,13,16,
11,0,29,13,16,
12,0,29,12,17,
13,0,28,12,16,
14,0,30,13,17,
15,0,30,13,17,
16,0,30,13,17,
17,0,30,13,17,
18,0,30,13,17,
19,0,30,12,18,
20,0,30,13,17,
21,0,30,13,17,
22,0,30,13,17,
23,0,30,12,18,
24,0,30,12,18,
25,0,31,13,18,
26,0,30,13,17,
27,0,30,13,17,
28,0,30,13,17,
29,0,29,12,17,
30,0,31,13,18,
31,0,30,13,17,
32,0,27,11,16,
33,0,29,13,16,
34,0,29,13,16,
35,0,28,12,16,
36,0,29,13,16,
37,0,30,13,17,
38,0,24,9,15,
39,0,24,7,17,
40,0,22,6,16,
41,0,26,8,18,
42,0,23,6,17,
43,0,24,7,17,
44,0,23,6,17,
45,0,23,6,17,
46,0,24,7,17,
47,0,23,6,17,
48,0,23,7,16,
49,0,24,6,18,
50,0,23,7,16,
51,0,21,6,15,
52,0,23,7,16,
53,0,22,6,16,
54,0,22,7,15,
55,0,23,6,17,
56,0,23,6,17,
57,0,24,7,17,
58,0,24,8,16,
59,0,24,7,17,
60,0,23,7,16,
61,0,24,7,17,
62,0,22,6,16,
63,0,26,7,19,
64,0,24,6,18,
65,0,26,7,19,
66,0,23,6,17,
67,0,24,7,17,
68,0,25,8,17,
69,0,25,7,18,
70,0,24,8,16,
71,0,24,6,18,
72,0,23,6,17,
73,0,25,7,18,
74,0,24,5,19,
75,0,25,7,18,
76,0,22,6,16,
77,0,24,7,17,
78,0,23,6,17,
79,0,22,7,15,
80,0,23,7,16,
81,0,23,6,17,
82,0,25,7,18,
83,0,24,6,18,
84,0,25,6,19,
85,0,24,7,17,
86,0,23,6,17,
87,0,24,7,17,
88,0,24,7,17,
89,0,25,8,17,
90,0,22,6,16,
91,0,23,7,16,
92,0,22,6,16,
93,0,23,6,17,
94,0,23,6,17,
95,0,23,7,16,
96,0,23,6,17,
97,0,22,6,16,
98,0,23,7,16,
99,0,26,7,19,
100,0,25,7,18,
101,0,26,7,19,
102,0,22,6,16,
103,0,24,7,17,
104,0,24,7,17,
105,0,23,7,16,
106,0,24,7,17,
107,0,24,7,17,
108,0,23,6,17,
109,0,22,6,16,
110,0,25,7,18,
111,0,23,6,17,
112,0,24,7,17,
113,0,25,8,17,
114,0,22,6,16,
115,0,21,6,15,
116,0,23,7,16,
117,0,22,6,16,
118,0,22,7,15,
119,0,25,7,18,
120,0,23,6,17,
121,0,24,7,17,
122,0,26,7,19,
123,0,23,6,17,
124,0,25,7,18,
125,0,24,6,18,
126,0,24,7,17,
127,0,23,6,17,
128,0,22,6,16,
129,0,28,9,19,
130,0,23,6,17,
131,0,26,7,19,
132,0,23,6,17,
133,0,23,7,16,
134,0,22,7,15,
135,0,24,7,17,
136,0,22,6,16,
137,0,22,7,15,
138,0,23,7,16,
139,0,23,6,17,
140,0,23,6,17,
141,0,23,6,17,
142,0,24,7,17,
143,0,23,6,17,
144,0,23,6,17,
145,0,24,7,17,
146,0,22,6,16,
147,0,26,7,19,
148,0,25,6,19,
149,0,24,6,18,
150,0,23,7,16,
151,0,25,8,17,
152,0,24,6,18,
153,0,25,7,18,
154,0,24,6,18,
155,0,23,6,17,
156,0,23,7,16,
157,0,23,6,17,
158,0,22,6,16,
159,0,26,7,19,
160,0,24,6,18,
161,0,23,7,16,
162,0,23,6,17,
163,0,21,6,15,
164,0,23,7,16,
165,0,24,7,17,
166,0,22,6,16,
167,0,23,7,16,
168,0,21,6,15,
169,0,24,7,17,
170,0,24,6,18,
171,0,23,6,17,
172,0,23,7,16,
173,0,21,6,15,
174,0,23,7,16,
175,0,22,6,16,
176,0,21,6,15,
177,0,24,7,17,
178,0,23,6,17,
179,0,23,6,17,
180,0,24,7,17,
181,0,22,6,16,
182,0,24,7,17,
183,0,22,6,16,
184,0,26,8,18,
185,0,23,6,17,
186,0,23,7,16,
187,0,23,6,17,
188,0,23,7,16,
189,0,23,6,17,
190,0,25,7,18,
191,0,23,6,17,
192,0,25,7,18,
193,0,23,6,17,
194,0,21,6,15,
195,0,22,7,15,
196,0,26,7,19,
197,0,23,7,16,
198,0,23,6,17,
199,0,23,7,16,
200,0,24,7,17,
201,0,23,6,17,
202,0,22,7,15,
203,0,25,6,19,
204,0,23,6,17,
205,0,25,7,18,
206,0,23,6,17,
207,0,23,7,16,
208,0,22,6,16,
209,0,21,6,15,
210,0,22,7,15,
211,0,23,7,16,
212,0,23,7,16,
213,0,22,7,15,
214,0,22,6,16,
215,0,21,6,15,
216,0,24,7,17,
217,0,24,6,18,
218,0,23,6,17,
219,0,25,7,18,
220,0,25,9,16,
221,0,23,8,15,
222,0,25,6,19,
223,0,24,7,17,
224,0,25,7,18,
225,0,23,6,17,
226,0,25,7,18,
227,0,23,7,16,
228,0,24,6,18,
229,0,23,7,16,
230,0,23,6,17,
231,0,24,6,18,
232,0,25,7,18,
233,0,24,6,18,
234,0,22,6,16,
235,0,24,7,17,
236,0,22,6,16,
237,0,24,7,17,
238,0,24,6,18,
239,0,22,6,16,
240,0,23,7,16,
241,0,25,7,18,
242,0,23,6,17,
243,0,21,6,15,
244,0,25,7,18,
245,0,23,6,17,
246,0,24,7,17,
247,0,23,7,16,
248,0,23,6,17,
249,0,24,6,18,
250,0,26,8,18,
251,0,24,7,17,
252,0,22,6,16,
253,0,22,7,15,
254,0,23,7,16,
255,0,21,6,15,
256,0,25,7,18,
257,0,24,6,18,
258,0,25,7,18,
259,0,23,6,17,
260,0,26,9,17,
261,0,29,11,18,
262,0,27,11,16,
263,0,26,10,16,
264,0,28,12,16,
265,0,27,10,17,
266,0,28,11,17,
267,0,24,9,15,
268,0,26,10,16,
269,0,28,9,19,
270,0,28,10,18,
271,0,28,10,18,
272,0,27,10,17,
273,0,27,10,17,
274,0,25,8,17,
275,0,30,11,19,
276,0,29,12,17,
277,0,24,7,17,
278,0,23,7,16,
279,0,22,6,16,
280,0,21,6,15,
281,0,23,7,16,
282,0,24,7,17,
283,0,24,6,18,
284,0,25,7,18,
285,0,24,7,17,
286,0,22,6,16,
287,0,24,8,16,
288,0,22,6,16,
289,0,23,7,16,
290,0,24,6,18,
291,0,23,7,16,
292,0,23,6,17,
293,0,23,6,17,
294,0,25,7,18,
295,0,23,6,17,
296,0,21,6,15,
297,0,23,7,16,
298,0,24,6,18,
299,0,24,7,17,
300,0,24,6,18,
301,0,23,7,16,
302,0,23,6,17,
303,0,12,3,9,
308,0,21,8,13,
309,0,23,6,17,
310,0,21,6,15,
311,0,24,9,15,
312,0,24,7,17,
313,0,22,6,16,
314,0,23,7,16,
315,0,23,6,17,
316,0,22,6,16,
317,0,25,7,18,
318,0,25,8,17,
319,0,23,7,16,
320,0,23,7,16,
321,0,23,6,17,
322,0,26,7,19,
323,0,24,6,18,
324,0,23,6,17,
325,0,26,7,19,
326,0,24,6,18,
327,0,23,6,17,
328,0,24,7,17,
329,0,24,6,18,
330,0,23,6,17,
331,0,24,7,17,
332,0,24,7,17,
333,0,23,7,16,
334,0,26,8,18,
335,0,23,6,17,
336,0,23,7,16,
337,0,24,6,18,
338,0,23,6,17,
339,0,23,7,16,
340,0,21,6,15,
341,0,24,8,16,
342,0,21,6,15,
343,0,23,7,16,
344,0,21,6,15,
345,0,26,8,18,
346,0,23,6,17,
347,0,23,7,16,
348,0,23,7,16,
349,0,23,6,17,
350,0,23,6,17,
351,0,23,7,16,
352,0,23,6,17,
353,0,22,6,16,
354,0,25,7,18,
355,0,24,6,18,
356,0,23,6,17,
357,0,23,7,16,
358,0,23,6,17,
359,0,22,6,16,
360,0,24,7,17,
361,0,24,6,18,
362,0,24,7,17,
363,0,24,8,16,
364,0,25,7,18,
365,0,23,6,17,
366,0,24,7,17,
367,0,22,6,16,
368,0,22,7,15,
369,0,24,7,17,
370,0,22,7,15,
371,0,22,6,16,
372,0,21,6,15,
373,0,25,9,16,
374,0,25,7,18,
375,0,24,8,16,
376,0,24,7,17,
377,0,23,7,16,
378,0,23,7,16,
379,0,24,7,17,
380,0,22,6,16,
381,0,23,6,17,
382,0,25,7,18,
383,0,23,6,17,
384,0,23,7,16,
385,0,25,6,19,
386,0,24,6,18,
387,0,24,7,17,
388,0,24,6,18,
389,0,22,6,16,
390,0,24,7,17,
391,0,23,6,17,
392,0,24,7,17,
393,0,23,6,17,
394,0,25,8,17,
395,0,22,6,16,
396,0,22,7,15,
397,0,23,6,17,
398,0,22,6,16,
399,0,25,7,18,
400,0,24,6,18,
401,0,24,7,17,
402,0,26,7,19,
403,0,24,7,17,
404,0,23,6,17,
405,0,23,6,17,
406,0,23,7,16,
407,0,23,6,17,
408,0,22,6,16,
409,0,24,7,17,
410,0,23,7,16,
411,0,24,7,17,
412,0,24,6,18,
413,0,23,6,17,
414,0,22,7,15,
415,0,25,7,18,
416,0,22,6,16,
417,0,24,7,17,
418,0,22,6,16,
419,0,24,7,17,
420,0,24,6,18,
421,0,22,6,16,
422,0,23,7,16,
423,0,23,7,16,
424,0,24,7,17,
425,0,24,7,17,
426,0,24,7,17,
427,0,22,6,16,
428,0,21,6,15,
429,0,24,7,17,
430,0,24,7,17,
431,0,24,8,16,
432,0,24,7,17,
433,0,24,8,16,
434,0,23,6,17,
435,0,24,6,18,
436,0,26,8,18,
437,0,25,7,18,
438,0,23,7,16,
439,0,25,8,17,
440,0,23,6,17,
441,0,24,8,16,
442,0,24,6,18,
443,0,24,7,17,
444,0,23,6,17,
445,0,23,6,17,
446,0,24,8,16,
447,0,22,6,16,
448,0,22,7,15,
449,0,24,6,18,
450,0,24,7,17,
451,0,24,6,18,
452,0,23,6,17,
453,0,24,7,17,
454,0,24,7,17,
455,0,22,7,15,
456,0,25,6,19,
457,0,23,6,17,
458,0,25,7,18,
459,0,24,6,18,
460,0,22,6,16,
461,0,24,7,17,
462,0,26,7,19,
463,0,24,6,18,
464,0,24,7,17,
465,0,25,7,18,
466,0,23,6,17,
467,0,23,7,16,
468,0,22,6,16,
469,0,21,6,15,
470,0,23,7,16,
471,0,22,7,15,
472,0,23,6,17,
473,0,23,7,16,
474,0,24,7,17,
475,0,22,6,16,
476,0,24,7,17,
477,0,23,6,17,
478,0,22,6,16,
479,0,26,7,19,
480,0,24,6,18,
481,0,24,7,17,
482,0,22,6,16,
483,0,21,6,15,
484,0,25,7,18,
485,0,26,7,19,
486,0,22,6,16,
487,0,23,6,17,
488,0,25,7,18,
489,0,23,6,17,
490,0,22,7,15,
491,0,22,6,16,
492,0,23,6,17,
493,0,24,7,17,
494,0,25,7,18,
495,0,23,6,17,
496,0,25,7,18,
497,0,23,7,16,
498,0,23,7,16,
499,0,21,6,15,
500,0,23,7,16,
501,0,22,7,15,
502,0,24,7,17,
503,0,23,6,17,
504,0,23,6,17,
505,0,25,7,18,
506,0,23,6,17,
507,0,23,6,17,
508,0,23,7,16,
509,0,24,6,18,
510,0,24,7,17,
511,0,23,6,17,
512,0,22,6,16,
513,0,24,7,17,
514,0,22,6,16,
515,0,22,6,16,
516,0,22,7,15,
517,0,22,6,16,
518,0,21,6,15,
519,0,25,7,18,
520,0,23,6,17,
521,0,24,6,18,
522,0,25,7,18,
523,0,24,7,17,
524,0,23,7,16,
525,0,23,7,16,
526,0,24,6,18,
527,0,24,7,17,
528,0,23,6,17,
529,0,22,6,16,
530,0,23,7,16,
531,0,22,7,15,
532,0,23,7,16,
533,0,24,7,17,
534,0,22,6,16,
535,0,21,6,15,
536,0,24,7,17,
537,0,22,6,16,
538,0,25,7,18,
539,0,23,6,17,
540,0,23,7,16,
541,0,24,7,17,
542,0,23,6,17,
543,0,23,7,16,
544,0,24,6,18,
545,0,25,7,18,
546,0,23,6,17,
547,0,24,6,18,
548,0,25,7,18,
549,0,23,6,17,
550,0,23,7,16,
551,0,23,6,17,
552,0,22,6,16,
553,0,25,7,18,
554,0,24,7,17,
555,0,24,6,18,
556,0,22,6,16,
557,0,23,7,16,
558,0,24,7,17,
559,0,26,7,19,
560,0,24,6,18,
561,0,24,7,17,
562,0,24,6,18,
563,0,24,7,17,
564,0,24,6,18,
565,0,23,6,17,
566,0,25,7,18,
567,0,22,6,16,
568,0,25,7,18,
569,0,23,6,17,
570,0,23,6,17,
571,0,26,7,19,
572,0,24,6,18,
573,0,23,7,16,
574,0,23,6,17,
575,0,24,7,17,
576,0,22,6,16,
577,0,25,7,18,
578,0,24,6,18,
579,0,23,6,17,
580,0,22,6,16,
581,0,24,7,17,
582,0,21,6,15,
583,0,24,8,16,
584,0,22,6,16,
585,0,23,7,16,
586,0,25,9,16,
587,0,26,9,17,
588,0,27,9,18,
589,0,25,9,16,
590,0,26,10,16,
591,0,30,9,21,
592,0,27,9,18,
593,0,28,10,18,
594,0,28,9,19,
595,0,27,9,18,
596,0,23,6,17,
597,0,25,7,18,
598,0,23,6,17,
599,0,24,7,17,
600,0,23,6,17,
601,0,23,6,17,
602,0,24,7,17,
603,0,23,6,17,
604,0,22,6,16,
605,0,25,7,18,
606,0,23,7,16,
607,0,23,7,16,
608,0,21,6,15,
609,0,24,7,17,
610,0,23,6,17,
611,0,23,6,17,
612,0,26,8,18,
613,0,23,6,17,
614,0,25,7,18,
615,0,23,6,17,
616,0,24,7,17,
617,0,25,8,17,
618,0,24,6,18,
619,0,23,6,17,
620,0,24,7,17,
621,0,25,8,17,
622,0,23,6,17,
623,0,23,7,16,
624,0,24,7,17,
625,0,23,6,17,
626,0,23,7,16,
627,0,24,6,18,
628,0,23,6,17,
629,0,23,7,16,
630,0,21,6,15,
631,0,22,7,15,
632,0,22,6,16,
633,0,21,6,15,
634,0,22,7,15,
635,0,23,6,17,
636,0,23,7,16,
637,0,22,6,16,
638,0,23,7,16,
639,0,23,7,16,
640,0,24,7,17,
641,0,23,6,17,
642,0,22,7,15,
643,0,23,7,16,
644,0,26,7,19,
645,0,23,6,17,
646,0,24,7,17,
647,0,24,6,18,
648,0,25,7,18,
649,0,24,7,17,
650,0,22,6,16,
651,0,21,6,15,
652,0,22,7,15,
653,0,25,7,18,
654,0,24,7,17,
655,0,23,7,16,
656,0,23,6,17,
657,0,23,7,16,
658,0,24,7,17,
659,0,22,6,16,
660,0,24,7,17,
661,0,24,6,18,
662,0,23,6,17,
663,0,25,7,18,
664,0,24,7,17,
665,0,24,6,18,
666,0,24,7,17,
667,0,23,6,17,
668,0,21,6,15,
669,0,22,7,15,
670,0,22,7,15,
671,0,22,6,16,
672,0,21,6,15,
673,0,24,7,17,
674,0,23,7,16,
675,0,23,7,16,
676,0,25,9,16,
677,0,26,7,19,
678,0,25,7,18,
679,0,23,6,17,
680,0,24,7,17,
681,0,24,7,17,
682,0,24,7,17,
683,0,24,6,18,
684,0,24,7,17,
685,0,22,6,16,
686,0,25,7,18,
687,0,23,6,17,
688,0,22,6,16,
689,0,24,7,17,
690,0,22,6,16,
691,0,25,7,18,
692,0,24,6,18,
693,0,24,7,17,
694,0,22,6,16,
695,0,22,6,16,
696,0,24,7,17,
697,0,26,7,19,
698,0,24,6,18,
699,0,25,8,17,
700,0,22,6,16,
701,0,24,7,17,
702,0,22,6,16,
703,0,21,6,15,
704,0,25,7,18,
705,0,24,6,18,
706,0,24,7,17,
707,0,25,7,18,
708,0,23,7,16,
709,0,24,7,17,
710,0,23,6,17,
711,0,22,6,16,
712,0,24,7,17,
713,0,24,6,18,
714,0,24,7,17,
715,0,24,7,17,
716,0,24,6,18,
717,0,23,6,17,
718,0,24,7,17,
719,0,23,6,17,
720,0,24,7,17,
721,0,22,6,16,
722,0,22,6,16,
723,0,24,7,17,
724,0,24,6,18,
725,0,23,7,16,
726,0,24,7,17,
727,0,21,6,15,
728,0,24,7,17,
729,0,22,6,16,
730,0,24,7,17,
731,0,22,6,16,
732,0,23,6,17,
733,0,25,7,18,
734,0,23,6,17,
735,0,26,8,18,
736,0,23,6,17,
737,0,23,7,16,
738,0,23,6,17,
739,0,27,7,20,
740,0,24,6,18,
741,0,24,7,17,
742,0,24,7,17,
743,0,24,7,17,
744,0,23,7,16,
745,0,22,6,16,
746,0,22,7,15,
747,0,22,6,16,
748,0,22,6,16,
749,0,22,7,15,
750,0,23,6,17,
751,0,22,6,16,
752,0,24,7,17,
753,0,23,6,17,
754,0,23,7,16,
755,0,24,7,17,
756,0,22,6,16,
757,0,26,7,19,
758,0,24,7,17,
759,0,25,7,18,
760,0,25,8,17,
761,0,23,6,17,
762,0,22,7,15,
763,0,23,6,17,
764,0,25,7,18,
765,0,24,7,17,
766,0,25,6,19,
767,0,23,6,17,
768,0,22,6,16,
769,0,25,7,18,
770,0,24,6,18,
771,0,24,7,17,
772,0,22,6,16,
773,0,23,7,16,
774,0,21,6,15,
775,0,24,8,16,
776,0,22,6,16,
777,0,21,6,15,
778,0,24,7,17,
779,0,22,6,16,
780,0,25,7,18,
781,0,23,6,17,
782,0,24,7,17,
783,0,24,6,18,
784,0,23,6,17,
785,0,25,7,18,
786,0,23,6,17,
787,0,24,7,17,
788,0,22,6,16,
789,0,24,7,17,
790,0,24,7,17,
791,0,25,7,18,
792,0,23,6,17,
793,0,22,6,16,
794,0,25,7,18,
795,0,23,7,16,
796,0,24,6,18,
797,0,23,7,16,
798,0,23,6,17,
799,0,24,8,16,
800,0,24,7,17,
801,0,22,6,16,
802,0,23,7,16,
803,0,25,7,18,
804,0,23,6,17,
805,0,24,7,17,
806,0,25,7,18,
807,0,23,6,17,
808,0,23,7,16,
809,0,22,6,16,
810,0,21,6,15,
811,0,23,7,16,
812,0,22,6,16,
813,0,22,7,15,
814,0,23,6,17,
815,0,22,6,16,
816,0,24,7,17,
817,0,23,6,17,
818,0,24,8,16,
819,0,23,6,17,
820,0,23,6,17,
821,0,24,7,17,
822,0,22,7,15,
823,0,25,7,18,
824,0,23,6,17,
825,0,25,7,18,
826,0,26,7,19,
827,0,23,6,17,
828,0,28,10,18,
829,0,23,7,16,
830,0,25,6,19,
831,0,23,6,17,
832,0,23,7,16,
833,0,23,6,17,
834,0,23,7,16,
835,0,22,7,15,
836,0,22,6,16,
837,0,24,7,17,
838,0,22,6,16,
839,0,22,6,16,
840,0,24,7,17,
841,0,22,6,16,
842,0,23,6,17,
843,0,24,7,17,
844,0,22,6,16,
845,0,23,6,17,
846,0,24,7,17,
847,0,23,6,17,
848,0,22,6,16,
849,0,22,7,15,
850,0,24,6,18,
851,0,25,7,18,
852,0,25,7,18,
853,0,22,6,16,
854,0,26,7,19,
855,0,24,6,18,
856,0,26,8,18,
857,0,23,6,17,
858,0,25,7,18,
859,0,25,7,18,
860,0,23,6,17,
861,0,25,7,18,
862,0,22,6,16,
863,0,25,7,18,
864,0,24,6,18,
865,0,23,6,17,
866,0,24,7,17,
867,0,29,11,18,
868,0,27,10,17,
869,0,31,11,20,
870,0,30,11,19,
871,0,31,13,18,
872,0,30,11,19,
873,0,30,11,19,
874,0,27,9,18,
875,0,32,11,21,
876,0,28,9,19,
877,0,28,11,17,
878,0,28,12,16,
879,0,29,10,19,
880,0,31,13,18,
881,0,30,11,19,
882,0,31,11,20,
883,0,31,12,19,
884,0,30,11,19,
885,0,30,12,18,
886,0,29,11,18,
887,0,31,13,18,
888,0,28,11,17,
889,0,30,13,17,
890,0,27,11,16,
891,0,26,10,16,
892,0,26,10,16,
893,0,26,9,17,
894,0,27,10,17,
895,0,28,10,18,
896,0,26,9,17,
897,0,27,10,17,
898,0,26,9,17,
899,0,28,11,17,
900,0,27,11,16,
901,0,28,12,16,
902,0,23,6,17,
903,0,28,10,18,
904,0,29,12,17,
905,0,32,12,20,
906,0,28,11,17,
907,0,25,8,17,
908,0,30,11,18,1
909,0,23,7,16,
910,0,23,7,16,
911,0,22,6,16,
912,0,27,9,18,
913,0,23,7,16,
914,0,24,7,17,
915,0,25,7,17,1
916,0,24,7,17,
917,0,24,6,18,
918,0,23,7,16,
919,0,23,6,17,
920,0,23,7,16,
921,0,26,8,18,
922,0,24,7,17,
923,0,24,7,16,1
924,0,23,7,16,
925,0,23,7,16,
926,0,23,7,16,
927,0,24,6,18,
928,0,23,7,16,
929,0,25,8,17,
930,0,24,6,18,
931,0,24,7,17,
932,0,24,7,17,
933,0,25,7,18,
934,0,23,6,17,
935,0,24,7,17,
936,0,23,6,17,
937,0,21,6,15,
938,0,25,7,17,1
939,0,23,6,17,
940,0,22,6,16,
941,0,24,7,17,
942,0,24,6,18,
943,0,25,7,18,
944,0,22,6,16,
945,0,26,7,19,
946,0,24,6,18,
947,0,26,8,18,
948,0,23,6,17,
949,0,23,6,17,
950,0,24,7,17,
951,0,22,6,16,
952,0,23,6,17,
953,0,24,7,16,1
954,0,25,7,18,
955,0,22,6,16,
956,0,21,6,15,
957,0,23,7,16,
958,0,22,6,16,
959,0,24,8,16,
960,0,22,6,16,
961,0,21,6,15,
962,0,24,7,17,
963,0,22,6,16,
964,0,25,7,18,
965,0,23,6,17,
966,0,22,6,16,
967,0,24,7,17,
968,0,22,6,16,
969,0,23,7,16,
970,0,24,7,17,
971,0,24,6,18,
972,0,24,6,18,
973,0,23,6,17,
974,0,24,7,17,
975,0,25,7,18,
976,0,24,6,18,
977,0,25,7,18,
978,0,24,7,17,
979,0,23,6,17,
980,0,28,10,18,
981,0,24,6,18,
982,0,24,7,17,
983,0,25,7,18,
984,0,22,6,15,1
985,0,24,7,17,
986,0,23,7,16,
987,0,23,6,17,
988,0,24,7,17,
989,0,24,7,17,
990,0,21,6,15,
991,0,24,7,17,
992,0,25,7,18,
993,0,23,6,17,
994,0,23,7,16,
995,0,23,6,17,
996,0,22,6,16,
997,0,23,7,16,
998,0,24,7,17,
999,0,22,6,16,
1000,0,25,8,17,
1001,0,22,6,16,
1002,0,21,6,15,
1003,0,23,7,16,
1004,0,22,6,16,
1005,0,26,7,19,
1006,0,23,6,17,
1007,0,25,7,18,
1008,0,23,6,17,
1009,0,24,7,17,
1010,0,22,6,16,
1011,0,26,8,18,
1012,0,24,6,18,
1013,0,23,7,16,
1014,0,24,7,16,1
1015,0,23,6,17,
1016,0,22,6,16,
1017,0,23,7,16,
1018,0,22,6,16,
1019,0,23,6,17,
1020,0,25,8,17,
1021,0,23,6,17,
1022,0,23,7,16,
1023,0,23,6,17,
1024,0,22,6,16,
1025,0,25,7,18,
1026,0,23,6,17,
1027,0,24,7,17,
1028,0,22,6,16,
1029,0,21,6,15,
1030,0,22,7,15,
1031,0,22,6,16,
1032,0,21,6,15,
1033,0,24,7,17,
1034,0,22,6,16,
1035,0,23,7,16,
1036,0,24,7,17,
1037,0,22,6,16,
1038,0,24,7,17,
1039,0,23,6,17,
1040,0,22,6,16,
1041,0,25,8,17,
1042,0,25,7,18,
1043,0,24,6,18,
1044,0,24,7,16,1
1045,0,25,7,18,
1046,0,23,6,17,
1047,0,24,7,17,
1048,0,22,6,16,
1049,0,23,7,16,
1050,0,24,6,18,
1051,0,22,6,16,
1052,0,23,7,16,
1053,0,23,6,17,
1054,0,23,6,17,
1055,0,22,6,16,
1056,0,25,7,18,
1057,0,23,6,17,
1058,0,24,6,18,
1059,0,25,7,18,
1060,0,23,6,17,
1061,0,24,7,17,
1062,0,23,7,16,
1063,0,23,6,17,
1064,0,24,6,18,
1065,0,24,7,17,
1066,0,22,6,16,
1067,0,23,6,17,
1068,0,23,7,16,
1069,0,23,7,16,
1070,0,23,6,17,
1071,0,24,7,17,
1072,0,26,7,19,
1073,0,23,6,17,
1074,0,22,6,16,
1075,0,25,7,17,1
1076,0,22,6,16,
1077,0,24,7,17,
1078,0,22,6,16,
1079,0,25,7,18,
1080,0,23,6,17,
1081,0,23,6,17,
1082,0,23,7,16,
1083,0,24,7,17,
1084,0,23,6,17,
1085,0,21,7,14,
1086,0,7,1,6,
1087,0,22,7,15,
1088,0,24,6,18,
1089,0,23,6,17,
1090,0,24,7,17,
1091,0,24,6,18,
1092,0,24,7,17,
1093,0,24,7,17,
1094,0,22,6,16,
1095,0,23,7,16,
1096,0,25,8,17,
1097,0,24,6,18,
1098,0,22,6,16,
1099,0,26,8,18,
1100,0,22,6,16,
1101,0,22,7,15,
1102,0,21,6,15,
1103,0,23,7,16,
1104,0,21,6,15,
1105,0,23,7,15,1
1106,0,23,6,17,
1107,0,24,7,17,
1108,0,24,6,18,
1109,0,23,6,17,
1110,0,24,7,17,
1111,0,23,6,17,
1112,0,23,6,17,
1113,0,25,7,18,
1114,0,23,6,17,
1115,0,25,7,18,
1116,0,22,6,16,
1117,0,24,7,17,
1118,0,23,6,17,
1119,0,22,7,15,
1120,0,25,6,19,
1121,0,25,8,17,
1122,0,23,7,16,
1123,0,24,6,18,
1124,0,23,6,17,
1125,0,25,7,18,
1126,0,23,6,17,
1127,0,26,8,18,
1128,0,22,6,16,
1129,0,23,7,16,
1130,0,22,6,16,
1131,0,26,8,18,
1132,0,22,6,16,
1133,0,24,7,17,
1134,0,22,6,16,
1135,0,24,7,17,
1136,0,24,6,17,1
1137,0,23,7,16,
1138,0,23,7,16,
1139,0,24,7,17,
1140,0,22,6,16,
1141,0,21,6,15,
1142,0,25,7,18,
1143,0,24,6,18,
1144,0,23,7,16,
1145,0,24,7,17,
1146,0,23,7,16,
1147,0,24,7,17,
1148,0,24,6,18,
1149,0,24,7,17,
1150,0,24,6,18,
1151,0,22,6,16,
1152,0,26,7,19,
1153,0,24,6,18,
1154,0,23,6,17,
1155,0,23,7,16,
1156,0,22,6,16,
1157,0,23,7,16,
1158,0,22,7,15,
1159,0,23,7,16,
1160,0,22,6,16,
1161,0,22,6,16,
1162,0,26,7,19,
1163,0,26,7,19,
1164,0,22,6,16,
1165,0,25,7,18,
1166,0,24,6,17,1
1167,0,22,7,15,
1168,0,23,6,17,
1169,0,24,6,18,
1170,0,26,7,19,
1171,0,24,6,18,
1172,0,24,7,17,
1173,0,23,7,16,
1174,0,23,6,17,
1175,0,22,6,16,
1176,0,24,7,17,
1177,0,25,7,18,
1178,0,23,6,17,
1179,0,23,6,17,
1180,0,24,8,16,
1181,0,24,6,18,
1182,0,25,7,18,
1183,0,23,6,17,
1184,0,24,7,17,
1185,0,22,6,16,
1186,0,22,7,15,
1187,0,24,8,16,
1188,0,23,8,15,
1189,0,24,7,17,
1190,0,23,6,17,
1191,0,23,6,17,
1192,0,24,7,17,
1193,0,24,7,17,
1194,0,24,7,17,
1195,0,22,6,16,
1196,0,24,7,16,1
1197,0,24,7,17,
1198,0,25,7,18,
1199,0,23,6,17,
1200,0,23,7,16,
1201,0,23,6,17,
1202,0,24,6,18,
1203,0,24,7,17,
1204,0,25,7,18,
1205,0,23,6,17,
1206,0,22,6,16,
1207,0,24,7,17,
1208,0,24,6,18,
1209,0,23,6,17,
1210,0,24,7,17,
1211,0,24,6,18,
1212,0,23,7,16,
1213,0,23,7,16,
1214,0,24,6,18,
1215,0,23,6,17,
1216,0,24,7,17,
1217,0,23,6,17,
1218,0,23,7,16,
1219,0,23,7,16,
1220,0,22,7,15,
1221,0,25,7,18,
1222,0,27,9,18,
1223,0,23,7,16,
1224,0,25,7,18,
1225,0,23,6,17,
1226,0,22,7,15,
1227,0,26,7,18,1
1228,0,24,7,17,
1229,0,23,7,16,
1230,0,25,7,18,
1231,0,23,6,17,
1232,0,25,7,18,
1233,0,23,6,17,
1234,0,22,6,16,
1235,0,23,7,16,
1236,0,21,6,15,
1237,0,23,7,16,
1238,0,21,6,15,
1239,0,25,8,17,
1240,0,23,7,16,
1241,0,24,6,18,
1242,0,25,7,18,
1243,0,24,6,18,
1244,0,24,7,17,
1245,0,23,7,16,
1246,0,21,6,15,
1247,0,23,7,16,
1248,0,22,6,16,
1249,0,24,8,16,
1250,0,22,7,15,
1251,0,24,7,17,
1252,0,24,7,17,
1253,0,23,6,17,
1254,0,24,7,17,
1255,0,24,6,18,
1256,0,24,7,17,
1257,0,25,7,17,1
1258,0,23,6,17,
1259,0,22,6,16,
1260,0,25,7,18,
1261,0,23,6,17,
1262,0,23,6,17,
1263,0,24,7,17,
1264,0,25,7,18,
1265,0,23,7,16,
1266,0,22,6,16,
1267,0,22,7,15,
1268,0,22,6,16,
1269,0,22,6,16,
1270,0,22,7,15,
1271,0,23,6,17,
1272,0,23,6,17,
1273,0,23,7,16,
1274,0,23,6,17,
1275,0,22,6,16,
1276,0,23,7,16,
1277,0,23,6,17,
1278,0,23,6,17,
1279,0,27,8,19,
1280,0,23,6,17,
1281,0,26,7,19,
1282,0,23,6,17,
1283,0,25,9,16,
1284,0,23,6,17,
1285,0,24,7,17,
1286,0,23,6,17,
1287,0,24,7,16,1
1288,0,23,7,16,
1289,0,23,6,17,
1290,0,23,7,16,
1291,0,24,7,17,
1292,0,21,6,15,
1293,0,26,7,19,
1294,0,24,6,18,
1295,0,23,6,17,
1296,0,25,7,18,
1297,0,25,6,19,
1298,0,23,6,17,
1299,0,23,7,16,
1300,0,24,7,17,
1301,0,26,7,19,
1302,0,25,7,18,
1303,0,25,7,18,
1304,0,23,6,17,
1305,0,22,6,16,
1306,0,24,7,17,
1307,0,22,6,16,
1308,0,24,7,17,
1309,0,24,7,17,
1310,0,24,7,17,
1311,0,27,9,18,
1312,0,22,6,16,
1313,0,23,7,16,
1314,0,24,8,16,
1315,0,23,6,17,
1316,0,22,6,16,
1317,0,22,7,15,
1318,0,25,7,17,1
1319,0,24,7,17,
1320,0,24,7,17,
1321,0,23,6,17,
1322,0,22,6,16,
1323,0,26,7,19,
1324,0,22,6,16,
1325,0,26,8,18,
1326,0,23,6,17,
1327,0,23,7,16,
1328,0,22,6,16,
1329,0,23,6,17,
1330,0,22,6,16,
1331,0,26,7,19,
1332,0,25,6,19,
1333,0,23,6,17,
1334,0,26,7,19,
1335,0,23,6,17,
1336,0,23,7,16,
1337,0,23,6,17,
1338,0,23,6,17,
1339,0,25,7,18,
1340,0,24,7,17,
1341,0,23,7,16,
1342,0,23,7,16,
1343,0,24,7,17,
1344,0,24,6,18,
1345,0,23,7,16,
1346,0,24,7,17,
1347,0,23,6,17,
1348,0,23,6,16,1
1349,0,25,7,18,
1350,0,23,6,17,
1351,0,24,7,17,
1352,0,22,6,16,
1353,0,22,7,15,
1354,0,23,7,16,
1355,0,21,6,15,
1356,0,24,7,17,
1357,0,22,6,16,
1358,0,22,7,15,
1359,0,23,6,17,
1360,0,23,6,17,
1361,0,23,7,16,
1362,0,23,6,17,
1363,0,24,8,16,
1364,0,24,7,17,
1365,0,22,6,16,
1366,0,23,6,17,
1367,0,24,7,17,
1368,0,22,6,16,
1369,0,24,7,17,
1370,0,22,6,16,
1371,0,24,8,16,
1372,0,23,7,16,
1373,0,22,6,16,
1374,0,22,6,16,
1375,0,26,8,18,
1376,0,23,6,17,
1377,0,25,8,17,
1378,0,23,6,16,1
1379,0,24,7,17,
1380,0,23,6,17,
1381,0,23,7,16,
1382,0,23,6,17,
1383,0,22,6,16,
1384,0,26,7,19,
1385,0,24,6,18,
1386,0,23,6,17,
1387,0,23,7,16,
1388,0,21,6,15,
1389,0,22,7,15,
1390,0,22,6,16,
1391,0,21,6,15,
1392,0,24,7,17,
1393,0,23,6,17,
1394,0,22,6,16,
1395,0,24,7,17,
1396,0,23,6,17,
1397,0,22,6,16,
1398,0,24,7,17,
1399,0,22,6,16,
1400,0,27,7,20,
1401,0,24,7,17,
1402,0,33,14,19,
1403,0,31,10,21,
1404,0,32,12,20,
1405,0,29,11,18,
1406,0,30,12,18,
1407,0,31,12,19,
1408,0,31,12,19,
1409,0,30,11,18,1
1410,0,30,12,18,
1411,0,31,12,19,
1412,0,29,10,19,
1413,0,30,11,19,
1414,0,31,11,20,
1415,0,30,10,20,
1416,0,31,12,19,
1417,0,29,11,18,
1418,0,29,12,17,
1419,0,31,11,20,
1420,0,29,11,18,
1421,0,31,12,19,
1422,0,31,12,19,
1423,0,29,11,18,
1424,0,30,10,20,
1425,0,29,12,17,
1426,0,25,8,17,
1427,0,25,7,18,
1428,0,24,6,18,
1429,0,23,6,17,
1430,0,23,7,16,
1431,0,23,6,17,
1432,0,24,7,17,
1433,0,22,7,15,
1434,0,22,7,15,
1435,0,24,7,17,
1436,0,23,6,17,
1437,0,22,6,16,
1438,0,22,7,15,
1439,0,24,6,17,1
1440,0,23,6,17,
1441,0,23,7,16,
1442,0,22,6,16,
1443,0,24,7,17,
1444,0,24,6,18,
1445,0,23,6,17,
1446,0,23,7,16,
1447,0,24,6,18,
1448,0,24,6,18,
1449,0,24,7,17,
1450,0,22,6,16,
1451,0,22,6,16,
1452,0,22,7,15,
1453,0,22,6,16,
1454,0,23,7,16,
1455,0,23,8,15,
1456,0,24,6,18,
1457,0,23,6,17,
1458,0,23,7,16,
1459,0,24,7,17,
1460,0,23,6,17,
1461,0,22,6,16,
1462,0,24,8,16,
1463,0,23,6,17,
1464,0,25,7,18,
1465,0,24,6,18,
1466,0,25,7,18,
1467,0,23,6,17,
1468,0,23,7,16,
1469,0,22,6,15,1
1470,0,22,7,15,
1471,0,22,6,16,
1472,0,21,6,15,
1473,0,25,7,18,
1474,0,23,6,17,
1475,0,23,7,16,
1476,0,24,7,17,
1477,0,22,6,16,
1478,0,28,9,19,
1479,0,25,6,19,
1480,0,23,6,17,
1481,0,24,7,17,
1482,0,23,6,17,
1483,0,22,6,16,
1484,0,21,6,15,
1485,0,23,7,16,
1486,0,23,7,16,
1487,0,22,7,15,
1488,0,21,6,15,
1489,0,24,7,17,
1490,0,23,6,17,
1491,0,23,6,17,
1492,0,24,7,17,
1493,0,24,7,17,
1494,0,22,6,16,
1495,0,24,7,17,
1496,0,24,7,17,
1497,0,23,7,16,
1498,0,24,7,17,
1499,0,22,6,16,
1500,0,25,7,17,1
1501,0,22,6,16,
1502,0,24,8,16,
1503,0,24,6,18,
1504,0,23,6,17,
1505,0,23,7,16,
1506,0,22,6,16,
1507,0,22,7,15,
1508,0,22,6,16,
1509,0,24,7,17,
1510,0,23,6,17,
1511,0,22,6,16,
1512,0,22,7,15,
1513,0,24,6,18,
1514,0,24,7,17,
1515,0,23,7,16,
1516,0,22,6,16,
1517,0,24,7,17,
1518,0,23,6,17,
1519,0,22,6,16,
1520,0,25,7,18,
1521,0,23,6,17,
1522,0,23,6,17,
1523,0,23,7,16,
1524,0,24,6,18,
1525,0,23,6,17,
1526,0,24,7,17,
1527,0,24,7,17,
1528,0,24,8,16,
1529,0,22,6,16,
1530,0,24,7,16,1
1531,0,23,7,16,
1532,0,23,7,16,
1533,0,21,6,15,
1534,0,24,7,17,
1535,0,23,6,17,
1536,0,23,6,17,
1537,0,24,7,17,
1538,0,23,6,17,
1539,0,24,7,17,
1540,0,22,6,16,
1541,0,24,7,17,
1542,0,23,6,17,
1543,0,23,7,16,
1544,0,24,6,18,
1545,0,23,7,16,
1546,0,21,6,15,
1547,0,23,7,16,
1548,0,22,6,16,
1549,0,21,6,15,
1550,0,25,8,17,
1551,0,23,6,17,
1552,0,22,6,16,
1553,0,23,7,16,
1554,0,24,8,16,
1555,0,23,6,17,
1556,0,22,6,16,
1557,0,27,9,18,
1558,0,23,6,17,
1559,0,24,7,17,
1560,0,22,6,16,
1561,0,24,7,16,1
1562,0,23,7,16,
1563,0,23,6,17,
1564,0,22,6,16,
1565,0,23,7,16,
1566,0,22,6,16,
1567,0,22,6,16,
1568,0,22,7,15,
1569,0,25,7,18,
1570,0,24,7,17,
1571,0,22,6,16,
1572,0,24,7,17,
1573,0,23,6,17,
1574,0,22,6,16,
1575,0,25,7,18,
1576,0,23,6,17,
1577,0,24,7,17,
1578,0,22,6,16,
1579,0,24,7,17,
1580,0,21,6,15,
1581,0,24,7,17,
1582,0,23,6,17,
1583,0,25,8,17,
1584,0,30,11,19,
1585,0,29,11,18,
1586,0,32,12,20,
1587,0,28,11,17,
1588,0,29,12,17,
1589,0,32,13,19,
1590,0,30,11,19,
1591,0,31,11,19,1
1592,0,29,11,18,
1593,0,31,11,20,
1594,0,31,12,19,
1595,0,29,11,18,
1596,0,30,12,18,
1597,0,30,11,19,
1598,0,30,11,19,
1599,0,30,12,18,
1600,0,30,11,19,
1601,0,31,13,18,
1602,0,28,11,17,
1603,0,29,11,18,
1604,0,29,11,18,
1605,0,30,12,18,
1606,0,30,10,20,
1607,0,29,11,18,
1608,0,27,10,17,
1609,0,30,11,19,
1610,0,29,11,18,
1611,0,30,11,19,
1612,0,32,13,19,
1613,0,30,11,19,
1614,0,28,10,18,
1615,0,30,11,19,
1616,0,30,10,20,
1617,0,29,11,18,
1618,0,31,11,20,
1619,0,29,12,17,
1620,0,29,11,18,
1621,0,29,12,16,1
1622,0,31,12,19,
1623,0,29,11,18,
1624,0,31,11,20,
1625,0,27,10,17,
1626,0,31,11,20,
1627,0,29,11,18,
1628,0,30,11,19,
1629,0,31,10,21,
1630,0,30,12,18,
1631,0,30,11,19,
1632,0,30,12,18,
1633,0,29,11,18,
1634,0,28,10,18,
1635,0,30,11,19,
1636,0,30,10,20,
1637,0,30,11,19,
1638,0,30,11,19,
1639,0,30,10,20,
1640,0,29,11,18,
1641,0,29,10,19,
1642,0,29,11,18,
1643,0,30,12,18,
1644,0,24,8,16,
1645,0,25,8,17,
1646,0,22,6,16,
1647,0,21,6,15,
1648,0,22,7,15,
1649,0,24,8,16,
1650,0,22,7,15,
1651,0,22,6,16,
1652,0,24,7,16,1
1653,0,24,7,17,
1654,0,24,6,18,
1655,0,23,6,17,
1656,0,24,7,17,
1657,0,22,6,16,
1658,0,24,7,17,
1659,0,22,6,16,
1660,0,23,7,16,
1661,0,24,6,18,
1662,0,23,6,17,
1663,0,23,7,16,
1664,0,22,6,16,
1665,0,21,6,15,
1666,0,22,7,15,
1667,0,23,7,16,
1668,0,22,6,16,
1669,0,22,7,15,
1670,0,24,6,18,
1671,0,23,6,17,
1672,0,23,7,16,
1673,0,23,6,17,
1674,0,23,6,17,
1675,0,24,7,17,
1676,0,22,6,16,
1677,0,23,7,16,
1678,0,26,7,19,
1679,0,23,6,17,
1680,0,24,7,17,
1681,0,22,6,16,
1682,0,22,6,15,1
1683,0,24,7,17,
1684,0,22,6,16,
1685,0,21,6,15,
1686,0,24,7,17,
1687,0,23,7,16,
1688,0,24,7,17,
1689,0,23,6,17,
1690,0,23,6,17,
1691,0,23,7,16,
1692,0,23,6,17,
1693,0,22,6,16,
1694,0,23,6,17,
1695,0,25,7,18,
1696,0,24,6,18,
1697,0,24,6,18,
1698,0,23,7,16,
1699,0,22,6,16,
1700,0,23,7,16,
1701,0,23,6,17,
1702,0,22,6,16,
1703,0,21,6,15,
1704,0,25,7,18,
1705,0,22,7,15,
1706,0,23,6,17,
1707,0,24,7,17,
1708,0,24,7,17,
1709,0,22,6,16,
1710,0,23,7,16,
1711,0,23,6,17,
1712,0,25,7,17,1
1713,0,23,6,17,
1714,0,23,6,17,
1715,0,23,7,16,
1716,0,23,6,17,
1717,0,23,7,16,
1718,0,23,7,16,
1719,0,24,6,18,
1720,0,23,6,17,
1721,0,25,7,18,
1722,0,24,7,17,
1723,0,22,6,16,
1724,0,21,6,15,
1725,0,23,7,16,
1726,0,22,6,16,
1727,0,24,7,17,
1728,0,22,7,15,
1729,0,24,7,17,
1730,0,24,6,18,
1731,0,23,6,17,
1732,0,23,7,16,
1733,0,23,7,16,
1734,0,24,7,17,
1735,0,26,9,17,
1736,0,30,11,19,
1737,0,30,13,17,
1738,0,30,11,19,
1739,0,31,13,18,
1740,0,29,11,18,
1741,0,30,12,18,
1742,0,27,9,18,
1743,0,33,13,19,1
1744,0,30,12,18,
1745,0,28,11,17,
1746,0,32,11,21,
1747,0,29,10,19,
1748,0,30,12,18,
1749,0,30,11,19,
1750,0,31,12,19,
1751,0,28,10,18,
1752,0,29,11,18,
1753,0,31,11,20,
1754,0,29,10,19,
1755,0,29,11,18,
1756,0,30,11,19,
1757,0,30,12,18,
1758,0,31,11,20,
1759,0,29,11,18,
1760,0,31,11,20,
1761,0,29,12,17,
1762,0,32,12,20,
1763,0,29,11,18,
1764,0,29,11,18,
1765,0,32,12,20,
1766,0,29,11,18,
1767,0,28,11,17,
1768,0,30,11,19,
1769,0,31,10,21,
1770,0,30,11,19,
1771,0,29,10,19,
1772,0,31,11,20,
1773,0,31,10,20,1
1774,0,31,12,19,
1775,0,28,11,17,
1776,0,30,11,19,
1777,0,30,11,19,
1778,0,30,10,20,
1779,0,29,11,18,
1780,0,29,10,19,
1781,0,30,12,18,
1782,0,29,11,18,
1783,0,31,13,18,
1784,0,32,12,20,
1785,0,30,11,19,
1786,0,29,10,19,
1787,0,30,12,18,
1788,0,28,10,18,
1789,0,29,10,19,
1790,0,31,11,20,
1791,0,28,11,17,
1792,0,29,11,18,
1793,0,31,13,18,
1794,0,29,12,17,
1795,0,30,10,20,
1796,0,31,11,20,
1797,0,28,9,19,
1798,0,27,9,18,
1799,0,24,7,17,
1800,0,21,6,15,
1801,0,24,7,17,
1802,0,25,7,18,
1803,0,24,6,17,1
1804,0,24,7,17,
1805,0,22,6,16,
1806,0,25,7,18,
1807,0,24,6,18,
1808,0,25,8,17,
1809,0,24,7,17,
1810,0,22,6,16,
1811,0,21,6,15,
1812,0,24,7,17,
1813,0,23,6,17,
1814,0,23,8,15,
1815,0,23,6,17,
1816,0,22,6,16,
1817,0,27,10,17,
1818,0,30,11,19,
1819,0,30,11,19,
1820,0,32,12,20,
1821,0,29,10,19,
1822,0,32,12,20,
1823,0,29,10,19,
1824,0,31,11,20,
1825,0,30,12,18,
1826,0,32,13,19,
1827,0,28,10,18,
1828,0,30,11,19,
1829,0,30,11,19,
1830,0,30,11,19,
1831,0,32,13,19,
1832,0,30,12,18,
1833,0,32,14,18,
1834,0,29,12,17,
1835,0,30,12,18,
1836,0,30,11,19,
1837,0,29,11,18,
1838,0,30,13,17,
1839,0,31,13,18,
1840,0,30,12,18,
1841,0,31,11,20,
1842,0,30,12,18,
1843,0,31,12,19,
1844,0,30,12,18,
1845,0,32,13,19,
1846,0,30,11,19,
1847,0,31,13,18,
1848,0,28,10,18,
1849,0,30,13,17,
1850,0,29,12,17,
1851,0,30,13,17,
1852,0,32,13,19,
1853,0,30,12,18,
1854,0,32,13,19,
1855,0,31,12,19,
1856,0,29,11,18,
1857,0,31,13,18,
1858,0,28,10,18,
1859,0,29,12,17,
1860,0,24,8,16,
1861,0,23,7,16,
1862,0,24,7,17,
1863,0,23,7,16,
1864,0,25,7,18,
1865,0,25,7,18,
1866,0,23,6,17,
1867,0,23,7,16,
1868,0,24,7,17,
1869,0,22,6,16,
1870,0,24,7,17,
1871,0,23,6,17,
1872,0,23,7,16,
1873,0,24,6,18,
1874,0,23,7,16,
1875,0,21,6,15,
1876,0,23,7,16,
1877,0,21,6,15,
1878,0,25,7,18,
1879,0,23,6,17,
1880,0,23,7,16,
1881,0,23,6,17,
1882,0,23,6,17,
1883,0,23,7,16,
1884,0,23,6,17,
1885,0,23,7,16,
1886,0,24,7,17,
1887,0,24,8,16,
1888,0,21,6,15,
1889,0,24,7,17,
1890,0,23,7,16,
1891,0,27,9,18,
1892,0,23,7,16,
1893,0,24,7,17,
1894,0,25,7,18,
1895,0,22,6,16,
1896,0,23,7,16,
1897,0,23,6,17,
1898,0,23,6,17,
1899,0,23,7,16,
1900,0,25,6,19,
1901,0,23,6,17,
1902,0,24,7,17,
1903,0,23,6,17,
1904,0,22,6,16,
1905,0,24,7,17,
1906,0,23,6,17,
1907,0,22,6,16,
1908,0,22,7,15,
1909,0,24,7,17,
1910,0,22,6,16,
1911,0,23,7,16,
1912,0,23,6,17,
1913,0,22,6,16,
1914,0,25,7,18,
1915,0,24,6,18,
1916,0,26,7,19,
1917,0,24,7,17,
1918,0,24,7,17,
1919,0,24,6,18,
1920,0,25,8,17,
1921,0,24,7,17,
1922,0,24,7,17,
1923,0,22,6,16,
1924,0,22,6,16,
1925,0,22,7,15,
1926,0,23,6,17,
1927,0,23,7,16,
1928,0,24,7,17,
1929,0,23,6,17,
1930,0,22,6,16,
1931,0,24,7,17,
1932,0,24,6,18,
1933,0,22,6,16,
1934,0,25,7,18,
1935,0,23,6,17,
1936,0,25,7,18,
1937,0,23,7,16,
1938,0,22,6,16,
1939,0,23,7,16,
1940,0,23,7,16,
1941,0,22,7,15,
1942,0,22,6,16,
1943,0,22,7,15,
1944,0,24,6,18,
1945,0,23,6,17,
1946,0,22,6,16,
1947,0,25,8,17,
1948,0,22,6,16,
1949,0,25,7,18,
1950,0,23,6,17,
1951,0,27,8,19,
1952,0,23,6,17,
1953,0,24,6,18,
1954,0,24,7,17,
1955,0,24,7,17,
1956,0,21,6,15,
1957,0,26,8,18,
1958,0,22,6,16,
1959,0,22,7,15,
1960,0,23,6,17,
1961,0,23,6,17,
1962,0,23,6,17,
1963,0,24,7,17,
1964,0,22,6,16,
1965,0,23,6,17,
1966,0,24,7,17,
1967,0,22,6,16,
1968,0,25,7,18,
1969,0,25,6,19,
1970,0,26,7,19,
1971,0,23,6,17,
1972,0,23,7,16,
1973,0,22,6,16,
1974,0,22,7,15,
1975,0,22,6,16,
1976,0,22,7,15,
1977,0,24,7,17,
1978,0,23,6,17,
1979,0,23,7,16,
1980,0,23,6,17,
1981,0,26,8,18,
1982,0,23,6,17,
1983,0,23,7,16,
1984,0,24,6,18,
1985,0,24,6,18,
1986,0,24,7,17,
1987,0,22,6,16,
1988,0,23,7,16,
1989,0,23,6,17,
1990,0,22,6,16,
1991,0,22,7,15,
1992,0,24,6,18,
1993,0,23,6,17,
1994,0,23,7,16,
1995,0,24,7,17,
1996,0,23,6,17,
1997,0,24,7,17,
1998,0,22,6,16,
1999,0,24,7,17,
2000,0,25,7,18,
2001,0,24,6,18,
2002,0,23,6,17,
2003,0,23,7,16,
2004,0,24,6,18,
2005,0,24,6,18,
2006,0,24,7,17,
2007,0,22,6,16,
2008,0,23,7,16,
2009,0,23,6,17,
2010,0,22,6,16,
2011,0,21,6,15,
2012,0,25,7,18,
2013,0,23,7,16,
2014,0,23,6,17,
2015,0,24,8,16,
2016,0,24,7,17,
2017,0,23,6,17,
2018,0,23,7,16,
2019,0,24,6,18,
2020,0,23,6,17,
2021,0,23,7,16,
2022,0,21,6,15,
2023,0,24,7,17,
2024,0,22,6,16,
2025,0,21,6,15,
2026,0,24,7,17,
2027,0,22,6,16,
2028,0,24,7,17,
2029,0,23,7,16,
2030,0,26,7,19,
2031,0,23,6,17,
2032,0,24,7,17,
2033,0,22,6,16,
2034,0,21,6,15,
2035,0,25,7,18,
2036,0,21,6,15,
2037,0,24,7,17,
2038,0,27,9,18,
2039,0,22,6,16,
2040,0,25,7,18,
2041,0,26,7,19,
2042,0,24,7,17,
2043,0,26,8,18,
2044,0,25,7,18,
2045,0,22,6,16,
2046,0,23,7,16,
2047,0,22,7,15,
2048,0,24,6,18,
2049,0,23,6,17,
2050,0,22,6,16,
2051,0,24,7,17,
2052,0,23,6,17,
2053,0,23,7,16,
2054,0,24,7,17,
2055,0,22,6,16,
2056,0,23,6,17,
2057,0,25,7,18,
2058,0,25,7,18,
2059,0,24,7,17,
2060,0,22,6,16,
2061,0,22,7,15,
2062,0,23,7,16,
2063,0,21,6,15,
2064,0,25,7,18,
2065,0,23,6,17,
2066,0,22,6,16,
2067,0,24,7,17,
2068,0,22,6,16,
2069,0,24,8,16,
2070,0,24,7,17,
2071,0,23,7,16,
2072,0,23,6,17,
2073,0,23,7,16,
2074,0,24,6,18,
2075,0,23,6,17,
2076,0,24,7,17,
2077,0,23,7,16,
2078,0,22,6,16,
2079,0,22,7,15,
2080,0,22,6,16,
2081,0,21,6,15,
2082,0,25,7,18,
2083,0,23,6,17,
2084,0,23,7,16,
2085,0,23,6,17,
2086,0,22,6,16,
2087,0,24,7,17,
2088,0,26,7,19,
2089,0,23,7,16,
2090,0,23,6,17,
2091,0,24,8,16,
2092,0,25,7,18,
2093,0,23,6,17,
2094,0,23,7,16,
2095,0,22,6,16,
2096,0,21,6,15,
2097,0,23,7,16,
2098,0,21,6,15,
2099,0,25,7,18,
2100,0,23,6,17,
2101,0,23,7,16,
2102,0,23,7,16,
2103,0,23,6,17,
2104,0,24,7,17,
2105,0,23,7,16,
2106,0,23,6,17,
2107,0,23,7,16,
2108,0,24,7,17,
2109,0,23,7,16,
2110,0,23,7,16,
2111,0,23,6,17,
2112,0,22,6,16,
2113,0,21,6,15,
2114,0,25,7,18,
2115,0,24,6,18,
2116,0,22,6,16,
2117,0,24,7,17,
2118,0,23,6,17,
2119,0,24,7,17,
2120,0,24,7,17,
2121,0,22,6,16,
2122,0,25,7,18,
2123,0,23,6,17,
2124,0,24,7,17,
2125,0,22,6,16,
2126,0,22,7,15,
2127,0,22,6,16,
2128,0,22,6,16,
2129,0,22,7,15,
2130,0,23,6,17,
2131,0,23,7,16,
2132,0,25,8,17,
2133,0,25,8,17,
2134,0,25,7,18,
2135,0,26,8,18,
2136,0,23,7,16,
2137,0,23,7,16,
2138,0,21,6,15,
2139,0,24,7,17,
2140,0,22,6,16,
2141,0,21,6,15,
2142,0,24,7,17,
2143,0,24,6,18,
2144,0,23,6,17,
2145,0,23,7,16,
2146,0,23,6,17,
2147,0,23,6,17,
2148,0,24,7,17,
2149,0,23,6,17,
2150,0,24,8,16,
2151,0,24,6,18,
2152,0,25,7,18,
2153,0,27,8,19,
2154,0,24,7,17,
2155,0,22,6,16,
2156,0,23,7,16,
2157,0,23,6,17,
2158,0,24,7,17,
2159,0,23,6,17,
2160,0,23,6,17,
2161,0,24,7,17,
2162,0,23,7,16,
2163,0,23,7,16,
2164,0,24,7,17,
2165,0,22,6,16,
2166,0,26,7,19,
2167,0,24,7,17,
2168,0,25,7,18,
2169,0,24,6,18,
2170,0,25,8,17,
2171,0,22,6,16,
2172,0,23,7,16,
2173,0,22,6,16,
2174,0,22,6,16,
2175,0,23,7,16,
2176,0,22,6,16,
2177,0,23,7,16,
2178,0,24,6,18,
2179,0,22,6,16,
2180,0,25,7,18,
2181,0,23,6,17,
2182,0,26,8,18,
2183,0,23,6,17,
2184,0,23,7,16,
2185,0,24,6,18,
2186,0,23,6,17,
2187,0,23,7,16,
2188,0,21,6,15,
2189,0,23,7,16,
2190,0,22,7,15,
2191,0,23,7,16,
2192,0,21,6,15,
2193,0,24,7,17,
2194,0,25,8,17,
2195,0,23,6,17,
2196,0,24,7,17,
2197,0,22,6,16,
2198,0,25,7,18,
2199,0,23,6,17,
2200,0,23,7,16,
2201,0,24,6,18,
2202,0,23,6,17,
2203,0,23,7,16,
2204,0,21,6,15,
2205,0,24,7,17,
2206,0,22,6,16,
2207,0,21,6,15,
2208,0,24,7,17,
2209,0,22,6,16,
2210,0,25,7,18,
2211,0,23,6,17,
2212,0,25,7,18,
2213,0,22,6,16,
2214,0,26,7,19,
2215,0,24,6,18,
2216,0,24,7,17,
2217,0,22,6,16,
2218,0,21,6,15,
2219,0,23,7,16,
2220,0,30,12,18,
2221,0,29,11,18,
2222,0,31,13,18,
2223,0,30,12,18,
2224,0,31,13,18,
2225,0,32,13,19,
2226,0,30,12,18,
2227,0,29,11,18,
2228,0,29,13,16,
2229,0,29,11,18,
2230,0,30,13,17,
2231,0,30,12,18,
2232,0,29,11,18,
2233,0,23,7,16,
2234,0,23,6,17,
2235,0,23,7,16,
2236,0,24,6,18,
2237,0,23,6,17,
2238,0,25,7,18,
2239,0,22,6,16,
2240,0,23,7,16,
2241,0,23,6,17,
2242,0,24,7,17,
2243,0,25,7,18,
2244,0,23,6,17,
2245,0,24,7,17,
2246,0,23,7,16,
2247,0,22,6,16,
2248,0,23,7,16,
2249,0,23,6,17,
2250,0,24,7,17,
2251,0,25,7,18,
2252,0,27,7,20,
2253,0,22,6,16,
2254,0,26,7,19,
2255,0,24,7,17,
2256,0,25,7,18,
2257,0,25,8,17,
2258,0,25,8,17,
2259,0,22,6,16,
2260,0,22,7,15,
2261,0,24,7,17,
2262,0,23,6,17,
2263,0,21,6,15,
2264,0,24,7,17,
2265,0,24,6,18,
2266,0,23,6,17,
2267,0,24,7,17,
2268,0,22,6,16,
2269,0,23,6,17,
2270,0,25,7,18,
2271,0,23,6,17,
2272,0,23,7,16,
2273,0,23,7,16,
2274,0,24,6,18,
2275,0,23,6,17,
2276,0,23,7,16,
2277,0,22,6,16,
2278,0,22,7,15,
2279,0,23,7,16,
2280,0,21,6,15,
2281,0,24,7,17,
2282,0,22,6,16,
2283,0,25,7,18,
2284,0,23,6,17,
2285,0,22,6,16,
2286,0,24,7,17,
2287,0,25,7,18,
2288,0,24,6,18,
2289,0,24,7,17,
2290,0,22,6,16,
2291,0,24,7,17,
2292,0,24,7,17,
2293,0,22,6,16,
2294,0,24,7,17,
2295,0,22,7,15,
2296,0,23,6,17,
2297,0,25,7,18,
2298,0,22,6,16,
2299,0,24,7,17,
2300,0,23,6,17,
2301,0,23,7,16,
2302,0,26,8,18,
2303,0,25,8,17,
2304,0,22,6,16,
2305,0,22,7,15,
2306,0,23,7,16,
2307,0,21,6,15,
2308,0,26,8,18,
2309,0,24,6,18,
2310,0,26,7,19,
2311,0,24,7,17,
2312,0,23,7,16,
2313,0,23,6,17,
2314,0,25,7,18,
2315,0,22,6,16,
2316,0,26,7,19,
2317,0,24,7,17,
2318,0,24,7,17,
2319,0,25,6,19,
2320,0,24,7,17,
2321,0,22,6,16,
2322,0,23,7,16,
2323,0,23,6,17,
2324,0,21,6,15,
2325,0,24,7,17,
2326,0,23,6,17,
2327,0,24,7,17,
2328,0,24,7,17,
2329,0,22,6,16,
2330,0,23,7,16,
2331,0,23,6,17,
2332,0,23,6,17,
2333,0,24,8,16,
2334,0,24,6,18,
2335,0,24,7,17,
2336,0,22,6,16,
2337,0,21,6,15,
2338,0,23,7,16,
2339,0,22,6,16,
2340,0,22,7,15,
2341,0,22,6,16,
2342,0,24,7,17,
2343,0,23,7,16,
2344,0,24,7,17,
2345,0,26,8,18,
2346,0,23,7,16,
2347,0,24,6,18,
2348,0,23,6,17,
2349,0,24,7,17,
2350,0,23,7,16,
2351,0,24,7,17,
2352,0,23,6,17,
2353,0,22,6,16,
2354,0,24,7,17,
2355,0,22,6,16,
2356,0,25,8,17,
2357,0,24,6,18,
2358,0,24,7,17,
2359,0,22,6,16,
2360,0,21,6,15,
2361,0,24,7,17,
2362,0,22,6,16,
2363,0,21,6,15,
2364,0,24,7,17,
2365,0,22,6,16,
2366,0,25,7,18,
2367,0,23,6,17,
2368,0,23,7,16,
2369,0,23,6,17,
2370,0,23,6,17,
2371,0,25,7,18,
2372,0,23,7,16,
2373,0,25,6,19,
2374,0,24,7,17,
2375,0,24,7,17,
2376,0,22,6,16,
2377,0,21,6,15,
2378,0,24,7,17,
2379,0,22,7,15,
2380,0,23,6,17,
2381,0,22,6,16,
2382,0,24,7,17,
2383,0,22,6,16,
2384,0,24,7,17,
2385,0,26,7,19,
2386,0,24,6,18,
2387,0,23,6,17,
2388,0,23,7,16,
2389,0,25,7,18,
2390,0,22,6,16,
2391,0,22,7,15,
2392,0,23,6,17,
2393,0,24,7,17,
2394,0,25,7,18,
2395,0,23,6,17,
2396,0,22,6,16,
2397,0,24,7,17,
2398,0,22,6,16,
2399,0,24,7,17,
2400,0,23,6,17,
2401,0,25,7,18,
2402,0,26,8,18,
2403,0,23,6,17,
2404,0,24,7,17,
2405,0,25,8,17,
2406,0,22,6,16,
2407,0,21,6,15,
2408,0,23,7,16,
2409,0,21,6,15,
2410,0,27,8,19,
2411,0,23,6,17,
2412,0,22,7,15,
2413,0,23,6,17,
2414,0,22,6,16,
2415,0,24,7,17,
2416,0,23,7,16,
2417,0,24,7,17,
2418,0,23,6,17,
2419,0,26,7,19,
2420,0,24,6,18,
2421,0,24,7,17,
2422,0,24,7,17,
2423,0,22,7,15,
2424,0,22,6,16,
2425,0,24,7,17,
2426,0,25,8,17,
2427,0,24,6,18,
2428,0,23,6,17,
2429,0,23,7,16,
2430,0,24,7,17,
2431,0,23,6,17,
2432,0,25,7,18,
2433,0,22,6,16,
2434,0,25,7,18,
2435,0,25,7,18,
2436,0,25,8,17,
2437,0,22,6,16,
2438,0,21,6,15,
2439,0,24,8,16,
2440,0,23,7,16,
2441,0,21,6,15,
2442,0,24,7,17,
2443,0,23,6,17,
2444,0,23,7,16,
2445,0,24,7,17,
2446,0,22,6,16,
2447,0,24,7,17,
2448,0,22,6,16,
2449,0,23,7,16,
2450,0,24,6,18,
2451,0,23,6,17,
2452,0,23,7,16,
2453,0,22,6,16,
2454,0,22,7,15,
2455,0,24,7,17,
2456,0,21,6,15,
2457,0,23,7,16,
2458,0,21,6,15,
2459,0,25,7,18,
2460,0,23,6,17,
2461,0,22,6,16,
2462,0,24,7,17,
2463,0,26,8,18,
2464,0,24,6,18,
2465,0,22,6,16,
2466,0,24,7,17,
2467,0,26,7,19,
2468,0,24,6,18,
2469,0,23,6,17,
2470,0,25,8,17,
2471,0,23,7,16,
2472,0,22,6,16,
2473,0,22,7,15,
2474,0,22,6,16,
2475,0,21,6,15,
2476,0,25,7,18,
2477,0,23,6,17,
2478,0,23,7,16,
2479,0,23,6,17,
2480,0,23,7,16,
2481,0,28,11,17,
2482,0,30,12,18,
2483,0,31,12,19,
2484,0,28,11,17,
2485,0,31,13,18,
2486,0,29,12,17,
2487,0,29,12,17,
2488,0,29,10,19,
2489,0,33,14,19,
2490,0,30,12,18,
2491,0,29,11,18,
2492,0,30,12,18,
2493,0,30,12,18,
2494,0,31,13,18,
2495,0,28,10,18,
2496,0,30,11,19,
2497,0,30,12,18,
2498,0,30,13,17,
2499,0,31,14,17,
2500,0,31,13,18,
2501,0,29,13,16,
2502,0,27,11,16,
2503,0,29,12,17,
2504,0,30,12,18,
2505,0,30,11,19,
2506,0,30,12,18,
2507,0,28,11,17,
2508,0,31,11,20,
2509,0,30,12,18,
2510,0,30,13,17,
2511,0,31,13,18,
2512,0,29,12,17,
2513,0,30,12,18,
2514,0,30,13,17,
2515,0,28,11,17,
2516,0,30,13,17,
2517,0,30,12,18,
2518,0,30,12,18,
2519,0,28,11,17,
2520,0,31,13,18,
2521,0,32,13,19,
2522,0,31,13,18,
2523,0,29,12,17,
2524,0,30,13,17,
2525,0,29,12,17,
2526,0,28,12,16,
2527,0,29,12,17,
2528,0,31,11,20,
2529,0,28,11,17,
2530,0,31,12,19,
2531,0,31,13,18,
2532,0,29,12,17,
2533,0,29,11,18,
2534,0,28,12,16,
2535,0,30,13,17,
2536,0,28,12,16,
2537,0,29,12,17,
2538,0,28,12,16,
2539,0,28,11,17,
2540,0,31,12,19,
2541,0,29,12,17,
2542,0,29,11,18,
2543,0,30,12,18,
2544,0,30,12,18,
2545,0,29,12,17,
2546,0,29,12,17,
2547,0,30,12,18,
2548,0,30,11,19,
2549,0,29,12,17,
2550,0,30,11,19,
2551,0,29,11,18,
2552,0,30,12,18,
2553,0,30,13,17,
2554,0,29,12,17,
2555,0,31,12,19,
2556,0,30,12,18,
2557,0,31,13,18,
2558,0,29,11,18,
2559,0,33,14,19,
2560,0,29,10,19,
2561,0,30,12,18,
2562,0,30,12,18,
2563,0,30,13,17,
2564,0,29,13,16,
2565,0,31,13,18,
2566,0,30,12,18,
2567,0,30,11,19,
2568,0,31,13,18,
2569,0,31,13,18,
2570,0,32,12,20,
2571,0,31,12,19,
2572,0,27,10,17,
2573,0,29,12,17,
2574,0,29,12,17,
2575,0,29,12,17,
2576,0,32,14,18,
2577,0,31,13,18,
2578,0,30,12,18,
2579,0,30,12,18,
2580,0,31,12,19,
2581,0,31,12,19,
2582,0,31,13,18,
2583,0,29,11,18,
2584,0,24,7,17,
2585,0,23,7,16,
2586,0,24,7,17,
2587,0,22,6,16,
2588,0,23,7,16,
2589,0,24,7,17,
2590,0,22,6,16,
2591,0,21,6,15,
2592,0,24,7,17,
2593,0,25,7,18,
2594,0,23,6,17,
2595,0,23,7,16,
2596,0,23,6,17,
2597,0,22,6,16,
2598,0,26,7,19,
2599,0,24,6,18,
2600,0,24,7,17,
2601,0,22,6,16,
2602,0,23,7,16,
2603,0,22,7,15,
2604,0,23,7,16,
2605,0,24,6,18,
2606,0,23,6,17,
2607,0,22,6,16,
2608,0,23,7,16,
2609,0,25,7,18,
2610,0,23,6,17,
2611,0,23,7,16,
2612,0,24,7,17,
2613,0,22,6,16,
2614,0,24,7,17,
2615,0,24,7,17,
2616,0,22,6,16,
2617,0,23,7,16,
2618,0,23,7,16,
2619,0,24,7,17,
2620,0,22,6,16,
2621,0,24,7,17,
2622,0,22,7,15,
2623,0,24,7,17,
2624,0,23,7,16,
2625,0,25,7,18,
2626,0,23,6,17,
2627,0,22,6,16,
2628,0,25,7,18,
2629,0,23,6,17,
2630,0,23,7,16,
2631,0,24,6,18,
2632,0,23,6,17,
2633,0,23,7,16,
2634,0,22,6,16,
2635,0,21,6,15,
2636,0,22,7,15,
2637,0,22,7,15,
2638,0,23,7,16,
2639,0,22,6,16,
2640,0,24,7,17,
2641,0,22,6,16,
2642,0,24,7,17,
2643,0,24,6,18,
2644,0,23,6,17,
2645,0,24,7,17,
2646,0,22,6,16,
2647,0,22,7,15,
2648,0,23,7,16,
2649,0,22,7,15,
2650,0,22,6,16,
2651,0,21,6,15,
2652,0,25,7,18,
2653,0,24,6,18,
2654,0,24,7,17,
2655,0,23,7,16,
2656,0,24,6,18,
2657,0,23,6,17,
2658,0,23,7,16,
2659,0,24,7,17,
2660,0,22,6,16,
2661,0,25,7,18,
2662,0,24,6,18,
2663,0,23,6,17,
2664,0,24,7,17,
2665,0,22,6,16,
2666,0,23,7,16,
2667,0,23,7,16,
2668,0,23,7,16,
2669,0,23,6,17,
2670,0,22,7,15,
2671,0,23,6,17,
2672,0,22,6,16,
2673,0,24,7,17,
2674,0,25,8,17,
2675,0,31,11,20,
2676,0,30,11,19,
2677,0,29,11,18,
2678,0,28,10,18,
2679,0,29,10,19,
2680,0,29,10,19,
2681,0,33,12,21,
2682,0,30,11,19,
2683,0,31,11,20,
2684,0,28,10,18,
2685,0,30,11,19,
2686,0,32,12,20,
2687,0,29,10,19,
2688,0,28,10,18,
2689,0,31,11,20,
2690,0,30,10,20,
2691,0,32,12,20,
2692,0,29,10,19,
2693,0,29,11,18,
2694,0,30,11,19,
2695,0,30,11,19,
2696,0,32,12,20,
2697,0,30,12,18,
2698,0,29,12,17,
2699,0,30,12,18,
2700,0,30,12,18,
2701,0,32,10,22,
2702,0,31,11,20,
2703,0,28,9,19,
2704,0,30,12,18,
2705,0,30,11,19,
2706,0,31,11,20,
2707,0,28,10,18,
2708,0,31,11,20,
2709,0,31,11,20,
2710,0,29,11,18,
2711,0,31,11,20,
2712,0,28,10,18,
2713,0,29,12,17,
2714,0,28,12,16,
2715,0,30,11,19,
2716,0,31,11,20,
2717,0,29,10,19,
2718,0,31,11,20,
2719,0,30,11,19,
2720,0,29,11,18,
2721,0,30,12,18,
2722,0,29,11,18,
2723,0,31,11,20,
2724,0,30,11,19,
2725,0,30,11,19,
2726,0,31,10,21,
2727,0,30,12,18,
2728,0,29,12,17,
2729,0,29,10,19,
2730,0,25,7,18,
2731,0,23,6,17,
2732,0,24,6,18,
2733,0,24,7,17,
2734,0,22,6,16,
2735,0,22,6,16,
2736,0,22,7,15,
2737,0,22,6,16,
2738,0,24,7,17,
2739,0,24,7,17,
2740,0,25,7,18,
2741,0,24,6,18,
2742,0,25,7,18,
2743,0,23,7,16,
2744,0,24,7,17,
2745,0,22,6,16,
2746,0,23,7,16,
2747,0,23,7,16,
2748,0,24,6,18,
2749,0,23,6,17,
2750,0,23,7,16,
2751,0,22,6,16,
2752,0,21,6,15,
2753,0,23,7,16,
2754,0,21,6,15,
2755,0,23,7,16,
2756,0,23,6,17,
2757,0,23,7,16,
2758,0,23,7,16,
2759,0,24,7,17,
2760,0,23,6,17,
2761,0,22,6,16,
2762,0,25,7,18,
2763,0,24,6,18,
2764,0,25,7,18,
2765,0,22,7,15,
2766,0,23,7,16,
2767,0,23,7,16,
2768,0,26,8,18,
2769,0,24,9,15,
2770,0,22,6,16,
2771,0,21,6,15,
2772,0,24,7,17,
2773,0,20,7,13,
2774,0,5,,5,
2776,0,31,12,19,
2777,0,33,12,21,
2778,0,35,12,23,
2779,0,36,11,25,
2780,0,38,12,26,
2781,0,38,11,27,
2782,0,40,11,29,
2783,0,40,11,29,
2784,0,42,12,30,
2785,0,42,13,29,
2786,0,42,11,31,
2787,0,43,11,32,
2788,0,44,12,32,
2789,0,45,11,34,
2790,0,45,11,34,
2791,0,42,8,34,
2792,0,42,7,35,
2793,0,41,7,34,
2794,0,42,6,36,
2795,0,43,7,36,
2796,0,44,8,36,
2797,0,43,6,37,
2798,0,44,6,38,
2799,0,45,8,37,
2800,0,44,6,38,
2801,0,46,7,39,
2802,0,45,6,39,
2803,0,47,8,39,
2804,0,47,6,41,
2805,0,46,6,40,
2806,0,49,7,42,
2807,0,50,7,43,
2808,0,48,6,42,
2809,0,48,6,42,
2810,0,50,7,43,
2811,0,50,6,44,
2812,0,50,7,43,
2813,0,50,6,44,
2814,0,50,6,44,
2815,0,52,7,45,
2816,0,52,6,46,
2817,0,51,6,45,
2818,0,52,7,45,
2819,0,54,7,47,
2820,0,54,8,46,
2821,0,53,6,47,
2822,0,55,7,48,
2823,0,53,6,47,
2824,0,56,7,49,
2825,0,55,6,49,
2826,0,57,7,50,
2827,0,56,6,50,
2828,0,55,6,49,
2829,0,57,8,49,
2830,0,58,7,51,
2831,0,57,6,51,
2832,0,57,7,50,
2833,0,58,7,51,
2834,0,59,7,52,
2835,0,58,6,52,
2836,0,58,7,51,
2837,0,59,7,52,
2838,0,60,7,53,
2839,0,59,6,53,
2840,0,60,7,53,
2841,0,60,6,54,
2842,0,59,6,53,
2843,0,62,7,55,
2844,0,61,6,55,
2845,0,60,6,54,
2846,0,63,7,56,
2847,0,61,6,55,
2848,0,62,7,55,
2849,0,62,6,56,
2850,0,62,6,56,
2851,0,64,7,57,
2852,0,64,7,57,
2853,0,70,11,59,
2854,0,72,11,61,
2855,0,71,10,61,
2856,0,72,12,60,
2857,0,71,12,59,
2858,0,71,11,60,
2859,0,72,11,61,
2860,0,74,12,62,
2861,0,72,9,63,
2862,0,72,11,61,
2863,0,74,12,62,
2864,0,73,11,62,
2865,0,73,11,62,
2866,0,75,13,62,
2867,0,75,10,65,
2868,0,75,10,65,
2869,0,75,12,63,
2870,0,75,11,64,
2871,0,77,13,64,
2872,0,76,12,64,
2873,0,78,13,65,
2874,0,77,12,65,
2875,0,78,12,66,
2876,0,76,12,64,
2877,0,78,13,65,
2878,0,77,12,65,
2879,0,77,12,65,
2880,0,79,13,66,
2881,0,81,13,68,
2882,0,79,11,68,
2883,0,80,14,66,
2884,0,78,13,65,
2885,0,80,12,68,
2886,0,79,11,68,
2887,0,82,13,69,
2888,0,81,13,68,
2889,0,84,14,70,
2890,0,81,12,69,
2891,0,80,10,70,
2892,0,83,12,71,
2893,0,82,12,70,
2894,0,81,12,69,
2895,0,81,12,69,
2896,0,83,11,72,
2897,0,82,12,70,
2898,0,84,12,72,
2899,0,82,11,71,
2900,0,85,13,72,
2901,0,84,12,72,
2902,0,85,13,72,
2903,0,83,12,71,
2904,0,84,13,71,
2905,0,84,11,73,
2906,0,85,13,72,
2907,0,86,12,74,
2908,0,85,12,73,
2909,0,85,12,73,
2910,0,87,13,74,
2911,0,86,12,74,
2912,0,87,12,75,
2913,0,85,12,73,
2914,0,87,13,74,
2915,0,87,13,74,
2916,0,86,12,74,
2917,0,88,13,75,
2918,0,87,11,76,
2919,0,88,11,77,
2920,0,88,13,75,
2921,0,87,13,74,
2922,0,88,12,76,
2923,0,90,13,77,
2924,0,89,13,76,
2925,0,89,12,77,
2926,0,89,13,76,
2927,0,88,11,77,
2928,0,89,12,77,
2929,0,88,12,76,
2930,0,90,12,78,
2931,0,88,11,77,
2932,0,88,12,76,
2933,0,75,11,64,
2934,0,62,11,51,
2935,0,62,12,50,
2936,0,56,12,44,
2937,0,44,9,35,
2938,0,39,12,27,
2939,0,34,13,21,
2940,0,36,11,25,
2941,0,46,12,34,
2942,0,47,12,35,
2943,0,47,11,36,
2944,0,47,12,35,
2945,0,48,12,36,
2946,0,49,12,37,
2947,0,48,13,35,
2948,0,49,12,37,
2949,0,52,11,41,
2950,0,51,12,39,
2951,0,53,12,41,
2952,0,52,13,39,
2953,0,53,13,40,
2954,0,52,11,41,
2955,0,54,11,43,
2956,0,54,12,42,
2957,0,55,12,43,
2958,0,53,10,43,
2959,0,56,12,44,
2960,0,56,12,44,
2961,0,56,11,45,
2962,0,56,12,44,
2963,0,60,12,48,
2964,0,58,11,47,
2965,0,58,11,47,
2966,0,57,10,47,
2967,0,59,11,48,
2968,0,59,11,48,
2969,0,59,12,47,
2970,0,62,12,50,
2971,0,62,11,51,
2972,0,60,11,49,
2973,0,62,12,50,
2974,0,62,12,50,
2975,0,62,13,49,
2976,0,61,10,51,
2977,0,63,12,51,
2978,0,64,12,52,
2979,0,63,10,53,
2980,0,64,12,52,
2981,0,65,12,53,
2982,0,65,12,53,
2983,0,64,12,52,
2984,0,65,12,53,
2985,0,66,11,55,
2986,0,66,11,55,
2987,0,66,11,55,
2988,0,67,12,55,
2989,0,66,11,55,
2990,0,67,12,55,
2991,0,68,11,57,
2992,0,68,12,56,
2993,0,69,11,58,
2994,0,69,13,56,
2995,0,68,11,57,
2996,0,70,12,58,
2997,0,70,12,58,
2998,0,68,10,58,
2999,0,73,12,61,
3000,0,70,11,59,
3001,0,71,11,60,
3002,0,71,11,60,
3003,0,71,11,60,
3004,0,72,12,60,
3005,0,74,12,62,
3006,0,73,10,63,
3007,0,73,11,62,
3008,0,73,12,61,
3009,0,74,11,63,
3010,0,73,12,61,
3011,0,73,11,62,
3012,0,74,13,61,
3013,0,75,11,64,
3014,0,75,10,65,
3015,0,77,11,66,
3016,0,76,12,64,
3017,0,75,12,63,
3018,0,75,11,64,
3019,0,78,13,65,
3020,0,76,10,66,
3021,0,79,12,67,
3022,0,73,8,65,
3023,0,71,6,65,
3024,0,70,6,64,
3025,0,72,7,65,
3026,0,71,6,65,
3027,0,72,7,65,
3028,0,72,6,66,
3029,0,71,6,65,
3030,0,73,7,66,
3031,0,73,6,67,
3032,0,76,8,68,
3033,0,73,6,67,
3034,0,72,6,66,
3035,0,74,7,67,
3036,0,73,6,67,
3037,0,76,7,69,
3038,0,79,11,68,
3039,0,77,9,68,
3040,0,77,7,70,
3041,0,74,6,68,
3042,0,76,7,69,
3043,0,75,6,69,
3044,0,78,8,70,
3045,0,76,7,69,
3046,0,77,7,70,
3047,0,75,6,69,
3048,0,77,7,70,
3049,0,77,6,71,
3050,0,76,6,70,
3051,0,77,7,70,
3052,0,77,7,70,
3053,0,77,6,71,
3054,0,77,6,71,
3055,0,79,7,72,
3056,0,77,6,71,
3057,0,78,7,71,
3058,0,79,6,73,
3059,0,78,6,72,
3060,0,81,7,74,
3061,0,79,6,73,
3062,0,79,7,72,
3063,0,81,7,74,
3064,0,79,6,73,
3065,0,81,7,74,
3066,0,80,7,73,
3067,0,80,6,74,
3068,0,80,6,74,
3069,0,83,7,76,
3070,0,81,7,74,
3071,0,81,6,75,
3072,0,81,7,74,
3073,0,83,7,76,
3074,0,81,6,75,
3075,0,84,7,77,
3076,0,82,6,76,
3077,0,81,6,75,
3078,0,83,7,76,
3079,0,82,6,76,
3080,0,82,7,75,
3081,0,82,7,75,
3082,0,82,7,75,
3083,0,81,7,74,
3084,0,69,7,62,
3085,0,58,7,51,
3086,0,53,6,47,
3087,0,51,6,45,
3088,0,45,6,39,
3089,0,35,7,28,
3090,0,28,7,21,
3091,0,23,7,16,
3092,0,29,6,23,
3093,0,38,6,32,
3094,0,41,7,34,
3095,0,40,6,34,
3096,0,42,7,35,
3097,0,40,6,34,
3098,0,43,7,36,
3099,0,41,6,35,
3100,0,45,9,36,
3101,0,45,8,37,
3102,0,51,11,40,
3103,0,53,11,42,
3104,0,51,12,39,
3105,0,52,11,41,
3106,0,53,12,41,
3107,0,54,12,42,
3108,0,53,11,42,
3109,0,54,12,42,
3110,0,55,11,44,
3111,0,55,12,43,
3112,0,55,11,44,
3113,0,56,12,44,
3114,0,57,11,46,
3115,0,57,12,45,
3116,0,58,12,46,
3117,0,58,11,47,
3118,0,58,11,47,
3119,0,59,12,47,
3120,0,59,11,48,
3121,0,60,12,48,
3122,0,59,12,47,
3123,0,60,10,50,
3124,0,62,12,50,
3125,0,62,11,51,
3126,0,62,11,51,
3127,0,61,12,49,
3128,0,63,11,52,
3129,0,66,13,53,
3130,0,64,11,53,
3131,0,64,11,53,
3132,0,63,11,52,
3133,0,64,12,52,
3134,0,64,11,53,
3135,0,66,12,54,
3136,0,65,12,53,
3137,0,66,11,55,
3138,0,65,10,55,
3139,0,67,12,55,
3140,0,67,12,55,
3141,0,67,12,55,
3142,0,67,11,56,
3143,0,71,12,59,
3144,0,70,11,59,
3145,0,69,11,58,
3146,0,68,12,56,
3147,0,71,13,58,
3148,0,70,12,58,
3149,0,71,13,58,
3150,0,69,12,57,
3151,0,70,11,59,
3152,0,70,11,59,
3153,0,71,12,59,
3154,0,72,12,60,
3155,0,71,11,60,
3156,0,64,12,52,
3157,0,50,12,38,
3158,0,35,11,24,
