window-id,queue-size-CL,queue-size-LL,10.0.0.13:46371 -> 10.0.1.13:3000,10.0.1.13:3000 -> 10.0.0.13:46371,10.0.0.13:48821 -> 10.0.1.13:1000
0,0,34,10,24,
1,0,40,6,34,
2,0,37,7,30,
3,0,30,6,24,
4,0,29,7,22,
5,0,26,7,19,
6,0,24,6,18,
7,0,24,6,18,
8,0,23,7,16,
9,0,23,6,17,
10,0,25,7,18,
11,0,23,6,17,
12,0,25,7,18,
13,0,23,7,16,
14,0,24,7,17,
15,0,21,6,15,
16,0,27,7,20,
17,0,24,6,18,
18,0,23,6,17,
19,0,26,7,19,
20,0,25,7,18,
21,0,24,6,18,
22,0,23,7,16,
23,0,21,6,15,
24,0,23,7,16,
25,0,22,6,16,
26,0,22,7,15,
27,0,26,9,17,
28,0,30,13,17,
29,0,29,13,16,
30,0,26,11,15,
31,0,28,13,15,
32,0,29,13,16,
33,0,28,12,16,
34,0,29,12,17,
35,0,27,12,15,
36,0,30,13,17,
37,0,29,12,17,
38,0,31,11,20,
39,0,25,8,17,
40,0,25,8,17,
41,0,23,7,16,
42,0,23,7,16,
43,0,24,7,17,
44,0,22,7,15,
45,0,23,6,17,
46,0,25,6,19,
47,0,23,6,17,
48,0,22,6,16,
49,0,24,7,17,
50,0,25,8,17,
51,0,24,7,17,
52,0,23,7,16,
53,0,23,6,17,
54,0,25,6,19,
55,0,26,8,18,
56,0,22,6,16,
57,0,25,7,18,
58,0,24,7,17,
59,0,24,7,17,
60,0,22,6,16,
61,0,23,7,16,
62,0,21,6,15,
63,0,24,7,17,
64,0,23,6,17,
65,0,22,6,16,
66,0,23,7,16,
67,0,24,7,17,
68,0,23,7,16,
69,0,23,6,17,
70,0,25,6,19,
71,0,23,6,17,
72,0,23,7,16,
73,0,24,7,17,
74,0,21,5,16,
75,0,24,7,17,
76,0,22,6,16,
77,0,21,6,15,
78,0,24,7,17,
79,0,22,6,16,
80,0,23,7,16,
81,0,23,7,16,
82,0,26,7,19,
83,0,23,6,17,
84,0,26,7,19,
85,0,23,7,16,
86,0,23,6,17,
87,0,21,6,15,
88,0,23,7,16,
89,0,24,6,18,
90,0,23,7,16,
91,0,23,6,17,
92,0,24,7,17,
93,0,23,6,17,
94,0,22,6,16,
95,0,25,7,18,
96,0,23,6,17,
97,0,26,8,18,
98,0,22,6,16,
99,0,22,6,16,
100,0,22,6,16,
101,0,25,8,17,
102,0,23,6,17,
103,0,22,6,16,
104,0,24,7,17,
105,0,23,6,17,
106,0,23,7,16,
107,0,23,6,17,
108,0,22,6,16,
109,0,25,7,18,
110,0,27,9,18,
111,0,25,7,18,
112,0,23,7,16,
113,0,22,6,16,
114,0,22,7,15,
115,0,22,6,16,
116,0,21,6,15,
117,0,24,7,17,
118,0,25,7,18,
119,0,24,6,18,
120,0,25,7,18,
121,0,23,6,17,
122,0,24,7,17,
123,0,23,6,17,
124,0,23,6,17,
125,0,21,6,15,
126,0,24,7,17,
127,0,23,6,17,
128,0,23,7,16,
129,0,23,6,17,
130,0,22,6,16,
131,0,25,7,18,
132,0,23,6,17,
133,0,25,7,18,
134,0,22,6,16,
135,0,24,7,17,
136,0,22,7,15,
137,0,22,6,16,
138,0,21,6,15,
139,0,24,7,17,
140,0,23,6,17,
141,0,24,7,17,
142,0,23,7,16,
143,0,23,6,17,
144,0,22,6,16,
145,0,24,7,17,
146,0,23,6,17,
147,0,25,7,18,
148,0,23,7,16,
149,0,24,7,17,
150,0,25,7,18,
151,0,22,6,16,
152,0,24,7,17,
153,0,24,7,17,
154,0,24,6,18,
155,0,24,7,17,
156,0,22,6,16,
157,0,22,7,15,
158,0,24,7,17,
159,0,24,7,17,
160,0,24,6,18,
161,0,22,6,16,
162,0,23,7,16,
163,0,22,6,16,
164,0,24,7,17,
165,0,24,6,18,
166,0,24,7,17,
167,0,23,6,17,
168,0,23,6,17,
169,0,25,7,18,
170,0,23,6,17,
171,0,23,6,17,
172,0,23,7,16,
173,0,24,7,17,
174,0,23,6,17,
175,0,24,7,17,
176,0,23,6,17,
177,0,21,6,15,
178,0,24,7,17,
179,0,23,6,17,
180,0,24,6,18,
181,0,25,6,19,
182,0,25,8,17,
183,0,23,6,17,
184,0,22,6,16,
185,0,24,7,17,
186,0,23,6,17,
187,0,23,7,16,
188,0,23,6,17,
189,0,26,7,19,
190,0,23,6,17,
191,0,23,7,16,
192,0,24,7,17,
193,0,21,6,15,
194,0,25,7,18,
195,0,24,7,17,
196,0,24,6,18,
197,0,23,6,17,
198,0,22,6,16,
199,0,22,7,15,
200,0,23,7,16,
201,0,23,8,15,
202,0,25,8,17,
203,0,24,7,17,
204,0,23,7,16,
205,0,21,6,15,
206,0,23,7,16,
207,0,22,6,16,
208,0,22,7,15,
209,0,24,7,17,
210,0,22,6,16,
211,0,22,7,15,
212,0,23,6,17,
213,0,25,8,17,
214,0,23,6,17,
215,0,25,6,19,
216,0,24,6,18,
217,0,23,6,17,
218,0,23,7,16,
219,0,21,6,15,
220,0,23,7,16,
221,0,22,7,15,
222,0,23,6,17,
223,0,22,6,16,
224,0,24,7,17,
225,0,24,6,18,
226,0,23,6,17,
227,0,23,7,16,
228,0,24,6,18,
229,0,22,6,16,
230,0,24,7,17,
231,0,25,8,17,
232,0,24,7,17,
233,0,24,6,18,
234,0,23,7,16,
235,0,26,8,18,
236,0,23,6,17,
237,0,23,7,16,
238,0,24,6,18,
239,0,23,6,17,
240,0,23,7,16,
241,0,22,6,16,
242,0,22,7,15,
243,0,21,6,15,
244,0,25,7,18,
245,0,22,6,16,
246,0,25,6,19,
247,0,24,6,18,
248,0,24,6,18,
249,0,25,7,18,
250,0,24,6,18,
251,0,24,7,17,
252,0,22,6,16,
253,0,22,6,16,
254,0,25,7,18,
255,0,23,7,16,
256,0,23,6,17,
257,0,23,6,17,
258,0,24,7,17,
259,0,24,6,18,
260,0,23,7,16,
261,0,23,6,17,
262,0,22,6,16,
263,0,23,7,16,
264,0,24,6,18,
265,0,24,7,17,
266,0,24,6,18,
267,0,25,7,18,
268,0,23,6,17,
269,0,24,7,17,
270,0,23,6,17,
271,0,24,7,17,
272,0,24,7,17,
273,0,25,8,17,
274,0,23,7,16,
275,0,25,8,17,
276,0,22,6,16,
277,0,24,7,17,
278,0,24,6,18,
279,0,24,6,18,
280,0,23,7,16,
281,0,22,6,16,
282,0,24,7,17,
283,0,23,6,17,
284,0,23,7,16,
285,0,24,7,17,
286,0,22,6,16,
287,0,26,7,19,
288,0,23,6,17,
289,0,22,6,16,
290,0,26,7,19,
291,0,24,6,18,
292,0,26,9,17,
293,0,25,9,16,
294,0,24,7,17,
295,0,21,6,15,
296,0,27,8,19,
297,0,22,5,17,
298,0,24,7,17,
299,0,22,6,16,
300,0,23,7,16,
301,0,23,6,17,
302,0,23,7,16,
303,0,23,6,17,
304,0,26,8,18,
305,0,25,6,19,
306,0,22,6,16,
307,0,23,6,17,
308,0,25,7,18,
309,0,23,6,17,
310,0,23,7,16,
311,0,23,6,17,
312,0,22,6,16,
313,0,25,7,18,
314,0,24,6,18,
315,0,25,7,18,
316,0,24,6,18,
317,0,23,6,17,
318,0,25,7,18,
319,0,23,6,17,
320,0,24,7,17,
321,0,23,7,16,
322,0,24,7,17,
323,0,22,6,16,
324,0,25,7,18,
325,0,23,6,17,
326,0,25,7,18,
327,0,22,6,16,
328,0,25,7,18,
329,0,23,6,17,
330,0,24,7,17,
331,0,22,6,16,
332,0,21,6,15,
333,0,23,7,16,
334,0,23,7,16,
335,0,22,7,15,
336,0,24,6,18,
337,0,23,7,16,
338,0,24,7,17,
339,0,23,6,17,
340,0,23,7,16,
341,0,21,6,15,
342,0,23,7,16,
343,0,22,6,16,
344,0,23,7,16,
345,0,23,6,17,
346,0,24,7,17,
347,0,22,6,16,
348,0,24,7,17,
349,0,22,6,16,
350,0,21,6,15,
351,0,23,7,16,
352,0,24,7,17,
353,0,24,7,17,
354,0,24,6,18,
355,0,25,7,18,
356,0,22,6,16,
357,0,26,8,18,
358,0,27,8,19,
359,0,23,5,18,
360,0,24,8,16,
361,0,22,6,16,
362,0,23,7,16,
363,0,23,6,17,
364,0,24,6,18,
365,0,24,7,17,
366,0,24,6,18,
367,0,22,6,16,
368,0,25,7,18,
369,0,22,6,16,
370,0,22,7,15,
371,0,25,7,18,
372,0,24,7,17,
373,0,22,6,16,
374,0,24,7,17,
375,0,24,7,17,
376,0,24,6,18,
377,0,22,6,16,
378,0,25,7,18,
379,0,23,6,17,
380,0,24,7,17,
381,0,22,6,16,
382,0,21,6,15,
383,0,23,8,15,
384,0,23,7,16,
385,0,22,6,16,
386,0,21,6,15,
387,0,24,7,17,
388,0,23,6,17,
389,0,23,7,16,
390,0,23,6,17,
391,0,22,6,16,
392,0,24,7,17,
393,0,22,6,16,
394,0,25,7,18,
395,0,24,7,17,
396,0,24,7,17,
397,0,24,7,17,
398,0,23,6,17,
399,0,22,6,16,
400,0,24,7,17,
401,0,22,6,16,
402,0,25,7,18,
403,0,23,7,16,
404,0,23,6,17,
405,0,23,6,17,
406,0,26,7,19,
407,0,23,6,17,
408,0,25,7,18,
409,0,22,6,16,
410,0,25,7,18,
411,0,23,6,17,
412,0,23,7,16,
413,0,23,6,17,
414,0,24,7,17,
415,0,22,6,16,
416,0,21,6,15,
417,0,23,7,16,
418,0,21,6,15,
419,0,22,7,15,
420,0,23,6,17,
421,0,22,6,16,
422,0,24,7,17,
423,0,23,6,17,
424,0,22,6,16,
425,0,24,7,17,
426,0,22,6,16,
427,0,23,7,16,
428,0,24,6,18,
429,0,23,6,17,
430,0,21,6,15,
431,0,23,7,16,
432,0,22,6,16,
433,0,26,7,19,
434,0,25,7,18,
435,0,23,7,16,
436,0,23,7,16,
437,0,22,6,16,
438,0,22,6,16,
439,0,22,6,16,
440,0,26,7,19,
441,0,24,6,18,
442,0,23,6,17,
443,0,26,7,19,
444,0,24,6,18,
445,0,25,7,18,
446,0,23,6,17,
447,0,23,7,16,
448,0,24,7,17,
449,0,22,6,16,
450,0,22,7,15,
451,0,22,6,16,
452,0,22,6,16,
453,0,22,7,15,
454,0,23,6,17,
455,0,22,6,16,
456,0,24,7,17,
457,0,25,7,18,
458,0,23,6,17,
459,0,23,7,16,
460,0,22,6,16,
461,0,24,6,18,
462,0,24,7,17,
463,0,22,6,16,
464,0,25,8,17,
465,0,24,7,17,
466,0,23,6,17,
467,0,24,7,17,
468,0,22,7,15,
469,0,23,7,16,
470,0,22,6,16,
471,0,21,6,15,
472,0,24,7,17,
473,0,22,6,16,
474,0,25,7,18,
475,0,22,6,16,
476,0,23,7,16,
477,0,24,6,18,
478,0,24,7,17,
479,0,23,6,17,
480,0,23,6,17,
481,0,24,6,18,
482,0,25,7,18,
483,0,22,6,16,
484,0,24,7,17,
485,0,23,7,16,
486,0,22,7,15,
487,0,22,6,16,
488,0,22,6,16,
489,0,22,6,16,
490,0,26,7,19,
491,0,24,6,18,
492,0,24,7,17,
493,0,24,7,17,
494,0,24,6,18,
495,0,24,7,17,
496,0,24,6,18,
497,0,25,7,18,
498,0,23,6,17,
499,0,24,7,17,
500,0,22,6,16,
501,0,24,7,17,
502,0,24,7,17,
503,0,22,6,16,
504,0,23,7,16,
505,0,24,7,17,
506,0,24,7,17,
507,0,22,6,16,
508,0,22,6,16,
509,0,23,7,16,
510,0,22,6,16,
511,0,22,7,15,
512,0,22,6,16,
513,0,21,6,15,
514,0,25,7,18,
515,0,24,6,18,
516,0,23,6,17,
517,0,22,6,16,
518,0,24,7,17,
519,0,24,6,18,
520,0,22,7,15,
521,0,22,6,16,
522,0,21,6,15,
523,0,24,7,17,
524,0,23,6,17,
525,0,24,7,17,
526,0,23,6,17,
527,0,23,7,16,
528,0,24,6,18,
529,0,24,7,17,
530,0,23,6,17,
531,0,22,6,16,
532,0,25,7,18,
533,0,21,6,15,
534,0,25,7,18,
535,0,22,6,16,
536,0,24,7,17,
537,0,23,6,17,
538,0,23,7,16,
539,0,22,7,15,
540,0,22,6,16,
541,0,23,6,17,
542,0,24,7,17,
543,0,23,7,16,
544,0,24,6,18,
545,0,24,6,18,
546,0,24,7,17,
547,0,21,6,15,
548,0,24,7,17,
549,0,23,6,17,
550,0,21,6,15,
551,0,24,7,17,
552,0,24,6,18,
553,0,24,6,18,
554,0,22,6,16,
555,0,24,7,17,
556,0,24,6,18,
557,0,24,8,16,
558,0,22,6,16,
559,0,24,7,17,
560,0,22,6,16,
561,0,23,7,16,
562,0,23,6,17,
563,0,22,6,16,
564,0,24,7,17,
565,0,27,9,18,
566,0,24,7,17,
567,0,23,7,16,
568,0,25,7,18,
569,0,23,6,17,
570,0,25,7,18,
571,0,23,6,17,
572,0,24,7,17,
573,0,22,6,16,
574,0,23,8,15,
575,0,22,6,16,
576,0,23,7,16,
577,0,24,7,17,
578,0,25,6,19,
579,0,24,7,17,
580,0,24,6,18,
581,0,24,6,18,
582,0,23,7,16,
583,0,21,6,15,
584,0,26,7,19,
585,0,24,6,18,
586,0,23,7,16,
587,0,22,5,17,
588,0,25,7,18,
589,0,23,6,17,
590,0,22,6,16,
591,0,26,7,19,
592,0,23,6,17,
593,0,25,7,18,
594,0,23,6,17,
595,0,23,7,16,
596,0,24,7,17,
597,0,24,7,17,
598,0,23,6,17,
599,0,23,7,16,
600,0,25,8,17,
601,0,22,6,16,
602,0,24,7,17,
603,0,23,6,17,
604,0,24,6,18,
605,0,23,6,17,
606,0,23,7,16,
607,0,24,7,17,
608,0,24,7,17,
609,0,23,6,17,
610,0,22,6,16,
611,0,24,6,18,
612,0,25,7,18,
613,0,24,6,18,
614,0,23,6,17,
615,0,25,8,17,
616,0,25,7,18,
617,0,22,6,16,
618,0,24,7,17,
619,0,24,6,18,
620,0,22,6,16,
621,0,23,7,16,
622,0,24,6,18,
623,0,24,7,17,
624,0,23,7,16,
625,0,24,7,17,
626,0,22,6,16,
627,0,21,6,15,
628,0,24,7,17,
629,0,22,6,16,
630,0,23,7,16,
631,0,23,6,17,
632,0,22,6,16,
633,0,24,7,17,
634,0,22,6,16,
635,0,21,6,15,
636,0,23,7,16,
637,0,21,6,15,
638,0,25,7,18,
639,0,25,6,19,
640,0,24,7,17,
641,0,24,6,18,
642,0,22,6,16,
643,0,24,7,17,
644,0,21,6,15,
645,0,25,7,18,
646,0,24,6,18,
647,0,23,6,17,
648,0,23,7,16,
649,0,23,6,17,
650,0,22,6,16,
651,0,25,7,18,
652,0,24,6,18,
653,0,23,6,17,
654,0,23,7,16,
655,0,21,6,15,
656,0,24,7,17,
657,0,23,7,16,
658,0,21,6,15,
659,0,25,7,18,
660,0,24,7,17,
661,0,27,8,19,
662,0,23,6,17,
663,0,7,1,6,
664,0,10,3,7,
665,0,24,8,16,
666,0,23,7,16,
667,0,23,7,16,
668,0,24,7,17,
669,0,25,6,19,
670,0,25,7,18,
671,0,24,7,17,
672,0,23,6,17,
673,0,22,6,16,
674,0,26,7,19,
675,0,22,5,17,
676,0,24,7,17,
677,0,22,6,16,
678,0,25,7,18,
679,0,23,6,17,
680,0,23,7,16,
681,0,24,6,18,
682,0,23,6,17,
683,0,24,7,17,
684,0,22,6,16,
685,0,21,6,15,
686,0,24,8,16,
687,0,23,6,17,
688,0,25,7,18,
689,0,23,6,17,
690,0,23,7,16,
691,0,23,6,17,
692,0,23,6,17,
693,0,26,7,19,
694,0,24,6,18,
695,0,22,6,16,
696,0,25,7,18,
697,0,23,6,17,
698,0,22,6,16,
699,0,22,7,15,
700,0,22,6,16,
701,0,21,6,15,
702,0,25,7,18,
703,0,23,6,17,
704,0,22,6,16,
705,0,25,7,18,
706,0,22,6,16,
707,0,24,7,17,
708,0,24,7,17,
709,0,25,7,18,
710,0,23,6,17,
711,0,22,6,16,
712,0,23,7,16,
713,0,23,6,17,
714,0,22,6,16,
715,0,23,7,16,
716,0,24,7,17,
717,0,21,6,15,
718,0,25,7,18,
719,0,25,6,19,
720,0,23,6,17,
721,0,22,6,16,
722,0,24,7,17,
723,0,24,7,17,
724,0,25,7,18,
725,0,25,7,18,
726,0,22,6,16,
727,0,24,6,18,
728,0,27,8,19,
729,0,24,6,18,
730,0,23,6,17,
731,0,23,7,16,
732,0,21,6,15,
733,0,24,7,17,
734,0,24,6,18,
735,0,23,7,16,
736,0,21,6,15,
737,0,25,7,18,
738,0,22,7,15,
739,0,23,7,16,
740,0,25,7,18,
741,0,23,6,17,
742,0,25,7,18,
743,0,25,7,18,
744,0,23,6,17,
745,0,26,7,19,
746,0,25,7,18,
747,0,24,7,17,
748,0,24,7,17,
749,0,23,6,17,
750,0,23,7,16,
751,0,21,6,15,
752,0,24,7,17,
753,0,22,6,16,
754,0,21,6,15,
755,0,24,7,17,
756,0,23,7,16,
757,0,24,7,17,
758,0,23,7,16,
759,0,23,7,16,
760,0,22,6,16,
761,0,24,7,17,
762,0,23,6,17,
763,0,21,6,15,
764,0,23,7,16,
765,0,22,6,16,
766,0,24,7,17,
767,0,24,7,17,
768,0,24,7,17,
769,0,25,7,18,
770,0,24,7,17,
771,0,24,6,18,
772,0,23,6,17,
773,0,23,7,16,
774,0,23,6,17,
775,0,25,7,18,
776,0,25,7,18,
777,0,25,7,18,
778,0,22,6,16,
779,0,23,7,16,
780,0,23,6,17,
781,0,23,6,17,
782,0,24,6,18,
783,0,23,7,16,
784,0,26,7,19,
785,0,25,7,18,
786,0,23,6,17,
787,0,22,6,16,
788,0,25,7,18,
789,0,21,6,15,
790,0,26,7,19,
791,0,23,6,17,
792,0,24,7,17,
793,0,23,6,17,
794,0,22,6,16,
795,0,25,7,18,
796,0,25,6,19,
797,0,23,6,17,
798,0,22,6,16,
799,0,23,7,16,
800,0,25,8,17,
801,0,23,7,16,
802,0,24,6,18,
803,0,11,4,7,
804,0,14,3,11,
805,0,22,6,16,
806,0,23,7,16,
807,0,25,6,19,
808,0,23,6,17,
809,0,23,7,16,
810,0,23,6,17,
811,0,25,6,19,
812,0,24,6,18,
813,0,23,7,16,
814,0,23,6,17,
815,0,25,7,18,
816,0,22,6,16,
817,0,24,7,17,
818,0,25,8,17,
819,0,23,7,16,
820,0,21,6,15,
821,0,25,7,18,
822,0,23,6,17,
823,0,23,7,16,
824,0,23,6,17,
825,0,23,7,16,
826,0,24,7,17,
827,0,22,6,16,
828,0,25,6,19,
829,0,24,7,17,
830,0,23,7,16,
831,0,22,6,16,
832,0,23,6,17,
833,0,22,7,15,
834,0,23,6,17,
835,0,22,6,16,
836,0,24,7,17,
837,0,26,8,18,
838,0,26,8,18,
839,0,22,6,16,
840,0,23,7,16,
841,0,22,7,15,
842,0,24,7,17,
843,0,24,7,17,
844,0,22,6,16,
845,0,27,8,19,
846,0,23,6,17,
847,0,24,7,17,
848,0,25,7,18,
849,0,26,8,18,
850,0,24,7,17,
851,0,23,6,17,
852,0,21,6,15,
853,0,22,7,15,
854,0,23,6,17,
855,0,24,6,18,
856,0,23,6,17,
857,0,23,7,16,
858,0,23,6,17,
859,0,22,6,16,
860,0,23,7,16,
861,0,25,7,18,
862,0,24,6,18,
863,0,23,6,17,
864,0,23,7,16,
865,0,22,6,16,
866,0,22,7,15,
867,0,22,6,16,
868,0,22,7,15,
869,0,25,7,18,
870,0,24,6,18,
871,0,23,6,17,
872,0,22,6,16,
873,0,24,7,17,
874,0,22,6,16,
875,0,25,7,18,
876,0,24,8,16,
877,0,24,6,18,
878,0,23,6,17,
879,0,24,8,16,
880,0,24,7,17,
881,0,22,6,16,
882,0,21,6,15,
883,0,23,7,16,
884,0,21,6,15,
885,0,23,7,16,
886,0,23,6,17,
887,0,25,9,16,
888,0,28,12,16,
889,0,26,7,19,
890,0,24,9,15,
891,0,27,10,17,
892,0,28,11,17,
893,0,23,7,16,
894,0,25,7,18,
895,0,24,7,17,
896,0,28,10,18,
897,0,26,9,17,
898,0,24,8,16,
899,0,26,7,19,
900,0,26,7,19,
901,0,28,11,17,
902,0,26,8,18,
903,0,28,12,16,
904,0,24,8,16,
905,0,28,9,19,
906,0,31,12,19,
907,0,30,12,18,
908,0,29,12,17,
909,0,26,10,16,
910,0,24,9,15,
911,0,25,9,15,1
912,0,23,7,16,
913,0,23,7,16,
914,0,22,6,16,
915,0,27,7,20,
916,0,24,6,18,
917,0,24,7,17,
918,0,24,6,17,1
919,0,22,6,16,
920,0,24,7,17,
921,0,25,8,17,
922,0,23,7,16,
923,0,23,6,17,
924,0,22,6,16,
925,0,24,6,18,
926,0,25,8,16,1
927,0,23,6,17,
928,0,23,7,16,
929,0,24,7,17,
930,0,25,7,18,
931,0,24,6,18,
932,0,23,6,17,
933,0,23,7,16,
934,0,21,6,15,
935,0,24,7,17,
936,0,22,7,15,
937,0,26,7,19,
938,0,25,7,18,
939,0,23,6,17,
940,0,25,7,18,
941,0,24,6,17,1
942,0,22,6,16,
943,0,23,6,17,
944,0,25,7,18,
945,0,22,6,16,
946,0,25,7,18,
947,0,23,6,17,
948,0,24,6,18,
949,0,23,6,17,
950,0,24,7,17,
951,0,22,6,16,
952,0,23,7,16,
953,0,22,7,15,
954,0,23,7,16,
955,0,24,7,17,
956,0,24,6,17,1
957,0,27,8,19,
958,0,23,6,17,
959,0,24,7,17,
960,0,25,7,18,
961,0,23,6,17,
962,0,24,7,17,
963,0,22,6,16,
964,0,22,7,15,
965,0,25,7,18,
966,0,24,6,18,
967,0,24,7,17,
968,0,22,7,15,
969,0,24,7,17,
970,0,25,8,17,
971,0,22,6,16,
972,0,26,7,19,
973,0,24,6,18,
974,0,24,7,17,
975,0,22,6,16,
976,0,21,6,15,
977,0,23,7,16,
978,0,21,6,15,
979,0,22,7,15,
980,0,23,6,17,
981,0,22,6,16,
982,0,25,8,17,
983,0,23,7,16,
984,0,23,6,17,
985,0,23,7,16,
986,0,23,6,16,1
987,0,23,6,17,
988,0,25,7,18,
989,0,23,6,17,
990,0,22,6,16,
991,0,24,7,17,
992,0,22,6,16,
993,0,23,7,16,
994,0,24,6,18,
995,0,24,7,17,
996,0,24,7,17,
997,0,24,8,16,
998,0,24,7,17,
999,0,22,6,16,
1000,0,21,6,15,
1001,0,24,7,17,
1002,0,23,6,17,
1003,0,23,7,16,
1004,0,23,6,17,
1005,0,22,6,16,
1006,0,24,7,17,
1007,0,22,6,16,
1008,0,24,7,17,
1009,0,25,7,18,
1010,0,22,6,16,
1011,0,25,8,17,
1012,0,24,7,17,
1013,0,23,7,16,
1014,0,24,6,18,
1015,0,24,7,17,
1016,0,25,7,18,
1017,0,26,7,18,1
1018,0,23,6,17,
1019,0,25,9,16,
1020,0,24,7,17,
1021,0,24,6,18,
1022,0,24,6,18,
1023,0,24,7,17,
1024,0,22,6,16,
1025,0,21,6,15,
1026,0,24,7,17,
1027,0,24,7,17,
1028,0,23,6,17,
1029,0,26,8,18,
1030,0,24,6,18,
1031,0,25,7,18,
1032,0,22,6,16,
1033,0,25,7,18,
1034,0,23,6,17,
1035,0,23,6,17,
1036,0,23,6,17,
1037,0,24,7,17,
1038,0,23,6,17,
1039,0,23,7,16,
1040,0,24,6,18,
1041,0,23,6,17,
1042,0,23,7,16,
1043,0,22,7,15,
1044,0,22,6,16,
1045,0,21,6,15,
1046,0,24,7,17,
1047,0,23,6,16,1
1048,0,25,7,18,
1049,0,23,6,17,
1050,0,22,6,16,
1051,0,26,8,18,
1052,0,25,7,18,
1053,0,24,6,18,
1054,0,22,6,16,
1055,0,23,7,16,
1056,0,23,6,17,
1057,0,24,7,17,
1058,0,22,6,16,
1059,0,24,7,17,
1060,0,23,7,16,
1061,0,24,8,16,
1062,0,24,7,17,
1063,0,21,6,15,
1064,0,23,7,16,
1065,0,22,6,16,
1066,0,23,7,16,
1067,0,22,5,17,
1068,0,25,7,18,
1069,0,23,6,17,
1070,0,23,7,16,
1071,0,23,6,17,
1072,0,22,6,16,
1073,0,24,7,17,
1074,0,25,6,19,
1075,0,25,7,18,
1076,0,23,6,17,
1077,0,26,8,17,1
1078,0,23,6,17,
1079,0,24,6,18,
1080,0,24,7,17,
1081,0,24,6,18,
1082,0,22,6,16,
1083,0,24,7,17,
1084,0,23,6,17,
1085,0,23,7,16,
1086,0,21,6,15,
1087,0,23,7,16,
1088,0,23,7,16,
1089,0,25,7,18,
1090,0,23,6,17,
1091,0,24,7,17,
1092,0,25,7,18,
1093,0,23,6,17,
1094,0,23,7,16,
1095,0,24,6,18,
1096,0,24,7,17,
1097,0,22,6,16,
1098,0,21,6,15,
1099,0,23,7,16,
1100,0,22,6,16,
1101,0,23,7,16,
1102,0,24,7,17,
1103,0,22,7,15,
1104,0,23,6,17,
1105,0,23,7,16,
1106,0,24,7,17,
1107,0,22,6,16,
1108,0,27,8,18,1
1109,0,23,6,17,
1110,0,25,6,19,
1111,0,23,6,17,
1112,0,23,7,16,
1113,0,22,6,16,
1114,0,23,7,16,
1115,0,22,7,15,
1116,0,22,6,16,
1117,0,25,7,18,
1118,0,23,6,17,
1119,0,23,7,16,
1120,0,23,6,17,
1121,0,23,7,16,
1122,0,25,7,18,
1123,0,23,6,17,
1124,0,24,7,17,
1125,0,21,5,16,
1126,0,23,7,16,
1127,0,22,6,16,
1128,0,24,7,17,
1129,0,24,7,17,
1130,0,23,7,16,
1131,0,24,7,17,
1132,0,24,6,18,
1133,0,26,7,19,
1134,0,23,6,17,
1135,0,22,6,16,
1136,0,24,6,18,
1137,0,23,7,16,
1138,0,23,7,15,1
1139,0,22,6,16,
1140,0,25,7,18,
1141,0,23,6,17,
1142,0,22,6,16,
1143,0,24,7,17,
1144,0,22,6,16,
1145,0,25,7,18,
1146,0,23,6,17,
1147,0,23,7,16,
1148,0,23,7,16,
1149,0,24,7,17,
1150,0,23,6,17,
1151,0,25,7,18,
1152,0,24,6,18,
1153,0,23,6,17,
1154,0,23,7,16,
1155,0,22,6,16,
1156,0,22,7,15,
1157,0,22,6,16,
1158,0,23,6,17,
1159,0,26,7,19,
1160,0,24,6,18,
1161,0,23,7,16,
1162,0,24,7,17,
1163,0,22,7,15,
1164,0,21,6,15,
1165,0,24,7,17,
1166,0,23,7,16,
1167,0,25,7,18,
1168,0,23,6,17,
1169,0,25,7,17,1
1170,0,22,6,16,
1171,0,25,7,18,
1172,0,23,6,17,
1173,0,25,7,18,
1174,0,24,6,18,
1175,0,24,7,17,
1176,0,21,5,16,
1177,0,24,7,17,
1178,0,22,7,15,
1179,0,25,6,19,
1180,0,25,7,18,
1181,0,23,6,17,
1182,0,23,7,16,
1183,0,23,7,16,
1184,0,22,6,16,
1185,0,22,6,16,
1186,0,22,6,16,
1187,0,24,7,17,
1188,0,23,6,17,
1189,0,23,7,16,
1190,0,23,6,17,
1191,0,22,6,16,
1192,0,24,7,17,
1193,0,23,6,17,
1194,0,22,6,16,
1195,0,24,6,18,
1196,0,23,7,16,
1197,0,22,6,16,
1198,0,22,7,15,
1199,0,24,7,16,1
1200,0,22,7,15,
1201,0,24,8,16,
1202,0,26,8,18,
1203,0,24,6,18,
1204,0,24,7,17,
1205,0,24,7,17,
1206,0,23,6,17,
1207,0,21,6,15,
1208,0,23,7,16,
1209,0,25,7,18,
1210,0,24,6,18,
1211,0,23,7,16,
1212,0,24,7,17,
1213,0,24,7,17,
1214,0,23,7,16,
1215,0,24,6,18,
1216,0,23,6,17,
1217,0,23,7,16,
1218,0,22,6,16,
1219,0,21,6,15,
1220,0,23,7,16,
1221,0,21,6,15,
1222,0,23,7,16,
1223,0,23,6,17,
1224,0,24,8,16,
1225,0,24,7,17,
1226,0,22,6,16,
1227,0,24,7,17,
1228,0,22,6,16,
1229,0,24,7,16,1
1230,0,24,7,17,
1231,0,23,6,17,
1232,0,24,7,17,
1233,0,22,6,16,
1234,0,22,7,15,
1235,0,23,7,16,
1236,0,22,6,16,
1237,0,27,7,20,
1238,0,24,7,17,
1239,0,24,7,17,
1240,0,25,7,18,
1241,0,24,6,18,
1242,0,24,7,17,
1243,0,24,7,17,
1244,0,22,6,16,
1245,0,22,6,16,
1246,0,23,7,16,
1247,0,22,6,16,
1248,0,23,6,17,
1249,0,24,6,18,
1250,0,25,7,18,
1251,0,24,6,18,
1252,0,24,7,17,
1253,0,24,6,18,
1254,0,23,6,17,
1255,0,23,7,16,
1256,0,23,6,17,
1257,0,22,6,16,
1258,0,23,7,16,
1259,0,24,7,17,
1260,0,25,7,17,1
1261,0,23,6,17,
1262,0,24,7,17,
1263,0,22,6,16,
1264,0,26,8,18,
1265,0,24,6,18,
1266,0,24,7,17,
1267,0,26,8,18,
1268,0,24,6,18,
1269,0,22,6,16,
1270,0,24,7,17,
1271,0,22,6,16,
1272,0,24,7,17,
1273,0,23,7,16,
1274,0,25,7,18,
1275,0,24,6,18,
1276,0,23,6,17,
1277,0,21,6,15,
1278,0,25,7,18,
1279,0,24,6,18,
1280,0,22,6,16,
1281,0,24,7,17,
1282,0,23,7,16,
1283,0,26,8,18,
1284,0,22,6,16,
1285,0,23,8,15,
1286,0,23,6,17,
1287,0,23,6,17,
1288,0,26,7,19,
1289,0,23,6,17,
1290,0,25,8,16,1
1291,0,23,7,16,
1292,0,27,9,18,
1293,0,23,6,17,
1294,0,24,7,17,
1295,0,23,7,16,
1296,0,22,6,16,
1297,0,23,6,17,
1298,0,22,7,15,
1299,0,23,6,17,
1300,0,24,7,17,
1301,0,22,6,16,
1302,0,23,7,16,
1303,0,25,7,18,
1304,0,24,6,18,
1305,0,23,6,17,
1306,0,24,7,17,
1307,0,22,6,16,
1308,0,22,7,15,
1309,0,22,6,16,
1310,0,21,6,15,
1311,0,24,7,17,
1312,0,23,6,17,
1313,0,23,7,16,
1314,0,23,6,17,
1315,0,25,7,18,
1316,0,23,6,17,
1317,0,23,7,16,
1318,0,23,6,17,
1319,0,24,6,18,
1320,0,25,7,17,1
1321,0,26,7,19,
1322,0,23,6,17,
1323,0,22,6,16,
1324,0,24,7,17,
1325,0,23,7,16,
1326,0,24,6,18,
1327,0,23,6,17,
1328,0,21,6,15,
1329,0,23,7,16,
1330,0,25,7,18,
1331,0,23,6,17,
1332,0,26,7,19,
1333,0,25,7,18,
1334,0,25,7,18,
1335,0,23,6,17,
1336,0,25,7,18,
1337,0,24,6,18,
1338,0,23,7,16,
1339,0,23,6,17,
1340,0,23,6,17,
1341,0,24,7,17,
1342,0,22,6,16,
1343,0,23,7,16,
1344,0,22,6,16,
1345,0,25,7,18,
1346,0,23,6,17,
1347,0,25,7,18,
1348,0,24,6,18,
1349,0,23,6,17,
1350,0,24,7,17,
1351,0,25,7,17,1
1352,0,22,6,16,
1353,0,21,6,15,
1354,0,23,7,16,
1355,0,21,6,15,
1356,0,24,7,17,
1357,0,23,6,17,
1358,0,22,6,16,
1359,0,25,7,18,
1360,0,26,8,18,
1361,0,24,6,18,
1362,0,23,6,17,
1363,0,23,7,16,
1364,0,22,7,15,
1365,0,23,7,16,
1366,0,24,7,17,
1367,0,24,6,18,
1368,0,22,6,16,
1369,0,25,7,18,
1370,0,23,6,17,
1371,0,23,7,16,
1372,0,24,6,18,
1373,0,23,6,17,
1374,0,23,7,16,
1375,0,22,6,16,
1376,0,23,8,15,
1377,0,23,7,16,
1378,0,22,6,16,
1379,0,23,6,17,
1380,0,24,7,17,
1381,0,24,7,16,1
1382,0,23,6,17,
1383,0,26,8,18,
1384,0,23,6,17,
1385,0,23,7,16,
1386,0,24,7,17,
1387,0,24,6,18,
1388,0,23,7,16,
1389,0,21,6,15,
1390,0,23,7,16,
1391,0,23,7,16,
1392,0,24,7,17,
1393,0,24,7,17,
1394,0,25,7,18,
1395,0,24,7,17,
1396,0,23,6,17,
1397,0,23,7,16,
1398,0,24,7,17,
1399,0,22,6,16,
1400,0,25,7,18,
1401,0,23,6,17,
1402,0,22,6,16,
1403,0,25,7,18,
1404,0,23,6,17,
1405,0,25,7,18,
1406,0,23,7,16,
1407,0,23,6,17,
1408,0,22,6,16,
1409,0,25,7,18,
1410,0,22,6,16,
1411,0,25,7,17,1
1412,0,22,6,16,
1413,0,25,7,18,
1414,0,23,6,17,
1415,0,26,7,19,
1416,0,24,6,18,
1417,0,22,6,16,
1418,0,25,7,18,
1419,0,23,6,17,
1420,0,24,6,18,
1421,0,23,7,16,
1422,0,24,6,18,
1423,0,25,7,18,
1424,0,22,6,16,
1425,0,25,7,18,
1426,0,23,6,17,
1427,0,23,6,17,
1428,0,24,7,17,
1429,0,23,6,17,
1430,0,23,7,16,
1431,0,24,6,18,
1432,0,24,7,17,
1433,0,22,6,16,
1434,0,22,6,16,
1435,0,22,7,15,
1436,0,22,7,15,
1437,0,24,7,17,
1438,0,23,6,17,
1439,0,25,9,16,
1440,0,25,7,18,
1441,0,23,6,17,
1442,0,26,8,17,1
1443,0,24,6,18,
1444,0,26,8,18,
1445,0,25,8,17,
1446,0,24,6,18,
1447,0,24,7,17,
1448,0,24,7,17,
1449,0,23,6,17,
1450,0,26,9,17,
1451,0,31,14,17,
1452,0,29,13,16,
1453,0,30,12,18,
1454,0,30,12,18,
1455,0,31,13,18,
1456,0,29,11,18,
1457,0,30,13,17,
1458,0,28,12,16,
1459,0,29,12,17,
1460,0,29,12,17,
1461,0,30,12,18,
1462,0,28,11,17,
1463,0,31,13,18,
1464,0,27,11,16,
1465,0,30,13,17,
1466,0,29,13,16,
1467,0,29,13,16,
1468,0,28,12,16,
1469,0,28,12,16,
1470,0,30,13,17,
1471,0,30,13,17,
1472,0,31,12,18,1
1473,0,30,12,18,
1474,0,31,13,18,
1475,0,30,12,18,
1476,0,30,13,17,
1477,0,31,12,19,
1478,0,31,13,18,
1479,0,28,12,16,
1480,0,28,13,15,
1481,0,28,12,16,
1482,0,28,12,16,
1483,0,29,13,16,
1484,0,28,12,16,
1485,0,27,12,15,
1486,0,29,13,16,
1487,0,29,13,16,
1488,0,31,13,18,
1489,0,29,13,16,
1490,0,29,12,17,
1491,0,30,13,17,
1492,0,30,13,17,
1493,0,28,12,16,
1494,0,27,11,16,
1495,0,30,13,17,
1496,0,27,11,16,
1497,0,32,13,19,
1498,0,27,11,16,
1499,0,29,13,16,
1500,0,29,12,17,
1501,0,30,13,17,
1502,0,31,13,17,1
1503,0,27,11,16,
1504,0,30,13,17,
1505,0,29,13,16,
1506,0,29,13,16,
1507,0,29,13,16,
1508,0,31,13,18,
1509,0,29,12,17,
1510,0,31,13,18,
1511,0,30,11,19,
1512,0,29,13,16,
1513,0,27,11,16,
1514,0,30,13,17,
1515,0,30,13,17,
1516,0,29,12,17,
1517,0,29,12,17,
1518,0,30,12,18,
1519,0,30,12,18,
1520,0,30,13,17,
1521,0,29,11,18,
1522,0,31,13,18,
1523,0,29,12,17,
1524,0,29,12,17,
1525,0,29,12,17,
1526,0,30,13,17,
1527,0,28,12,16,
1528,0,29,12,17,
1529,0,27,11,16,
1530,0,30,13,17,
1531,0,29,12,17,
1532,0,29,13,16,
1533,0,29,11,17,1
1534,0,30,13,17,
1535,0,27,11,16,
1536,0,27,12,15,
1537,0,28,13,15,
1538,0,30,13,17,
1539,0,27,12,15,
1540,0,28,12,16,
1541,0,27,11,16,
1542,0,29,13,16,
1543,0,29,13,16,
1544,0,27,12,15,
1545,0,31,13,18,
1546,0,30,13,17,
1547,0,26,9,17,
1548,0,22,6,16,
1549,0,24,7,17,
1550,0,24,6,18,
1551,0,23,6,17,
1552,0,24,7,17,
1553,0,23,6,17,
1554,0,22,6,16,
1555,0,22,7,15,
1556,0,23,6,17,
1557,0,23,7,16,
1558,0,24,7,17,
1559,0,23,6,17,
1560,0,23,7,16,
1561,0,24,7,17,
1562,0,22,6,16,
1563,0,24,7,16,1
1564,0,24,6,18,
1565,0,25,8,17,
1566,0,22,6,16,
1567,0,26,8,18,
1568,0,24,6,18,
1569,0,22,6,16,
1570,0,25,8,17,
1571,0,26,6,20,
1572,0,24,6,18,
1573,0,23,6,17,
1574,0,24,8,16,
1575,0,22,7,15,
1576,0,24,8,16,
1577,0,21,6,15,
1578,0,26,7,19,
1579,0,24,6,18,
1580,0,25,7,18,
1581,0,24,6,18,
1582,0,23,6,17,
1583,0,23,7,16,
1584,0,21,6,15,
1585,0,24,7,17,
1586,0,22,6,16,
1587,0,25,7,18,
1588,0,24,7,17,
1589,0,23,6,17,
1590,0,24,7,17,
1591,0,24,6,18,
1592,0,24,7,17,
1593,0,23,6,16,1
1594,0,24,8,16,
1595,0,25,7,18,
1596,0,23,6,17,
1597,0,23,7,16,
1598,0,24,6,18,
1599,0,23,6,17,
1600,0,24,7,17,
1601,0,22,6,16,
1602,0,22,7,15,
1603,0,22,6,16,
1604,0,21,6,15,
1605,0,24,7,17,
1606,0,23,6,17,
1607,0,24,7,17,
1608,0,22,6,16,
1609,0,24,8,16,
1610,0,24,7,17,
1611,0,23,6,17,
1612,0,23,7,16,
1613,0,24,6,18,
1614,0,23,6,17,
1615,0,24,7,17,
1616,0,22,6,16,
1617,0,22,7,15,
1618,0,24,7,17,
1619,0,24,6,18,
1620,0,22,6,16,
1621,0,24,7,17,
1622,0,23,6,17,
1623,0,23,7,16,
1624,0,25,7,17,1
1625,0,25,7,18,
1626,0,23,6,17,
1627,0,24,7,17,
1628,0,22,6,16,
1629,0,22,7,15,
1630,0,22,6,16,
1631,0,22,6,16,
1632,0,22,7,15,
1633,0,23,7,16,
1634,0,23,6,17,
1635,0,22,6,16,
1636,0,22,6,16,
1637,0,23,7,16,
1638,0,23,7,16,
1639,0,23,6,17,
1640,0,21,6,15,
1641,0,24,7,17,
1642,0,23,6,17,
1643,0,24,6,18,
1644,0,22,6,16,
1645,0,24,7,17,
1646,0,22,6,16,
1647,0,24,7,17,
1648,0,24,7,17,
1649,0,22,6,16,
1650,0,24,7,17,
1651,0,23,6,17,
1652,0,23,7,16,
1653,0,24,6,18,
1654,0,26,7,18,1
1655,0,23,6,17,
1656,0,26,8,18,
1657,0,22,6,16,
1658,0,25,7,18,
1659,0,23,6,17,
1660,0,23,7,16,
1661,0,23,6,17,
1662,0,22,6,16,
1663,0,25,7,18,
1664,0,24,6,18,
1665,0,26,8,18,
1666,0,23,6,17,
1667,0,23,7,16,
1668,0,23,7,16,
1669,0,23,6,17,
1670,0,23,7,16,
1671,0,23,6,17,
1672,0,22,6,16,
1673,0,26,7,19,
1674,0,24,6,18,
1675,0,22,6,16,
1676,0,24,7,17,
1677,0,24,6,18,
1678,0,24,7,17,
1679,0,24,6,18,
1680,0,24,7,17,
1681,0,22,6,16,
1682,0,22,6,16,
1683,0,22,7,15,
1684,0,23,6,16,1
1685,0,21,6,15,
1686,0,22,7,15,
1687,0,24,7,17,
1688,0,23,7,16,
1689,0,22,6,16,
1690,0,23,6,17,
1691,0,23,6,17,
1692,0,23,7,16,
1693,0,24,7,17,
1694,0,25,7,18,
1695,0,23,6,17,
1696,0,24,7,17,
1697,0,25,7,18,
1698,0,24,7,17,
1699,0,22,6,16,
1700,0,23,6,17,
1701,0,26,7,19,
1702,0,24,6,18,
1703,0,24,7,17,
1704,0,22,6,16,
1705,0,21,6,15,
1706,0,23,7,16,
1707,0,22,6,16,
1708,0,21,6,15,
1709,0,22,7,15,
1710,0,24,7,17,
1711,0,23,6,17,
1712,0,24,6,18,
1713,0,23,7,16,
1714,0,23,6,17,
1715,0,26,7,18,1
1716,0,23,6,17,
1717,0,23,7,16,
1718,0,23,6,17,
1719,0,21,6,15,
1720,0,26,7,19,
1721,0,23,6,17,
1722,0,24,7,17,
1723,0,23,6,17,
1724,0,22,6,16,
1725,0,25,7,18,
1726,0,24,6,18,
1727,0,24,7,17,
1728,0,24,6,18,
1729,0,22,6,16,
1730,0,25,7,18,
1731,0,23,6,17,
1732,0,23,6,17,
1733,0,21,6,15,
1734,0,23,7,16,
1735,0,21,6,15,
1736,0,23,7,16,
1737,0,23,6,17,
1738,0,23,7,16,
1739,0,23,6,17,
1740,0,22,6,16,
1741,0,25,7,18,
1742,0,23,6,17,
1743,0,22,6,16,
1744,0,25,7,18,
1745,0,25,7,17,1
1746,0,25,8,17,
1747,0,24,7,17,
1748,0,23,6,17,
1749,0,23,7,16,
1750,0,22,6,16,
1751,0,23,7,16,
1752,0,24,6,18,
1753,0,23,6,17,
1754,0,25,8,17,
1755,0,22,6,16,
1756,0,22,6,16,
1757,0,24,7,17,
1758,0,26,7,19,
1759,0,23,6,17,
1760,0,25,6,19,
1761,0,23,6,17,
1762,0,24,7,17,
1763,0,22,6,16,
1764,0,21,6,15,
1765,0,23,7,16,
1766,0,21,6,15,
1767,0,23,7,16,
1768,0,23,6,17,
1769,0,24,7,17,
1770,0,23,7,16,
1771,0,23,6,17,
1772,0,23,7,16,
1773,0,25,7,18,
1774,0,23,6,17,
1775,0,25,7,17,1
1776,0,24,7,17,
1777,0,22,6,16,
1778,0,23,7,16,
1779,0,22,6,16,
1780,0,22,7,15,
1781,0,22,6,16,
1782,0,21,6,15,
1783,0,24,7,17,
1784,0,23,6,17,
1785,0,24,8,16,
1786,0,23,6,17,
1787,0,25,6,19,
1788,0,23,6,17,
1789,0,23,7,16,
1790,0,24,6,18,
1791,0,23,6,17,
1792,0,23,7,16,
1793,0,22,6,16,
1794,0,22,7,15,
1795,0,22,6,16,
1796,0,22,6,16,
1797,0,22,7,15,
1798,0,23,6,17,
1799,0,22,6,16,
1800,0,24,7,17,
1801,0,22,6,16,
1802,0,23,7,16,
1803,0,23,6,17,
1804,0,22,6,16,
1805,0,26,7,19,
1806,0,25,7,17,1
1807,0,24,6,18,
1808,0,23,6,17,
1809,0,23,7,16,
1810,0,23,7,16,
1811,0,22,7,15,
1812,0,23,6,17,
1813,0,23,6,17,
1814,0,24,6,18,
1815,0,23,7,16,
1816,0,22,6,16,
1817,0,25,7,18,
1818,0,23,6,17,
1819,0,26,9,17,
1820,0,26,9,17,
1821,0,23,7,16,
1822,0,23,7,16,
1823,0,29,12,17,
1824,0,31,13,18,
1825,0,28,12,16,
1826,0,27,11,16,
1827,0,27,11,16,
1828,0,29,13,16,
1829,0,28,12,16,
1830,0,29,13,16,
1831,0,27,12,15,
1832,0,27,12,15,
1833,0,29,13,16,
1834,0,29,13,16,
1835,0,28,12,16,
1836,0,28,11,17,
1837,0,31,13,18,
1838,0,28,11,17,
1839,0,29,12,17,
1840,0,29,12,17,
1841,0,30,13,17,
1842,0,28,11,17,
1843,0,31,13,18,
1844,0,30,13,17,
1845,0,30,13,17,
1846,0,28,11,17,
1847,0,30,12,18,
1848,0,30,13,17,
1849,0,27,11,16,
1850,0,30,13,17,
1851,0,28,12,16,
1852,0,30,13,17,
1853,0,31,13,18,
1854,0,30,13,17,
1855,0,30,13,17,
1856,0,28,11,17,
1857,0,30,13,17,
1858,0,28,12,16,
1859,0,29,13,16,
1860,0,30,13,17,
1861,0,29,12,17,
1862,0,29,13,16,
1863,0,29,13,16,
1864,0,28,11,17,
1865,0,30,13,17,
1866,0,29,12,17,
1867,0,28,12,16,
1868,0,31,13,18,
1869,0,26,8,18,
1870,0,22,6,16,
1871,0,25,7,18,
1872,0,23,6,17,
1873,0,26,8,18,
1874,0,22,6,16,
1875,0,25,7,18,
1876,0,24,7,17,
1877,0,22,6,16,
1878,0,21,6,15,
1879,0,24,8,16,
1880,0,22,6,16,
1881,0,22,6,16,
1882,0,25,7,18,
1883,0,23,6,17,
1884,0,23,6,17,
1885,0,26,7,19,
1886,0,22,6,16,
1887,0,26,7,19,
1888,0,24,6,18,
1889,0,24,7,17,
1890,0,22,6,16,
1891,0,25,7,18,
1892,0,22,6,16,
1893,0,22,6,16,
1894,0,22,7,15,
1895,0,24,7,17,
1896,0,22,6,16,
1897,0,24,7,17,
1898,0,25,7,18,
1899,0,22,6,16,
1900,0,24,7,17,
1901,0,22,6,16,
1902,0,25,7,18,
1903,0,25,6,19,
1904,0,25,7,18,
1905,0,25,7,18,
1906,0,23,6,17,
1907,0,25,7,18,
1908,0,22,6,16,
1909,0,23,7,16,
1910,0,24,7,17,
1911,0,23,6,17,
1912,0,23,6,17,
1913,0,25,7,18,
1914,0,23,6,17,
1915,0,25,7,18,
1916,0,23,6,17,
1917,0,24,7,17,
1918,0,22,6,16,
1919,0,22,7,15,
1920,0,22,6,16,
1921,0,23,8,15,
1922,0,24,7,17,
1923,0,23,6,17,
1924,0,23,7,16,
1925,0,24,7,17,
1926,0,22,6,16,
1927,0,24,7,17,
1928,0,27,8,19,
1929,0,23,6,17,
1930,0,23,7,16,
1931,0,25,7,18,
1932,0,25,6,19,
1933,0,24,7,17,
1934,0,22,7,15,
1935,0,24,7,17,
1936,0,22,7,15,
1937,0,23,6,17,
1938,0,24,7,17,
1939,0,22,6,16,
1940,0,23,6,17,
1941,0,24,7,17,
1942,0,22,6,16,
1943,0,23,7,16,
1944,0,23,6,17,
1945,0,25,7,18,
1946,0,22,6,16,
1947,0,25,7,18,
1948,0,24,6,18,
1949,0,24,7,17,
1950,0,22,6,16,
1951,0,23,7,16,
1952,0,21,6,15,
1953,0,25,7,18,
1954,0,23,6,17,
1955,0,23,7,16,
1956,0,23,6,17,
1957,0,23,6,17,
1958,0,24,6,18,
1959,0,25,7,18,
1960,0,26,8,18,
1961,0,25,7,18,
1962,0,23,6,17,
1963,0,22,6,16,
1964,0,23,7,16,
1965,0,22,6,16,
1966,0,21,6,15,
1967,0,25,7,18,
1968,0,23,6,17,
1969,0,23,7,16,
1970,0,23,7,16,
1971,0,24,7,17,
1972,0,22,6,16,
1973,0,26,7,19,
1974,0,24,6,18,
1975,0,23,7,16,
1976,0,21,6,15,
1977,0,24,7,17,
1978,0,22,6,16,
1979,0,22,7,15,
1980,0,23,6,17,
1981,0,24,7,17,
1982,0,23,6,17,
1983,0,23,7,16,
1984,0,24,7,17,
1985,0,24,6,18,
1986,0,22,6,16,
1987,0,26,7,19,
1988,0,24,6,18,
1989,0,24,7,17,
1990,0,23,7,16,
1991,0,24,7,17,
1992,0,22,6,16,
1993,0,22,7,15,
1994,0,22,6,16,
1995,0,21,6,15,
1996,0,23,7,16,
1997,0,25,7,18,
1998,0,24,6,18,
1999,0,22,6,16,
2000,0,25,8,17,
2001,0,24,6,18,
2002,0,22,6,16,
2003,0,25,7,18,
2004,0,23,6,17,
2005,0,23,6,17,
2006,0,23,7,16,
2007,0,21,6,15,
2008,0,25,7,18,
2009,0,25,7,18,
2010,0,22,6,16,
2011,0,24,7,17,
2012,0,24,7,17,
2013,0,23,7,16,
2014,0,23,6,17,
2015,0,22,6,16,
2016,0,26,7,19,
2017,0,24,6,18,
2018,0,24,7,17,
2019,0,25,9,16,
2020,0,21,6,15,
2021,0,23,7,16,
2022,0,22,6,16,
2023,0,22,7,15,
2024,0,23,6,17,
2025,0,23,6,17,
2026,0,23,7,16,
2027,0,23,6,17,
2028,0,23,7,16,
2029,0,23,7,16,
2030,0,25,7,18,
2031,0,26,8,18,
2032,0,24,6,18,
2033,0,23,6,17,
2034,0,23,7,16,
2035,0,21,6,15,
2036,0,22,7,15,
2037,0,25,7,18,
2038,0,22,6,16,
2039,0,23,6,17,
2040,0,22,6,16,
2041,0,25,7,18,
2042,0,23,6,17,
2043,0,23,7,16,
2044,0,23,6,17,
2045,0,22,6,16,
2046,0,25,7,18,
2047,0,23,6,17,
2048,0,24,7,17,
2049,0,23,7,16,
2050,0,21,6,15,
2051,0,23,7,16,
2052,0,23,6,17,
2053,0,22,7,15,
2054,0,23,6,17,
2055,0,23,6,17,
2056,0,23,7,16,
2057,0,24,7,17,
2058,0,22,6,16,
2059,0,24,7,17,
2060,0,23,7,16,
2061,0,24,7,17,
2062,0,22,6,16,
2063,0,21,6,15,
2064,0,23,7,16,
2065,0,22,6,16,
2066,0,22,7,15,
2067,0,24,7,17,
2068,0,24,7,17,
2069,0,22,6,16,
2070,0,25,7,18,
2071,0,25,6,19,
2072,0,23,7,16,
2073,0,25,7,18,
2074,0,24,6,18,
2075,0,23,6,17,
2076,0,22,7,15,
2077,0,22,6,16,
2078,0,21,6,15,
2079,0,24,7,17,
2080,0,24,7,17,
2081,0,23,6,17,
2082,0,23,6,17,
2083,0,23,6,17,
2084,0,25,7,18,
2085,0,23,6,17,
2086,0,23,7,16,
2087,0,24,6,18,
2088,0,25,7,18,
2089,0,23,6,17,
2090,0,23,6,17,
2091,0,24,8,16,
2092,0,21,6,15,
2093,0,23,7,16,
2094,0,22,6,16,
2095,0,22,7,15,
2096,0,23,6,17,
2097,0,22,6,16,
2098,0,24,7,17,
2099,0,23,6,17,
2100,0,22,6,16,
2101,0,24,7,17,
2102,0,22,6,16,
2103,0,25,7,18,
2104,0,24,6,18,
2105,0,24,7,17,
2106,0,22,6,16,
2107,0,21,6,15,
2108,0,24,7,17,
2109,0,22,6,16,
2110,0,23,8,15,
2111,0,24,7,17,
2112,0,23,7,16,
2113,0,25,7,18,
2114,0,22,6,16,
2115,0,23,6,17,
2116,0,22,6,16,
2117,0,26,7,19,
2118,0,24,7,17,
2119,0,24,6,18,
2120,0,25,7,18,
2121,0,23,6,17,
2122,0,25,8,17,
2123,0,22,6,16,
2124,0,21,6,15,
2125,0,24,7,17,
2126,0,23,6,17,
2127,0,24,6,18,
2128,0,24,7,17,
2129,0,22,6,16,
2130,0,22,6,16,
2131,0,25,7,18,
2132,0,23,6,17,
2133,0,27,8,19,
2134,0,24,6,18,
2135,0,22,6,16,
2136,0,21,6,15,
2137,0,23,7,16,
2138,0,21,6,15,
2139,0,25,7,18,
2140,0,24,6,18,
2141,0,23,6,17,
2142,0,24,7,17,
2143,0,23,6,17,
2144,0,24,7,17,
2145,0,23,7,16,
2146,0,24,6,18,
2147,0,23,6,17,
2148,0,23,7,16,
2149,0,22,6,16,
2150,0,22,7,15,
2151,0,23,7,16,
2152,0,24,7,17,
2153,0,22,6,16,
2154,0,24,7,17,
2155,0,23,6,17,
2156,0,23,7,16,
2157,0,23,6,17,
2158,0,23,6,17,
2159,0,23,7,16,
2160,0,24,6,18,
2161,0,24,7,17,
2162,0,23,7,16,
2163,0,24,7,17,
2164,0,21,6,15,
2165,0,22,7,15,
2166,0,23,6,17,
2167,0,22,6,16,
2168,0,23,7,16,
2169,0,25,7,18,
2170,0,23,6,17,
2171,0,23,7,16,
2172,0,24,6,18,
2173,0,23,6,17,
2174,0,25,7,18,
2175,0,23,7,16,
2176,0,23,8,15,
2177,0,23,7,16,
2178,0,25,7,18,
2179,0,22,6,16,
2180,0,22,7,15,
2181,0,23,6,17,
2182,0,24,7,17,
2183,0,25,7,18,
2184,0,23,6,17,
2185,0,23,7,16,
2186,0,23,6,17,
2187,0,22,6,16,
2188,0,24,7,17,
2189,0,22,6,16,
2190,0,26,7,19,
2191,0,24,6,18,
2192,0,23,6,17,
2193,0,23,7,16,
2194,0,22,6,16,
2195,0,24,7,17,
2196,0,23,6,17,
2197,0,21,6,15,
2198,0,24,7,17,
2199,0,26,7,19,
2200,0,22,5,17,
2201,0,25,9,16,
2202,0,24,7,17,
2203,0,22,6,16,
2204,0,24,6,18,
2205,0,23,7,16,
2206,0,24,6,18,
2207,0,23,6,17,
2208,0,24,7,17,
2209,0,22,6,16,
2210,0,21,6,15,
2211,0,25,8,17,
2212,0,24,6,18,
2213,0,23,6,17,
2214,0,23,7,16,
2215,0,23,6,17,
2216,0,22,6,16,
2217,0,25,7,18,
2218,0,23,6,17,
2219,0,23,7,16,
2220,0,25,7,18,
2221,0,23,6,17,
2222,0,23,7,16,
2223,0,22,6,16,
2224,0,23,7,16,
2225,0,23,7,16,
2226,0,23,6,17,
2227,0,24,6,18,
2228,0,23,7,16,
2229,0,24,7,17,
2230,0,23,7,16,
2231,0,25,8,17,
2232,0,24,7,17,
2233,0,23,7,16,
2234,0,24,6,18,
2235,0,23,6,17,
2236,0,22,6,16,
2237,0,25,7,18,
2238,0,23,6,17,
2239,0,22,6,16,
2240,0,22,7,15,
2241,0,22,6,16,
2242,0,21,6,15,
2243,0,24,7,17,
2244,0,23,7,16,
2245,0,23,6,17,
2246,0,24,7,17,
2247,0,22,6,16,
2248,0,25,7,18,
2249,0,24,6,18,
2250,0,24,7,17,
2251,0,22,6,16,
2252,0,22,6,16,
2253,0,22,7,15,
2254,0,22,7,15,
2255,0,22,7,15,
2256,0,25,7,18,
2257,0,24,7,17,
2258,0,24,7,17,
2259,0,23,7,16,
2260,0,23,6,17,
2261,0,22,6,16,
2262,0,25,7,18,
2263,0,24,6,18,
2264,0,25,7,18,
2265,0,23,6,17,
2266,0,21,6,15,
2267,0,23,7,16,
2268,0,22,6,16,
2269,0,21,6,15,
2270,0,24,7,17,
2271,0,22,6,16,
2272,0,25,7,18,
2273,0,24,7,17,
2274,0,23,6,17,
2275,0,23,7,16,
2276,0,24,6,18,
2277,0,23,6,17,
2278,0,22,6,16,
2279,0,25,7,18,
2280,0,24,6,18,
2281,0,22,6,16,
2282,0,22,7,15,
2283,0,22,6,16,
2284,0,21,6,15,
2285,0,25,7,18,
2286,0,23,6,17,
2287,0,22,6,16,
2288,0,24,7,17,
2289,0,22,6,16,
2290,0,25,7,18,
2291,0,23,6,17,
2292,0,23,7,16,
2293,0,23,6,17,
2294,0,26,7,19,
2295,0,24,6,18,
2296,0,24,8,16,
2297,0,22,6,16,
2298,0,21,6,15,
2299,0,23,7,16,
2300,0,23,7,16,
2301,0,22,6,16,
2302,0,21,6,15,
2303,0,24,7,17,
2304,0,25,7,18,
2305,0,24,7,17,
2306,0,23,6,17,
2307,0,23,7,16,
2308,0,23,6,17,
2309,0,22,6,16,
2310,0,26,7,19,
2311,0,24,7,17,
2312,0,22,6,16,
2313,0,21,6,15,
2314,0,23,7,16,
2315,0,23,7,16,
2316,0,24,6,18,
2317,0,23,7,16,
2318,0,23,6,17,
2319,0,25,7,18,
2320,0,24,7,17,
2321,0,22,6,16,
2322,0,25,7,18,
2323,0,24,6,18,
2324,0,25,7,18,
2325,0,24,7,17,
2326,0,21,5,16,
2327,0,23,7,16,
2328,0,22,7,15,
2329,0,23,6,17,
2330,0,24,6,18,
2331,0,22,6,16,
2332,0,24,7,17,
2333,0,25,7,18,
2334,0,23,6,17,
2335,0,22,6,16,
2336,0,24,7,17,
2337,0,24,6,18,
2338,0,22,6,16,
2339,0,25,7,18,
2340,0,24,6,18,
2341,0,23,6,17,
2342,0,23,7,16,
2343,0,21,6,15,
2344,0,25,7,18,
2345,0,24,7,17,
2346,0,23,7,16,
2347,0,23,6,17,
2348,0,23,6,17,
2349,0,25,7,18,
2350,0,23,7,16,
2351,0,25,7,18,
2352,0,23,6,17,
2353,0,23,6,17,
2354,0,26,7,19,
2355,0,26,6,20,
2356,0,29,7,22,
2357,0,31,7,24,
2358,0,30,6,24,
2359,0,33,7,26,
2360,0,34,7,27,
2361,0,34,6,28,
2362,0,36,7,29,
2363,0,36,6,30,
2364,0,37,7,30,
2365,0,36,6,30,
2366,0,40,7,33,
2367,0,38,6,32,
2368,0,39,7,32,
2369,0,42,7,35,
2370,0,44,9,35,
2371,0,41,6,35,
2372,0,41,7,34,
2373,0,42,6,36,
2374,0,42,6,36,
2375,0,43,7,36,
2376,0,43,6,37,
2377,0,43,6,37,
2378,0,46,7,39,
2379,0,44,6,38,
2380,0,46,7,39,
2381,0,48,7,41,
2382,0,48,7,41,
2383,0,47,7,40,
2384,0,47,6,41,
2385,0,47,6,41,
2386,0,49,7,42,
2387,0,48,6,42,
2388,0,50,7,43,
2389,0,50,8,42,
2390,0,50,6,44,
2391,0,49,6,43,
2392,0,52,7,45,
2393,0,52,8,44,
2394,0,52,7,45,
2395,0,52,7,45,
2396,0,53,7,46,
2397,0,52,6,46,
2398,0,55,7,48,
2399,0,53,6,47,
2400,0,53,6,47,
2401,0,55,7,48,
2402,0,54,7,47,
2403,0,55,7,48,
2404,0,55,7,48,
2405,0,56,7,49,
2406,0,58,7,51,
2407,0,56,6,50,
2408,0,55,6,49,
2409,0,58,7,51,
2410,0,57,6,51,
2411,0,57,7,50,
2412,0,58,6,52,
2413,0,58,7,51,
2414,0,58,7,51,
2415,0,61,7,54,
2416,0,60,7,53,
2417,0,59,7,52,
2418,0,61,7,54,
2419,0,59,6,53,
2420,0,61,7,54,
2421,0,63,8,55,
2422,0,61,6,55,
2423,0,60,6,54,
2424,0,61,7,54,
2425,0,63,7,56,
2426,0,63,8,55,
2427,0,62,6,56,
2428,0,63,7,56,
2429,0,63,6,57,
2430,0,62,6,56,
2431,0,65,7,58,
2432,0,64,6,58,
2433,0,63,6,57,
2434,0,64,7,57,
2435,0,66,7,59,
2436,0,67,7,60,
2437,0,65,6,59,
2438,0,65,7,58,
2439,0,66,6,60,
2440,0,66,6,60,
2441,0,66,7,59,
2442,0,66,6,60,
2443,0,69,7,62,
2444,0,67,6,61,
2445,0,67,7,60,
2446,0,67,6,61,
2447,0,67,6,61,
2448,0,70,7,63,
2449,0,68,7,61,
2450,0,68,6,62,
2451,0,68,6,62,
2452,0,70,7,63,
2453,0,68,6,62,
2454,0,72,7,65,
2455,0,72,7,65,
2456,0,70,6,64,
2457,0,69,6,63,
2458,0,71,7,64,
2459,0,71,6,65,
2460,0,72,7,65,
2461,0,71,6,65,
2462,0,71,7,64,
2463,0,72,6,66,
2464,0,72,6,66,
2465,0,72,7,65,
2466,0,72,6,66,
2467,0,73,7,66,
2468,0,74,7,67,
2469,0,72,6,66,
2470,0,74,7,67,
2471,0,74,6,68,
2472,0,73,6,67,
2473,0,75,7,68,
2474,0,76,9,67,
2475,0,75,7,68,
2476,0,75,6,69,
2477,0,77,8,69,
2478,0,75,7,68,
2479,0,77,9,68,
2480,0,78,7,71,
2481,0,76,6,70,
2482,0,77,7,70,
2483,0,75,6,69,
2484,0,76,7,69,
2485,0,78,7,71,
2486,0,78,7,71,
2487,0,77,6,71,
2488,0,76,6,70,
2489,0,80,7,73,
2490,0,78,6,72,
2491,0,78,7,71,
2492,0,78,6,72,
2493,0,77,6,71,
2494,0,79,7,72,
2495,0,79,7,72,
2496,0,81,7,74,
2497,0,79,6,73,
2498,0,78,6,72,
2499,0,81,7,74,
2500,0,80,6,74,
2501,0,80,7,73,
2502,0,80,6,74,
2503,0,80,7,73,
2504,0,83,8,75,
2505,0,81,6,75,
2506,0,81,7,74,
2507,0,81,6,75,
2508,0,80,6,74,
2509,0,83,7,76,
2510,0,81,6,75,
2511,0,84,7,77,
2512,0,82,6,76,
2513,0,81,6,75,
2514,0,84,7,77,
2515,0,82,7,75,
2516,0,82,6,76,
2517,0,81,6,75,
2518,0,83,7,76,
2519,0,75,6,69,
2520,0,65,7,58,
2521,0,53,6,47,
2522,0,52,6,46,
2523,0,49,7,42,
2524,0,39,6,33,
2525,0,34,10,24,
2526,0,26,7,19,
2527,0,27,7,20,
2528,0,33,6,27,
2529,0,39,7,32,
2530,0,43,8,35,
2531,0,40,6,34,
2532,0,40,6,34,
2533,0,43,7,36,
2534,0,42,7,35,
2535,0,44,7,37,
2536,0,43,6,37,
2537,0,44,7,37,
2538,0,44,6,38,
2539,0,45,6,39,
2540,0,45,7,38,
2541,0,46,6,40,
2542,0,47,7,40,
2543,0,45,6,39,
2544,0,48,7,41,
2545,0,47,6,41,
2546,0,49,7,42,
2547,0,47,6,41,
2548,0,50,7,43,
2549,0,49,6,43,
2550,0,49,7,42,
2551,0,50,6,44,
2552,0,49,6,43,
2553,0,52,7,45,
2554,0,50,6,44,
2555,0,54,7,47,
2556,0,51,6,45,
2557,0,52,7,45,
2558,0,54,7,47,
2559,0,53,6,47,
2560,0,53,7,46,
2561,0,54,6,48,
2562,0,53,6,47,
2563,0,55,7,48,
2564,0,55,6,49,
2565,0,57,8,49,
2566,0,56,7,49,
2567,0,55,6,49,
2568,0,57,7,50,
2569,0,56,6,50,
2570,0,57,7,50,
2571,0,57,6,51,
2572,0,56,6,50,
2573,0,60,7,53,
2574,0,58,7,51,
2575,0,58,6,52,
2576,0,60,7,53,
2577,0,58,6,52,
2578,0,60,7,53,
2579,0,60,6,54,
2580,0,60,7,53,
2581,0,60,6,54,
2582,0,61,6,55,
2583,0,61,7,54,
2584,0,61,6,55,
2585,0,60,6,54,
2586,0,63,7,56,
2587,0,61,6,55,
2588,0,63,7,56,
2589,0,63,6,57,
2590,0,62,6,56,
2591,0,64,7,57,
2592,0,63,6,57,
2593,0,64,7,57,
2594,0,64,6,58,
2595,0,63,6,57,
2596,0,66,7,59,
2597,0,65,6,59,
2598,0,64,6,58,
2599,0,67,7,60,
2600,0,66,6,60,
2601,0,66,7,59,
2602,0,66,6,60,
2603,0,67,7,60,
2604,0,66,6,60,
2605,0,69,7,62,
2606,0,67,6,61,
2607,0,66,6,60,
2608,0,69,7,62,
2609,0,68,6,62,
2610,0,68,7,61,
2611,0,69,6,63,
2612,0,68,6,62,
2613,0,70,7,63,
2614,0,68,6,62,
2615,0,72,7,65,
2616,0,70,6,64,
2617,0,69,6,63,
2618,0,72,7,65,
2619,0,70,6,64,
2620,0,71,7,64,
2621,0,71,6,65,
2622,0,70,6,64,
2623,0,72,7,65,
2624,0,72,6,66,
2625,0,71,6,65,
2626,0,73,7,66,
2627,0,71,6,65,
2628,0,75,7,68,
2629,0,73,7,66,
2630,0,73,6,67,
2631,0,72,6,66,
2632,0,75,7,68,
2633,0,76,7,69,
2634,0,74,6,68,
2635,0,73,6,67,
2636,0,74,7,67,
2637,0,77,7,70,
2638,0,75,6,69,
2639,0,75,7,68,
2640,0,75,6,69,
2641,0,75,6,69,
2642,0,78,7,71,
2643,0,76,6,70,
2644,0,75,6,69,
2645,0,77,7,70,
2646,0,76,6,70,
2647,0,79,7,72,
2648,0,77,7,70,
2649,0,77,6,71,
2650,0,77,6,71,
2651,0,80,7,73,
2652,0,78,6,72,
2653,0,78,7,71,
2654,0,78,6,72,
2655,0,79,7,72,
2656,0,83,10,73,
2657,0,78,6,72,
2658,0,79,7,72,
2659,0,79,6,73,
2660,0,79,6,73,
2661,0,81,7,74,
2662,0,80,6,74,
2663,0,80,7,73,
2664,0,80,6,74,
2665,0,81,7,74,
2666,0,82,7,75,
2667,0,82,7,75,
2668,0,81,7,74,
2669,0,81,6,75,
2670,0,82,7,75,
2671,0,82,6,76,
2672,0,82,7,75,
2673,0,83,7,76,
2674,0,81,6,75,
2675,0,84,7,77,
2676,0,82,6,76,
2677,0,81,6,75,
2678,0,83,7,76,
2679,0,82,6,76,
2680,0,76,7,69,
2681,0,63,6,57,
2682,0,53,7,46,
2683,0,54,7,47,
2684,0,48,6,42,
2685,0,38,6,32,
2686,0,30,6,24,
2687,0,26,7,19,
2688,0,23,6,17,
2689,0,33,7,26,
2690,0,39,6,33,
2691,0,40,7,33,
2692,0,40,6,34,
2693,0,41,6,35,
2694,0,43,7,36,
2695,0,42,7,35,
2696,0,43,6,37,
2697,0,42,6,36,
2698,0,45,7,38,
2699,0,43,6,37,
2700,0,46,7,39,
2701,0,45,6,39,
2702,0,45,6,39,
2703,0,48,7,41,
2704,0,47,6,41,
2705,0,47,7,40,
2706,0,47,7,40,
2707,0,49,7,42,
2708,0,47,6,41,
2709,0,51,7,44,
2710,0,49,6,43,
2711,0,49,6,43,
2712,0,51,7,44,
2713,0,49,6,43,
2714,0,53,7,46,
2715,0,51,6,45,
2716,0,51,7,44,
2717,0,52,6,46,
2718,0,52,6,46,
2719,0,54,7,47,
2720,0,53,7,46,
2721,0,53,6,47,
2722,0,53,6,47,
2723,0,55,7,48,
2724,0,55,7,48,
2725,0,55,7,48,
2726,0,55,6,49,
2727,0,55,7,48,
2728,0,57,7,50,
2729,0,56,7,49,
2730,0,56,6,50,
2731,0,57,7,50,
2732,0,58,7,51,
2733,0,56,6,50,
2734,0,60,7,53,
2735,0,58,6,52,
2736,0,57,6,51,
2737,0,60,7,53,
2738,0,59,6,53,
2739,0,59,7,52,
2740,0,60,6,54,
2741,0,59,6,53,
2742,0,61,7,54,
2743,0,61,6,55,
2744,0,61,7,54,
2745,0,62,7,55,
2746,0,60,6,54,
2747,0,65,8,57,
2748,0,62,6,56,
2749,0,62,7,55,
2750,0,63,6,57,
2751,0,62,6,56,
2752,0,65,7,58,
2753,0,63,7,56,
2754,0,64,7,57,
2755,0,65,7,58,
2756,0,63,6,57,
2757,0,66,8,58,
2758,0,66,7,59,
2759,0,65,7,58,
2760,0,65,6,59,
2761,0,65,6,59,
2762,0,68,7,61,
2763,0,66,6,60,
2764,0,66,7,59,
2765,0,67,6,61,
2766,0,66,6,60,
2767,0,68,7,61,
2768,0,68,6,62,
2769,0,67,6,61,
2770,0,69,7,62,
2771,0,67,6,61,
2772,0,71,7,64,
2773,0,69,6,63,
2774,0,69,7,62,
2775,0,69,6,63,
2776,0,69,6,63,
2777,0,72,7,65,
2778,0,70,6,64,
2779,0,71,7,64,
2780,0,70,6,64,
2781,0,72,7,65,
2782,0,73,8,65,
2783,0,71,7,64,
2784,0,71,7,64,
2785,0,72,6,66,
2786,0,72,6,66,
2787,0,72,7,65,
2788,0,73,8,65,
2789,0,74,7,67,
2790,0,72,6,66,
2791,0,74,7,67,
2792,0,73,6,67,
2793,0,74,7,67,
2794,0,74,6,68,
2795,0,74,6,68,
2796,0,74,7,67,
2797,0,74,6,68,
2798,0,75,7,68,
2799,0,76,7,69,
2800,0,74,6,68,
2801,0,76,7,69,
2802,0,76,6,70,
2803,0,75,6,69,
2804,0,77,7,70,
2805,0,75,6,69,
2806,0,76,7,69,
2807,0,77,6,71,
2808,0,77,7,70,
2809,0,78,7,71,
2810,0,76,6,70,
2811,0,80,7,73,
2812,0,78,6,72,
2813,0,77,6,71,
2814,0,79,7,72,
2815,0,78,6,72,
2816,0,80,7,73,
2817,0,79,6,73,
2818,0,80,7,73,
2819,0,80,7,73,
2820,0,79,6,73,
2821,0,80,7,73,
2822,0,80,6,74,
2823,0,79,6,73,
2824,0,81,7,74,
2825,0,79,6,73,
2826,0,81,7,74,
2827,0,81,6,75,
2828,0,80,6,74,
2829,0,83,7,76,
2830,0,81,7,74,
2831,0,82,6,76,
2832,0,81,6,75,
2833,0,83,7,76,
2834,0,81,6,75,
2835,0,83,7,76,
2836,0,82,6,76,
2837,0,83,8,75,
2838,0,85,8,77,
2839,0,82,6,76,
2840,0,82,7,75,
2841,0,76,7,69,
2842,0,62,6,56,
2843,0,52,6,46,
2844,0,53,7,46,
2845,0,48,7,41,
2846,0,38,6,32,
2847,0,30,7,23,
2848,0,22,5,17,
2849,0,26,8,18,
2850,0,37,6,31,
2851,0,40,7,33,
2852,0,39,6,33,
2853,0,42,7,35,
2854,0,41,6,35,
2855,0,41,6,35,
2856,0,43,7,36,
2857,0,43,6,37,
2858,0,43,7,36,
2859,0,44,6,38,
2860,0,43,6,37,
2861,0,46,7,39,
2862,0,45,6,39,
2863,0,46,7,39,
2864,0,46,6,40,
2865,0,46,6,40,
2866,0,48,7,41,
2867,0,47,6,41,
2868,0,48,7,41,
2869,0,48,6,42,
2870,0,49,7,42,
2871,0,50,7,43,
2872,0,51,7,44,
2873,0,50,6,44,
2874,0,50,7,43,
2875,0,51,7,44,
2876,0,50,6,44,
2877,0,52,7,45,
2878,0,54,7,47,
2879,0,52,6,46,
2880,0,52,6,46,
2881,0,54,7,47,
2882,0,52,6,46,
2883,0,54,7,47,
2884,0,54,6,48,
2885,0,54,7,47,
2886,0,56,7,49,
2887,0,55,6,49,
2888,0,55,7,48,
2889,0,56,6,50,
2890,0,55,6,49,
2891,0,57,7,50,
2892,0,58,7,51,
2893,0,57,6,51,
2894,0,57,7,50,
2895,0,58,6,52,
2896,0,57,6,51,
2897,0,60,7,53,
2898,0,59,6,53,
2899,0,59,7,52,
2900,0,59,6,53,
2901,0,59,6,53,
2902,0,61,7,54,
2903,0,60,6,54,
2904,0,61,7,54,
2905,0,62,7,55,
2906,0,60,6,54,
2907,0,63,7,56,
2908,0,62,6,56,
2909,0,63,7,56,
2910,0,62,7,55,
2911,0,63,6,57,
2912,0,63,6,57,
2913,0,63,7,56,
2914,0,64,6,58,
2915,0,63,6,57,
2916,0,65,7,58,
2917,0,63,6,57,
2918,0,66,7,59,
2919,0,65,6,59,
2920,0,66,7,59,
2921,0,65,7,58,
2922,0,68,7,61,
2923,0,66,6,60,
2924,0,66,7,59,
2925,0,67,6,61,
2926,0,66,6,60,
2927,0,68,7,61,
2928,0,71,9,62,
2929,0,68,6,62,
2930,0,68,7,61,
2931,0,68,6,62,
2932,0,67,6,61,
2933,0,70,7,63,
2934,0,68,6,62,
2935,0,70,7,63,
2936,0,69,6,63,
2937,0,69,6,63,
2938,0,72,8,64,
2939,0,70,6,64,
2940,0,70,7,63,
2941,0,71,6,65,
2942,0,70,6,64,
2943,0,72,7,65,
2944,0,70,6,64,
2945,0,74,7,67,
2946,0,72,6,66,
2947,0,71,6,65,
2948,0,73,7,66,
2949,0,71,6,65,
2950,0,75,7,68,
2951,0,73,6,67,
2952,0,74,7,67,
2953,0,73,7,66,
2954,0,75,7,68,
2955,0,74,6,68,
2956,0,74,7,67,
2957,0,74,6,68,
2958,0,74,6,68,
2959,0,76,7,69,
2960,0,74,6,68,
2961,0,77,7,70,
2962,0,75,6,69,
2963,0,75,6,69,
2964,0,77,7,70,
2965,0,75,6,69,
2966,0,78,7,71,
2967,0,77,6,71,
2968,0,78,7,71,
2969,0,76,6,70,
2970,0,77,7,70,
2971,0,79,7,72,
2972,0,78,6,72,
2973,0,78,7,71,
2974,0,78,6,72,
2975,0,78,7,71,
2976,0,79,7,72,
2977,0,79,6,73,
2978,0,79,7,72,
2979,0,79,6,73,
2980,0,78,6,72,
2981,0,80,7,73,
2982,0,80,7,73,
2983,0,81,7,74,
2984,0,80,6,74,
2985,0,79,6,73,
2986,0,82,7,75,
2987,0,80,6,74,
2988,0,81,7,74,
2989,0,81,6,75,
2990,0,81,7,74,
2991,0,82,6,76,
2992,0,81,6,75,
2993,0,84,7,77,
2994,0,82,6,76,
2995,0,82,7,75,
2996,0,83,7,76,
2997,0,81,6,75,
2998,0,83,7,76,
2999,0,84,7,77,
3000,0,82,7,75,
3001,0,82,6,76,
3002,0,72,7,65,
3003,0,59,6,53,
3004,0,51,6,45,
3005,0,52,7,45,
3006,0,45,6,39,
3007,0,36,6,30,
3008,0,28,7,21,
3009,0,25,7,18,
3010,0,27,6,21,
3011,0,38,6,32,
3012,0,39,7,32,
3013,0,41,7,34,
3014,0,41,6,35,
3015,0,41,7,34,
3016,0,42,6,36,
3017,0,41,6,35,
3018,0,45,7,38,
3019,0,45,8,37,
3020,0,44,7,37,
3021,0,44,6,38,
3022,0,45,7,38,
3023,0,46,7,39,
3024,0,46,7,39,
3025,0,47,7,40,
3026,0,46,6,40,
3027,0,48,7,41,
3028,0,47,6,41,
3029,0,49,7,42,
3030,0,48,7,41,
3031,0,49,7,42,
3032,0,49,6,43,
3033,0,49,6,43,
3034,0,52,7,45,
3035,0,50,6,44,
3036,0,50,6,44,
3037,0,52,7,45,
3038,0,51,6,45,
3039,0,53,7,46,
3040,0,52,6,46,
3041,0,53,7,46,
3042,0,53,6,47,
3043,0,56,7,49,
3044,0,54,6,48,
3045,0,55,7,48,
3046,0,55,7,48,
3047,0,56,7,49,
3048,0,54,6,48,
3049,0,57,7,50,
3050,0,56,6,50,
3051,0,55,6,49,
3052,0,58,7,51,
3053,0,56,6,50,
3054,0,58,7,51,
3055,0,58,6,52,
3056,0,58,7,51,
3057,0,58,6,52,
3058,0,58,6,52,
3059,0,61,7,54,
3060,0,60,7,53,
3061,0,58,6,52,
3062,0,61,7,54,
3063,0,59,6,53,
3064,0,62,7,55,
3065,0,61,6,55,
3066,0,61,7,54,
3067,0,61,6,55,
3068,0,62,6,56,
3069,0,62,7,55,
3070,0,62,6,56,
3071,0,61,6,55,
3072,0,64,7,57,
3073,0,65,7,58,
3074,0,63,6,57,
3075,0,64,7,57,
3076,0,64,6,58,
3077,0,64,6,58,
3078,0,64,7,57,
3079,0,65,6,59,
3080,0,67,8,59,
3081,0,64,6,58,
3082,0,67,7,60,
3083,0,67,7,60,
3084,0,66,7,59,
3085,0,66,7,59,
3086,0,69,7,62,
3087,0,67,6,61,
3088,0,67,7,60,
3089,0,67,6,61,
3090,0,67,6,61,
3091,0,68,7,61,
3092,0,69,7,62,
3093,0,68,6,62,
3094,0,68,6,62,
3095,0,70,7,63,
3096,0,69,6,63,
3097,0,69,7,62,
3098,0,70,6,64,
3099,0,69,6,63,
3100,0,71,7,64,
3101,0,69,6,63,
3102,0,72,7,65,
3103,0,72,7,65,
3104,0,70,6,64,
3105,0,73,7,66,
3106,0,72,6,66,
3107,0,72,7,65,
3108,0,72,6,66,
3109,0,71,6,65,
3110,0,76,9,67,
3111,0,73,6,67,
3112,0,72,6,66,
3113,0,74,7,67,
3114,0,72,6,66,
3115,0,76,7,69,
3116,0,74,6,68,
3117,0,74,7,67,
3118,0,74,6,68,
3119,0,74,6,68,
3120,0,77,7,70,
3121,0,75,6,69,
3122,0,75,7,68,
3123,0,75,6,69,
3124,0,75,6,69,
3125,0,77,7,70,
3126,0,78,7,71,
3127,0,76,6,70,
3128,0,76,6,70,
3129,0,78,7,71,
3130,0,78,6,72,
3131,0,78,7,71,
3132,0,76,6,70,
3133,0,80,7,73,
3134,0,77,6,71,
3135,0,79,7,72,
3136,0,77,6,71,
3137,0,79,7,72,
3138,0,79,6,73,
3139,0,79,7,72,
3140,0,80,7,73,
3141,0,78,6,72,
3142,0,82,7,75,
3143,0,80,6,74,
3144,0,79,6,73,
3145,0,81,7,74,
3146,0,79,6,73,
3147,0,82,7,75,
3148,0,81,6,75,
3149,0,81,7,74,
3150,0,81,6,75,
3151,0,81,6,75,
3152,0,82,7,75,
3153,0,82,6,76,
3154,0,81,6,75,
3155,0,83,7,76,
3156,0,81,6,75,
3157,0,83,7,76,
3158,0,82,6,76,
3159,0,81,6,75,
3160,0,83,7,76,
3161,0,82,6,76,
3162,0,82,7,75,
3163,0,69,6,63,
3164,0,57,6,51,
3165,0,54,7,47,
3166,0,49,6,43,
3167,0,44,6,38,
3168,0,34,6,28,
3169,0,26,6,20,
3170,0,22,7,15,
3171,0,28,6,22,
3172,0,40,7,33,
3173,0,39,6,33,
3174,0,42,7,35,
3175,0,41,6,35,
3176,0,40,6,34,
3177,0,43,7,36,
3178,0,43,7,36,
3179,0,43,7,36,
3180,0,43,6,37,
3181,0,43,6,37,
3182,0,45,7,38,
3183,0,44,6,38,
3184,0,47,7,40,
3185,0,46,6,40,
3186,0,45,6,39,
3187,0,47,7,40,
3188,0,49,7,42,
3189,0,48,6,42,
3190,0,48,7,41,
3191,0,48,7,41,
3192,0,50,7,43,
3193,0,49,6,43,
3194,0,51,7,44,
3195,0,49,6,43,
3196,0,52,7,45,
3197,0,51,6,45,
3198,0,51,7,44,
3199,0,52,6,46,
3200,0,52,7,45,
3201,0,54,8,46,
3202,0,55,7,48,
3203,0,53,6,47,
3204,0,54,7,47,
3205,0,55,7,48,
3206,0,53,6,47,
3207,0,56,7,49,
3208,0,55,6,49,
3209,0,55,7,48,
3210,0,56,6,50,
3211,0,57,7,50,
3212,0,56,6,50,
3213,0,57,7,50,
3214,0,57,6,51,
3215,0,56,6,50,
3216,0,59,7,52,
3217,0,57,6,51,
3218,0,60,7,53,
3219,0,59,6,53,
3220,0,58,6,52,
3221,0,60,7,53,
3222,0,60,6,54,
3223,0,60,7,53,
3224,0,60,7,53,
3225,0,60,6,54,
3226,0,60,6,54,
3227,0,63,7,56,
3228,0,61,6,55,
3229,0,61,6,55,
3230,0,63,7,56,
3231,0,61,6,55,
3232,0,65,7,58,
3233,0,63,6,57,
3234,0,63,7,56,
3235,0,63,6,57,
3236,0,64,6,58,
3237,0,65,7,58,
3238,0,64,6,58,
3239,0,64,7,57,
3240,0,65,6,59,
3241,0,64,6,58,
3242,0,66,7,59,
3243,0,68,7,61,
3244,0,66,6,60,
3245,0,65,6,59,
3246,0,67,7,60,
3247,0,67,6,61,
3248,0,67,7,60,
3249,0,67,6,61,
3250,0,67,7,60,
3251,0,69,7,62,
3252,0,68,6,62,
3253,0,68,7,61,
3254,0,68,7,61,
3255,0,70,7,63,
3256,0,68,6,62,
3257,0,70,7,63,
3258,0,69,6,63,
3259,0,70,7,63,
3260,0,70,6,64,
3261,0,70,6,64,
3262,0,71,7,64,
3263,0,71,7,64,
3264,0,72,7,65,
3265,0,70,6,64,
3266,0,72,7,65,
3267,0,72,6,66,
3268,0,72,7,65,
3269,0,71,6,65,
3270,0,74,7,67,
3271,0,73,6,67,
3272,0,73,7,66,
3273,0,73,7,66,
3274,0,73,7,66,
3275,0,74,7,67,
3276,0,73,6,67,
3277,0,76,7,69,
3278,0,74,6,68,
3279,0,73,6,67,
3280,0,76,7,69,
3281,0,75,6,69,
3282,0,75,7,68,
3283,0,75,6,69,
3284,0,77,7,70,
3285,0,75,6,69,
3286,0,78,7,71,
3287,0,76,6,70,
3288,0,75,6,69,
3289,0,78,7,71,
3290,0,76,6,70,
3291,0,79,7,72,
3292,0,80,9,71,
3293,0,77,7,70,
3294,0,78,6,72,
3295,0,78,6,72,
3296,0,78,7,71,
3297,0,78,6,72,
3298,0,78,6,72,
3299,0,80,7,73,
3300,0,84,8,76,
3301,0,79,6,73,
3302,0,79,7,72,
3303,0,79,6,73,
3304,0,82,7,75,
3305,0,80,6,74,
3306,0,80,7,73,
3307,0,81,7,74,
3308,0,80,6,74,
3309,0,82,7,75,
3310,0,80,6,74,
3311,0,83,7,76,
3312,0,82,7,75,
3313,0,81,6,75,
3314,0,83,7,76,
3315,0,83,7,76,
3316,0,82,7,75,
3317,0,82,6,76,
3318,0,81,6,75,
3319,0,83,7,76,
3320,0,82,6,76,
3321,0,81,6,75,
3322,0,83,7,76,
3323,0,77,6,71,
3324,0,67,7,60,
3325,0,55,7,48,
3326,0,53,6,47,
3327,0,49,7,42,
3328,0,40,7,33,
3329,0,31,6,25,
3330,0,26,7,19,
3331,0,24,6,18,
3332,0,30,7,23,
3333,0,39,6,33,
3334,0,41,7,34,
3335,0,40,7,33,
3336,0,43,8,35,
3337,0,41,6,35,
3338,0,41,6,35,
3339,0,44,7,37,
3340,0,42,6,36,
3341,0,44,7,37,
3342,0,44,6,38,
3343,0,44,6,38,
3344,0,46,7,39,
3345,0,46,7,39,
3346,0,48,7,41,
3347,0,46,6,40,
3348,0,46,6,40,
3349,0,48,7,41,
3350,0,48,6,42,
3351,0,48,7,41,
3352,0,50,7,43,
3353,0,48,6,42,
3354,0,50,7,43,
3355,0,50,6,44,
3356,0,49,6,43,
3357,0,52,7,45,
3358,0,50,6,44,
3359,0,51,7,44,
3360,0,52,6,46,
3361,0,52,7,45,
3362,0,54,7,47,
3363,0,52,6,46,
3364,0,54,7,47,
3365,0,55,7,48,
3366,0,53,6,47,
3367,0,55,7,48,
3368,0,55,6,49,
3369,0,55,7,48,
3370,0,55,6,49,
3371,0,56,7,49,
3372,0,57,7,50,
3373,0,58,7,51,
3374,0,57,7,50,
3375,0,57,6,51,
3376,0,56,6,50,
3377,0,59,7,52,
3378,0,58,6,52,
3379,0,58,7,51,
3380,0,59,6,53,
3381,0,58,6,52,
3382,0,61,7,54,
3383,0,62,8,54,
3384,0,60,7,53,
3385,0,60,6,54,
3386,0,62,7,55,
3387,0,60,6,54,
3388,0,64,9,55,
3389,0,61,6,55,
3390,0,61,6,55,
3391,0,62,7,55,
3392,0,63,7,56,
3393,0,64,7,57,
3394,0,64,7,57,
3395,0,63,7,56,
3396,0,64,7,57,
3397,0,63,6,57,
3398,0,66,7,59,
3399,0,64,6,58,
3400,0,64,6,58,
3401,0,66,7,59,
3402,0,64,6,58,
3403,0,67,7,60,
3404,0,66,6,60,
3405,0,66,7,59,
3406,0,66,6,60,
3407,0,66,6,60,
3408,0,67,7,60,
3409,0,67,6,61,
3410,0,66,6,60,
3411,0,68,7,61,
3412,0,68,6,62,
3413,0,69,7,62,
3414,0,68,7,61,
3415,0,70,7,63,
3416,0,69,6,63,
3417,0,69,7,62,
3418,0,69,6,63,
3419,0,68,6,62,
3420,0,71,7,64,
3421,0,71,7,64,
3422,0,70,6,64,
3423,0,70,7,63,
3424,0,71,6,65,
3425,0,73,7,66,
3426,0,71,6,65,
3427,0,71,7,64,
3428,0,72,6,66,
3429,0,71,6,65,
3430,0,73,7,66,
3431,0,72,6,66,
3432,0,73,7,66,
3433,0,73,6,67,
3434,0,72,6,66,
3435,0,74,7,67,
3436,0,75,7,68,
3437,0,74,7,67,
3438,0,75,7,68,
3439,0,73,6,67,
3440,0,74,7,67,
3441,0,77,7,70,
3442,0,75,6,69,
3443,0,74,6,68,
3444,0,76,7,69,
3445,0,76,6,70,
3446,0,76,7,69,
3447,0,76,6,70,
3448,0,75,6,69,
3449,0,77,7,70,
3450,0,77,6,71,
3451,0,77,7,70,
3452,0,78,7,71,
3453,0,76,6,70,
3454,0,78,7,71,
3455,0,78,7,71,
3456,0,79,7,72,
3457,0,81,8,73,
3458,0,77,6,71,
3459,0,81,7,74,
3460,0,79,6,73,
3461,0,78,6,72,
3462,0,80,7,73,
3463,0,79,6,73,
3464,0,80,7,73,
3465,0,80,6,74,
3466,0,80,7,73,
3467,0,79,6,73,
3468,0,82,7,75,
3469,0,81,6,75,
3470,0,80,6,74,
3471,0,82,7,75,
3472,0,81,6,75,
3473,0,81,7,74,
3474,0,86,10,76,
3475,0,81,6,75,
3476,0,83,7,76,
3477,0,84,7,77,
3478,0,82,6,76,
3479,0,82,7,75,
3480,0,83,7,76,
3481,0,83,7,76,
3482,0,82,7,75,
3483,0,82,7,75,
3484,0,77,7,70,
3485,0,66,7,59,
3486,0,53,6,47,
3487,0,52,6,46,
3488,0,49,7,42,
3489,0,39,6,33,
3490,0,32,6,26,
3491,0,25,7,18,
3492,0,24,6,18,
3493,0,30,6,24,
3494,0,40,7,33,
3495,0,39,6,33,
3496,0,40,7,33,
3497,0,41,6,35,
3498,0,43,7,36,
3499,0,42,6,36,
3500,0,43,7,36,
3501,0,43,6,37,
3502,0,43,6,37,
3503,0,45,7,38,
3504,0,45,6,39,
3505,0,45,7,38,
3506,0,45,6,39,
3507,0,48,7,41,
3508,0,46,6,40,
3509,0,48,7,41,
3510,0,46,6,40,
3511,0,49,7,42,
3512,0,48,6,42,
3513,0,49,7,42,
3514,0,49,6,43,
3515,0,50,7,43,
3516,0,50,6,44,
3517,0,50,7,43,
3518,0,51,6,45,
3519,0,50,6,44,
3520,0,52,7,45,
3521,0,52,6,46,
3522,0,52,7,45,
3523,0,53,6,47,
3524,0,52,6,46,
3525,0,55,7,48,
3526,0,53,6,47,
3527,0,54,7,47,
3528,0,55,7,48,
3529,0,55,6,49,
3530,0,55,7,48,
3531,0,55,6,49,
3532,0,55,6,49,
3533,0,57,7,50,
3534,0,56,6,50,
3535,0,56,6,50,
3536,0,58,7,51,
3537,0,56,6,50,
3538,0,58,7,51,
3539,0,58,6,52,
3540,0,57,6,51,
3541,0,60,7,53,
3542,0,58,6,52,
3543,0,61,7,54,
3544,0,60,6,54,
3545,0,59,6,53,
3546,0,61,7,54,
3547,0,61,6,55,
3548,0,61,7,54,
3549,0,62,7,55,
3550,0,60,6,54,
3551,0,63,7,56,
3552,0,62,6,56,
3553,0,61,6,55,
3554,0,64,7,57,
3555,0,63,6,57,
3556,0,63,7,56,
3557,0,63,6,57,
3558,0,65,7,58,
3559,0,63,6,57,
3560,0,66,8,58,
3561,0,65,7,58,
3562,0,65,6,59,
3563,0,65,6,59,
3564,0,66,7,59,
3565,0,71,10,61,
3566,0,65,6,59,
3567,0,67,7,60,
3568,0,65,6,59,
3569,0,67,7,60,
3570,0,67,6,61,
3571,0,66,6,60,
3572,0,68,7,61,
3573,0,68,7,61,
3574,0,68,6,62,
3575,0,67,6,61,
3576,0,68,7,61,
3577,0,70,7,63,
3578,0,69,6,63,
3579,0,70,7,63,
3580,0,70,7,63,
3581,0,70,6,64,
3582,0,70,7,63,
3583,0,70,6,64,
3584,0,69,6,63,
3585,0,72,7,65,
3586,0,71,6,65,
3587,0,71,7,64,
3588,0,71,6,65,
3589,0,71,6,65,
3590,0,74,7,67,
3591,0,72,6,66,
3592,0,71,6,65,
3593,0,74,7,67,
3594,0,72,6,66,
3595,0,74,7,67,
3596,0,73,7,66,
3597,0,74,6,68,
3598,0,73,6,67,
3599,0,73,6,67,
3600,0,76,7,69,
3601,0,74,6,68,
3602,0,75,7,68,
3603,0,75,6,69,
3604,0,74,6,68,
3605,0,76,7,69,
3606,0,77,7,70,
3607,0,76,6,70,
3608,0,75,6,69,
3609,0,78,7,71,
3610,0,76,6,70,
3611,0,84,13,71,
3612,0,82,12,70,
3613,0,79,8,71,
3614,0,77,6,71,
3615,0,80,7,73,
3616,0,78,6,72,
3617,0,78,7,71,
3618,0,78,6,72,
3619,0,77,6,71,
3620,0,79,7,72,
3621,0,79,6,73,
3622,0,78,6,72,
3623,0,80,7,73,
3624,0,78,6,72,
3625,0,80,7,73,
3626,0,80,6,74,
3627,0,79,6,73,
3628,0,82,7,75,
3629,0,80,6,74,
3630,0,80,6,74,
3631,0,82,7,75,
3632,0,80,6,74,
3633,0,83,8,75,
3634,0,81,6,75,
3635,0,82,7,75,
3636,0,64,,64,
3637,0,42,,42,
3638,0,18,,18,
