window-id,queue-size-CL,queue-size-LL,10.0.0.13:36758 -> 10.0.1.13:3000,10.0.1.13:3000 -> 10.0.0.13:36758,10.0.0.13:45690 -> 10.0.1.13:1000
0,0,29,9,20,
1,0,43,8,35,
2,0,41,6,35,
3,0,33,7,26,
4,0,29,7,22,
5,0,26,7,19,
6,0,27,8,19,
7,0,24,6,18,
8,0,22,6,16,
9,0,23,7,16,
10,0,23,6,17,
11,0,21,6,15,
12,0,24,7,17,
13,0,25,7,18,
14,0,22,7,15,
15,0,22,6,16,
16,0,23,6,17,
17,0,26,7,19,
18,0,24,6,18,
19,0,26,8,18,
20,0,26,10,16,
21,0,25,9,16,
22,0,30,12,18,
23,0,25,8,17,
24,0,25,9,16,
25,0,24,8,16,
26,0,27,9,18,
27,0,27,9,18,
28,0,27,10,17,
29,0,24,9,15,
30,0,25,8,17,
31,0,24,8,16,
32,0,28,10,18,
33,0,25,7,18,
34,0,22,6,16,
35,0,23,6,17,
36,0,25,8,17,
37,0,22,6,16,
38,0,23,7,16,
39,0,23,6,17,
40,0,23,7,16,
41,0,25,8,17,
42,0,24,6,18,
43,0,24,7,17,
44,0,25,7,18,
45,0,23,6,17,
46,0,22,6,16,
47,0,23,7,16,
48,0,22,6,16,
49,0,23,7,16,
50,0,22,7,15,
51,0,23,6,17,
52,0,23,6,17,
53,0,26,7,19,
54,0,23,6,17,
55,0,22,6,16,
56,0,23,6,17,
57,0,25,8,17,
58,0,24,6,18,
59,0,23,7,16,
60,0,24,7,17,
61,0,22,6,16,
62,0,25,7,18,
63,0,24,6,18,
64,0,23,6,17,
65,0,24,7,17,
66,0,23,7,16,
67,0,25,7,18,
68,0,24,6,18,
69,0,22,6,16,
70,0,23,6,17,
71,0,24,7,17,
72,0,23,6,17,
73,0,22,6,16,
74,0,25,7,18,
75,0,23,6,17,
76,0,24,7,17,
77,0,22,6,16,
78,0,21,6,15,
79,0,23,7,16,
80,0,27,8,19,
81,0,24,6,18,
82,0,24,6,18,
83,0,26,7,19,
84,0,23,6,17,
85,0,23,7,16,
86,0,23,6,17,
87,0,23,7,16,
88,0,22,6,16,
89,0,21,6,15,
90,0,25,7,18,
91,0,25,6,19,
92,0,23,6,17,
93,0,23,6,17,
94,0,23,7,16,
95,0,24,7,17,
96,0,24,6,18,
97,0,22,6,16,
98,0,24,7,17,
99,0,22,6,16,
100,0,23,7,16,
101,0,25,7,18,
102,0,23,7,16,
103,0,25,8,17,
104,0,23,6,17,
105,0,23,6,17,
106,0,21,6,15,
107,0,24,7,17,
108,0,23,6,17,
109,0,23,7,16,
110,0,23,6,17,
111,0,24,6,18,
112,0,24,7,17,
113,0,25,8,17,
114,0,24,6,18,
115,0,22,6,16,
116,0,24,7,17,
117,0,23,6,17,
118,0,23,7,16,
119,0,21,6,15,
120,0,24,7,17,
121,0,22,6,16,
122,0,21,6,15,
123,0,24,7,17,
124,0,22,6,16,
125,0,23,7,16,
126,0,23,6,17,
127,0,23,7,16,
128,0,24,7,17,
129,0,23,6,17,
130,0,22,6,16,
131,0,25,7,18,
132,0,23,6,17,
133,0,24,7,17,
134,0,22,6,16,
135,0,22,7,15,
136,0,23,7,16,
137,0,21,6,15,
138,0,25,7,18,
139,0,23,6,17,
140,0,25,9,16,
141,0,25,8,17,
142,0,22,6,16,
143,0,23,7,16,
144,0,24,7,17,
145,0,23,7,16,
146,0,24,6,18,
147,0,23,6,17,
148,0,22,6,16,
149,0,23,7,16,
150,0,24,7,17,
151,0,24,6,18,
152,0,22,6,16,
153,0,23,7,16,
154,0,23,6,17,
155,0,22,6,16,
156,0,24,7,17,
157,0,23,6,17,
158,0,25,7,18,
159,0,22,6,16,
160,0,25,7,18,
161,0,24,6,18,
162,0,23,6,17,
163,0,22,6,16,
164,0,22,7,15,
165,0,24,8,16,
166,0,24,6,18,
167,0,23,6,17,
168,0,25,7,18,
169,0,23,6,17,
170,0,23,7,16,
171,0,23,7,16,
172,0,25,8,17,
173,0,23,7,16,
174,0,24,7,17,
175,0,23,7,16,
176,0,23,6,17,
177,0,23,6,17,
178,0,23,7,16,
179,0,23,6,17,
180,0,23,7,16,
181,0,21,6,15,
182,0,22,7,15,
183,0,22,6,16,
184,0,22,7,15,
185,0,24,7,17,
186,0,23,6,17,
187,0,24,7,17,
188,0,22,6,16,
189,0,24,7,17,
190,0,24,6,18,
191,0,22,6,16,
192,0,24,7,17,
193,0,22,6,16,
194,0,25,8,17,
195,0,24,7,17,
196,0,23,6,17,
197,0,23,7,16,
198,0,23,6,17,
199,0,22,6,16,
200,0,25,7,18,
201,0,24,6,18,
202,0,24,8,16,
203,0,23,7,16,
204,0,21,6,15,
205,0,24,7,17,
206,0,22,6,16,
207,0,21,6,15,
208,0,25,8,17,
209,0,23,6,17,
210,0,23,7,16,
211,0,23,7,16,
212,0,24,7,17,
213,0,22,6,16,
214,0,25,7,18,
215,0,24,6,18,
216,0,23,6,17,
217,0,24,7,17,
218,0,22,6,16,
219,0,22,7,15,
220,0,23,7,16,
221,0,21,6,15,
222,0,24,7,17,
223,0,23,6,17,
224,0,24,7,17,
225,0,23,6,17,
226,0,23,7,16,
227,0,23,6,17,
228,0,25,7,18,
229,0,25,6,19,
230,0,23,6,17,
231,0,24,7,17,
232,0,22,7,15,
233,0,23,6,17,
234,0,25,7,18,
235,0,23,6,17,
236,0,24,7,17,
237,0,23,7,16,
238,0,23,6,17,
239,0,23,7,16,
240,0,21,6,15,
241,0,23,7,16,
242,0,23,6,17,
243,0,24,6,18,
244,0,22,6,16,
245,0,23,7,16,
246,0,23,6,17,
247,0,22,6,16,
248,0,24,7,17,
249,0,22,6,16,
250,0,25,7,18,
251,0,24,6,18,
252,0,27,7,20,
253,0,23,6,17,
254,0,23,6,17,
255,0,23,6,17,
256,0,23,7,16,
257,0,22,6,16,
258,0,21,6,15,
259,0,23,7,16,
260,0,21,6,15,
261,0,22,7,15,
262,0,22,6,16,
263,0,25,7,18,
264,0,25,6,19,
265,0,25,8,17,
266,0,24,6,18,
267,0,23,6,17,
268,0,23,7,16,
269,0,22,6,16,
270,0,22,7,15,
271,0,22,6,16,
272,0,22,6,16,
273,0,24,7,17,
274,0,24,6,18,
275,0,23,6,17,
276,0,25,7,18,
277,0,23,6,17,
278,0,23,7,16,
279,0,23,6,17,
280,0,22,6,16,
281,0,25,7,18,
282,0,23,6,17,
283,0,22,6,16,
284,0,24,7,17,
285,0,22,6,16,
286,0,23,7,16,
287,0,24,6,18,
288,0,23,6,17,
289,0,23,7,16,
290,0,22,6,16,
291,0,21,6,15,
292,0,23,8,15,
293,0,25,6,19,
294,0,23,6,17,
295,0,25,7,18,
296,0,23,7,16,
297,0,23,6,17,
298,0,21,6,15,
299,0,23,7,16,
300,0,24,7,17,
301,0,22,6,16,
302,0,23,7,16,
303,0,24,7,17,
304,0,25,7,18,
305,0,24,7,17,
306,0,22,6,16,
307,0,21,6,15,
308,0,23,7,16,
309,0,25,7,18,
310,0,21,6,15,
311,0,25,7,18,
312,0,25,6,19,
313,0,24,7,17,
314,0,23,7,16,
315,0,24,8,16,
316,0,24,7,17,
317,0,21,6,15,
318,0,23,7,16,
319,0,21,5,16,
320,0,24,7,17,
321,0,23,6,17,
322,0,25,8,17,
323,0,25,7,18,
324,0,23,6,17,
325,0,27,8,19,
326,0,26,7,19,
327,0,21,6,15,
328,0,25,7,18,
329,0,24,6,18,
330,0,24,6,18,
331,0,24,7,17,
332,0,23,6,17,
333,0,24,6,18,
334,0,22,6,16,
335,0,25,7,18,
336,0,23,6,17,
337,0,24,7,17,
338,0,22,6,16,
339,0,21,6,15,
340,0,22,7,15,
341,0,22,6,16,
342,0,21,6,15,
343,0,24,7,17,
344,0,23,7,16,
345,0,24,7,17,
346,0,23,7,16,
347,0,23,6,17,
348,0,23,6,17,
349,0,23,7,16,
350,0,24,6,18,
351,0,23,6,17,
352,0,25,8,17,
353,0,24,6,18,
354,0,24,7,17,
355,0,22,6,16,
356,0,23,7,16,
357,0,22,6,16,
358,0,21,6,15,
359,0,24,7,17,
360,0,24,6,18,
361,0,25,7,18,
362,0,23,6,17,
363,0,23,7,16,
364,0,24,7,17,
365,0,22,6,16,
366,0,26,7,19,
367,0,24,6,18,
368,0,23,6,17,
369,0,24,7,17,
370,0,22,6,16,
371,0,25,7,18,
372,0,23,6,17,
373,0,22,6,16,
374,0,25,7,18,
375,0,23,6,17,
376,0,22,6,16,
377,0,26,7,19,
378,0,24,6,18,
379,0,24,7,17,
380,0,23,7,16,
381,0,21,6,15,
382,0,26,7,19,
383,0,24,7,17,
384,0,23,7,16,
385,0,23,6,17,
386,0,24,7,17,
387,0,22,7,15,
388,0,23,7,16,
389,0,21,6,15,
390,0,23,7,16,
391,0,22,7,15,
392,0,23,6,17,
393,0,22,6,16,
394,0,24,7,17,
395,0,23,6,17,
396,0,22,6,16,
397,0,24,7,17,
398,0,22,6,16,
399,0,25,7,18,
400,0,24,6,18,
401,0,23,6,17,
402,0,23,7,16,
403,0,21,6,15,
404,0,24,7,17,
405,0,24,6,18,
406,0,23,7,16,
407,0,23,6,17,
408,0,23,7,16,
409,0,24,6,18,
410,0,23,6,17,
411,0,25,7,18,
412,0,23,6,17,
413,0,25,8,17,
414,0,22,6,16,
415,0,25,7,18,
416,0,24,7,17,
417,0,23,7,16,
418,0,24,7,17,
419,0,22,6,16,
420,0,25,7,18,
421,0,24,6,18,
422,0,24,7,17,
423,0,22,6,16,
424,0,22,6,16,
425,0,22,7,15,
426,0,22,6,16,
427,0,21,6,15,
428,0,24,7,17,
429,0,22,6,16,
430,0,23,7,16,
431,0,23,6,17,
432,0,22,6,16,
433,0,24,7,17,
434,0,24,6,18,
435,0,22,6,16,
436,0,23,7,16,
437,0,24,8,16,
438,0,22,7,15,
439,0,23,6,17,
440,0,23,7,16,
441,0,24,7,17,
442,0,23,6,17,
443,0,24,8,16,
444,0,24,7,17,
445,0,25,7,18,
446,0,22,6,16,
447,0,24,8,16,
448,0,23,6,17,
449,0,21,6,15,
450,0,26,7,19,
451,0,25,7,18,
452,0,23,6,17,
453,0,25,7,18,
454,0,22,6,16,
455,0,25,7,18,
456,0,25,6,19,
457,0,24,7,17,
458,0,24,6,18,
459,0,23,6,17,
460,0,24,7,17,
461,0,22,6,16,
462,0,21,6,15,
463,0,23,7,16,
464,0,21,6,15,
465,0,22,7,15,
466,0,23,6,17,
467,0,23,7,16,
468,0,24,7,17,
469,0,29,12,17,
470,0,30,13,17,
471,0,29,11,18,
472,0,29,12,17,
473,0,30,12,18,
474,0,30,13,17,
475,0,30,13,17,
476,0,30,13,17,
477,0,31,13,18,
478,0,32,13,19,
479,0,29,11,18,
480,0,30,12,18,
481,0,29,12,17,
482,0,30,12,18,
483,0,30,12,18,
484,0,30,13,17,
485,0,28,11,17,
486,0,30,13,17,
487,0,27,11,16,
488,0,30,13,17,
489,0,31,13,18,
490,0,28,12,16,
491,0,30,13,17,
492,0,30,12,18,
493,0,29,12,17,
494,0,29,12,17,
495,0,30,13,17,
496,0,27,10,17,
497,0,25,8,17,
498,0,23,6,17,
499,0,24,6,18,
500,0,22,6,16,
501,0,26,7,19,
502,0,24,6,18,
503,0,23,6,17,
504,0,25,8,17,
505,0,24,7,17,
506,0,23,6,17,
507,0,23,7,16,
508,0,24,7,17,
509,0,24,6,18,
510,0,26,7,19,
511,0,23,7,16,
512,0,25,7,18,
513,0,23,6,17,
514,0,22,7,15,
515,0,25,7,18,
516,0,24,7,17,
517,0,24,6,18,
518,0,23,6,17,
519,0,22,6,16,
520,0,22,7,15,
521,0,22,6,16,
522,0,21,6,15,
523,0,23,7,16,
524,0,26,7,19,
525,0,24,6,18,
526,0,24,7,17,
527,0,24,6,18,
528,0,24,6,18,
529,0,24,7,17,
530,0,25,7,18,
531,0,22,6,16,
532,0,24,7,17,
533,0,23,6,17,
534,0,24,6,18,
535,0,22,6,16,
536,0,26,8,18,
537,0,24,7,17,
538,0,24,7,17,
539,0,23,8,15,
540,0,23,6,17,
541,0,23,7,16,
542,0,23,7,16,
543,0,25,7,18,
544,0,24,6,18,
545,0,24,7,17,
546,0,22,6,16,
547,0,22,6,16,
548,0,22,6,16,
549,0,24,7,17,
550,0,23,6,17,
551,0,22,6,16,
552,0,24,7,17,
553,0,23,6,17,
554,0,23,7,16,
555,0,23,6,17,
556,0,25,7,18,
557,0,22,6,16,
558,0,25,7,18,
559,0,25,6,19,
560,0,24,6,18,
561,0,25,8,17,
562,0,25,8,17,
563,0,23,7,16,
564,0,21,6,15,
565,0,22,7,15,
566,0,23,7,16,
567,0,27,7,20,
568,0,25,7,18,
569,0,23,7,16,
570,0,24,7,17,
571,0,23,7,16,
572,0,24,7,17,
573,0,25,7,18,
574,0,23,6,17,
575,0,24,7,17,
576,0,22,6,16,
577,0,22,7,15,
578,0,23,7,16,
579,0,22,6,16,
580,0,22,7,15,
581,0,23,6,17,
582,0,22,6,16,
583,0,24,7,17,
584,0,23,6,17,
585,0,24,7,17,
586,0,22,6,16,
587,0,24,7,17,
588,0,24,7,17,
589,0,22,6,16,
590,0,21,6,15,
591,0,23,7,16,
592,0,22,6,16,
593,0,22,7,15,
594,0,24,6,18,
595,0,27,9,18,
596,0,23,7,16,
597,0,23,6,17,
598,0,25,8,17,
599,0,23,7,16,
600,0,23,7,16,
601,0,21,6,15,
602,0,22,7,15,
603,0,23,7,16,
604,0,22,7,15,
605,0,23,6,17,
606,0,24,7,17,
607,0,23,6,17,
608,0,25,8,17,
609,0,22,6,16,
610,0,25,7,18,
611,0,23,6,17,
612,0,23,7,16,
613,0,23,6,17,
614,0,24,6,18,
615,0,25,7,18,
616,0,24,6,18,
617,0,22,6,16,
618,0,24,7,17,
619,0,22,6,16,
620,0,24,7,17,
621,0,23,6,17,
622,0,24,8,16,
623,0,23,7,16,
624,0,21,6,15,
625,0,24,8,16,
626,0,23,7,16,
627,0,22,6,16,
628,0,26,9,17,
629,0,21,6,15,
630,0,22,7,15,
631,0,26,7,19,
632,0,24,6,18,
633,0,25,7,18,
634,0,22,6,16,
635,0,26,7,19,
636,0,24,7,17,
637,0,24,6,18,
638,0,22,6,16,
639,0,24,7,17,
640,0,24,6,18,
641,0,24,7,17,
642,0,24,6,18,
643,0,23,6,17,
644,0,23,6,17,
645,0,22,7,15,
646,0,22,6,16,
647,0,21,6,15,
648,0,21,7,14,
649,0,23,6,17,
650,0,23,7,16,
651,0,23,6,17,
652,0,22,6,16,
653,0,25,7,18,
654,0,23,6,17,
655,0,23,7,16,
656,0,24,6,18,
657,0,24,7,17,
658,0,23,6,17,
659,0,26,8,18,
660,0,24,6,18,
661,0,23,6,17,
662,0,26,7,19,
663,0,12,4,8,
668,0,17,4,13,
669,0,21,6,15,
670,0,22,7,15,
671,0,23,6,17,
672,0,24,6,18,
673,0,25,7,18,
674,0,23,6,17,
675,0,23,7,16,
676,0,23,6,17,
677,0,22,6,16,
678,0,23,7,16,
679,0,23,6,17,
680,0,22,6,16,
681,0,24,7,17,
682,0,22,6,16,
683,0,23,7,16,
684,0,24,6,18,
685,0,23,6,17,
686,0,27,9,18,
687,0,25,7,18,
688,0,23,6,17,
689,0,24,7,17,
690,0,25,7,18,
691,0,23,6,17,
692,0,24,7,17,
693,0,23,7,16,
694,0,23,7,16,
695,0,22,6,16,
696,0,24,7,17,
697,0,23,6,17,
698,0,23,7,16,
699,0,25,7,18,
700,0,23,6,17,
701,0,23,7,16,
702,0,22,6,16,
703,0,22,7,15,
704,0,22,6,16,
705,0,22,6,16,
706,0,22,7,15,
707,0,23,6,17,
708,0,24,7,17,
709,0,23,6,17,
710,0,24,6,18,
711,0,23,7,16,
712,0,23,6,17,
713,0,22,6,16,
714,0,26,7,19,
715,0,24,6,18,
716,0,25,8,17,
717,0,23,6,17,
718,0,23,7,16,
719,0,22,7,15,
720,0,22,6,16,
721,0,21,6,15,
722,0,24,7,17,
723,0,23,6,17,
724,0,24,7,17,
725,0,23,7,16,
726,0,23,6,17,
727,0,22,6,16,
728,0,23,7,16,
729,0,21,6,15,
730,0,23,7,16,
731,0,24,6,18,
732,0,23,6,17,
733,0,27,8,19,
734,0,24,6,18,
735,0,21,6,15,
736,0,23,7,16,
737,0,21,6,15,
738,0,24,7,17,
739,0,23,6,17,
740,0,23,7,16,
741,0,23,6,17,
742,0,23,6,17,
743,0,23,7,16,
744,0,24,7,17,
745,0,22,6,16,
746,0,24,7,17,
747,0,25,7,18,
748,0,22,6,16,
749,0,22,7,15,
750,0,22,7,15,
751,0,25,7,18,
752,0,23,6,17,
753,0,22,6,16,
754,0,23,7,16,
755,0,24,7,17,
756,0,23,6,17,
757,0,23,7,16,
758,0,25,7,18,
759,0,23,6,17,
760,0,24,7,17,
761,0,22,6,16,
762,0,21,6,15,
763,0,24,7,17,
764,0,22,6,16,
765,0,22,7,15,
766,0,23,6,17,
767,0,22,6,16,
768,0,24,7,17,
769,0,24,7,17,
770,0,23,6,17,
771,0,22,6,16,
772,0,23,7,16,
773,0,23,6,17,
774,0,24,6,18,
775,0,23,6,17,
776,0,23,7,16,
777,0,27,8,19,
778,0,24,7,17,
779,0,24,7,17,
780,0,26,8,18,
781,0,23,6,17,
782,0,22,6,16,
783,0,26,7,19,
784,0,24,6,18,
785,0,23,7,16,
786,0,25,8,17,
787,0,24,7,17,
788,0,24,6,18,
789,0,23,7,16,
790,0,22,6,16,
791,0,21,6,15,
792,0,23,7,16,
793,0,23,6,17,
794,0,23,7,16,
795,0,23,6,17,
796,0,22,6,16,
797,0,23,7,16,
798,0,24,6,18,
799,0,24,7,17,
800,0,23,7,16,
801,0,21,6,15,
802,0,23,7,16,
803,0,22,6,16,
804,0,21,6,15,
805,0,25,7,18,
806,0,23,6,17,
807,0,27,8,19,
808,0,23,6,17,
809,0,22,7,15,
810,0,21,6,15,
811,0,23,7,16,
812,0,22,6,16,
813,0,23,7,16,
814,0,25,7,18,
815,0,23,6,17,
816,0,22,6,16,
817,0,24,7,17,
818,0,24,6,18,
819,0,24,7,17,
820,0,24,6,18,
821,0,22,6,16,
822,0,24,7,17,
823,0,23,6,17,
824,0,24,6,18,
825,0,22,6,16,
826,0,25,7,18,
827,0,24,6,18,
828,0,23,6,17,
829,0,21,6,15,
830,0,23,7,16,
831,0,21,6,15,
832,0,25,7,18,
833,0,21,6,15,
834,0,22,6,16,
835,0,25,7,18,
836,0,24,6,18,
837,0,25,8,17,
838,0,24,6,18,
839,0,22,6,16,
840,0,24,7,17,
841,0,24,6,18,
842,0,25,8,17,
843,0,24,7,17,
844,0,22,6,16,
845,0,23,8,15,
846,0,22,6,16,
847,0,21,6,15,
848,0,24,7,17,
849,0,22,6,16,
850,0,24,7,17,
851,0,23,6,17,
852,0,22,6,16,
853,0,23,7,16,
854,0,23,6,17,
855,0,22,7,15,
856,0,25,7,18,
857,0,23,6,17,
858,0,25,7,18,
859,0,23,6,17,
860,0,22,6,16,
861,0,24,7,17,
862,0,21,6,15,
863,0,23,7,16,
864,0,23,6,17,
865,0,23,6,17,
866,0,22,6,16,
867,0,23,7,16,
868,0,27,9,18,
869,0,23,6,17,
870,0,25,7,18,
871,0,22,7,15,
872,0,23,7,16,
873,0,22,7,15,
874,0,22,6,16,
875,0,24,7,17,
876,0,21,6,15,
877,0,25,7,18,
878,0,24,6,18,
879,0,24,6,18,
880,0,22,6,16,
881,0,23,7,16,
882,0,23,6,17,
883,0,23,7,16,
884,0,25,7,18,
885,0,23,6,17,
886,0,24,7,17,
887,0,22,6,16,
888,0,21,6,15,
889,0,25,10,15,
890,0,25,10,15,
891,0,23,8,15,
892,0,28,12,16,
893,0,30,13,17,
894,0,26,8,18,
895,0,25,8,17,
896,0,24,8,16,
897,0,25,8,17,
898,0,25,9,16,
899,0,28,12,16,
900,0,26,10,16,
901,0,24,8,16,
902,0,28,11,17,
903,0,25,9,16,
904,0,30,13,17,
905,0,25,10,15,
906,0,28,13,15,
907,0,28,12,16,
908,0,29,13,16,
909,0,28,13,15,
910,0,28,12,16,
911,0,28,12,16,
912,0,29,13,16,
913,0,29,13,16,
914,0,32,12,19,1
915,0,24,6,18,
916,0,23,7,16,
917,0,23,6,17,
918,0,24,6,18,
919,0,22,6,16,
920,0,25,7,18,
921,0,23,7,16,
922,0,25,8,16,1
923,0,23,6,17,
924,0,23,6,17,
925,0,23,7,16,
926,0,23,6,17,
927,0,22,6,16,
928,0,24,7,17,
929,0,26,7,18,1
930,0,23,6,17,
931,0,25,9,16,
932,0,23,6,17,
933,0,24,7,17,
934,0,23,7,16,
935,0,23,5,18,
936,0,24,7,17,
937,0,25,7,18,
938,0,24,6,18,
939,0,23,7,16,
940,0,23,6,17,
941,0,22,6,16,
942,0,24,7,17,
943,0,23,7,16,
944,0,24,7,16,1
945,0,21,6,15,
946,0,24,7,17,
947,0,22,6,16,
948,0,21,6,15,
949,0,24,7,17,
950,0,24,6,18,
951,0,23,6,17,
952,0,24,7,17,
953,0,22,6,16,
954,0,24,7,17,
955,0,22,6,16,
956,0,23,7,16,
957,0,21,5,16,
958,0,24,8,16,
959,0,31,12,19,
960,0,31,12,18,1
961,0,29,13,16,
962,0,28,12,16,
963,0,30,13,17,
964,0,28,11,17,
965,0,30,13,17,
966,0,27,11,16,
967,0,29,13,16,
968,0,29,12,17,
969,0,30,12,18,
970,0,31,13,18,
971,0,29,12,17,
972,0,25,9,16,
973,0,23,7,16,
974,0,22,7,15,
975,0,24,7,17,
976,0,23,7,16,
977,0,23,6,17,
978,0,24,7,17,
979,0,24,6,18,
980,0,22,6,16,
981,0,23,7,16,
982,0,23,6,17,
983,0,24,7,17,
984,0,25,7,18,
985,0,23,6,17,
986,0,25,7,18,
987,0,24,6,18,
988,0,23,6,17,
989,0,23,7,16,
990,0,23,6,16,1
991,0,23,7,16,
992,0,23,7,16,
993,0,22,6,16,
994,0,23,6,17,
995,0,24,7,17,
996,0,23,6,17,
997,0,22,6,16,
998,0,24,7,17,
999,0,23,6,17,
1000,0,23,7,16,
1001,0,24,6,18,
1002,0,23,6,17,
1003,0,25,7,18,
1004,0,23,6,17,
1005,0,29,11,18,
1006,0,29,12,17,
1007,0,22,6,16,
1008,0,23,7,16,
1009,0,23,6,17,
1010,0,23,7,16,
1011,0,25,7,18,
1012,0,25,7,18,
1013,0,23,7,16,
1014,0,24,6,18,
1015,0,23,6,17,
1016,0,24,7,17,
1017,0,23,6,17,
1018,0,23,7,16,
1019,0,25,8,17,
1020,0,24,7,16,1
1021,0,23,6,17,
1022,0,22,6,16,
1023,0,23,7,16,
1024,0,23,7,16,
1025,0,21,6,15,
1026,0,24,7,17,
1027,0,23,8,15,
1028,0,25,6,19,
1029,0,24,7,17,
1030,0,24,6,18,
1031,0,24,7,17,
1032,0,22,6,16,
1033,0,22,6,16,
1034,0,24,7,17,
1035,0,22,7,15,
1036,0,24,7,17,
1037,0,22,6,16,
1038,0,24,7,17,
1039,0,23,6,17,
1040,0,23,7,16,
1041,0,22,6,16,
1042,0,24,6,18,
1043,0,24,7,17,
1044,0,23,7,16,
1045,0,23,6,17,
1046,0,22,6,16,
1047,0,25,7,18,
1048,0,24,6,18,
1049,0,25,8,17,
1050,0,24,7,17,
1051,0,26,7,18,1
1052,0,24,7,17,
1053,0,27,9,18,
1054,0,26,7,19,
1055,0,23,6,17,
1056,0,23,7,16,
1057,0,23,6,17,
1058,0,24,7,17,
1059,0,27,7,20,
1060,0,24,6,18,
1061,0,23,6,17,
1062,0,25,7,18,
1063,0,23,6,17,
1064,0,23,6,17,
1065,0,23,6,17,
1066,0,22,7,15,
1067,0,23,6,17,
1068,0,23,6,17,
1069,0,25,7,18,
1070,0,24,6,18,
1071,0,23,6,17,
1072,0,24,8,16,
1073,0,25,8,17,
1074,0,22,6,16,
1075,0,23,7,16,
1076,0,21,5,16,
1077,0,24,7,17,
1078,0,23,6,17,
1079,0,23,7,16,
1080,0,23,7,16,
1081,0,26,7,18,1
1082,0,22,6,16,
1083,0,23,8,15,
1084,0,22,7,15,
1085,0,22,6,16,
1086,0,22,6,16,
1087,0,24,6,18,
1088,0,24,7,17,
1089,0,23,7,16,
1090,0,22,6,16,
1091,0,24,7,17,
1092,0,22,6,16,
1093,0,23,7,16,
1094,0,24,6,18,
1095,0,23,6,17,
1096,0,24,7,17,
1097,0,24,6,18,
1098,0,24,7,17,
1099,0,23,6,17,
1100,0,22,6,16,
1101,0,24,7,17,
1102,0,23,6,17,
1103,0,22,6,16,
1104,0,26,8,18,
1105,0,23,6,17,
1106,0,24,7,17,
1107,0,23,6,17,
1108,0,23,6,17,
1109,0,21,6,15,
1110,0,24,8,16,
1111,0,25,7,17,1
1112,0,22,6,16,
1113,0,23,7,16,
1114,0,23,6,17,
1115,0,23,7,16,
1116,0,23,6,17,
1117,0,22,6,16,
1118,0,25,7,18,
1119,0,24,6,18,
1120,0,25,7,18,
1121,0,23,6,17,
1122,0,22,6,16,
1123,0,22,7,15,
1124,0,22,6,16,
1125,0,21,6,15,
1126,0,24,7,17,
1127,0,24,8,16,
1128,0,23,7,16,
1129,0,24,7,17,
1130,0,25,6,19,
1131,0,23,6,17,
1132,0,22,6,16,
1133,0,25,7,18,
1134,0,24,6,18,
1135,0,24,7,17,
1136,0,22,6,16,
1137,0,21,6,15,
1138,0,23,7,16,
1139,0,22,6,16,
1140,0,24,7,17,
1141,0,23,8,15,
1142,0,23,6,16,1
1143,0,23,7,16,
1144,0,25,8,17,
1145,0,25,8,17,
1146,0,22,6,16,
1147,0,23,7,16,
1148,0,22,7,15,
1149,0,23,6,17,
1150,0,22,6,16,
1151,0,22,7,15,
1152,0,23,6,17,
1153,0,23,6,17,
1154,0,23,6,17,
1155,0,23,6,17,
1156,0,25,7,18,
1157,0,24,6,18,
1158,0,23,7,16,
1159,0,22,6,16,
1160,0,22,7,15,
1161,0,22,6,16,
1162,0,21,6,15,
1163,0,25,8,17,
1164,0,22,6,16,
1165,0,23,7,16,
1166,0,22,6,16,
1167,0,23,6,17,
1168,0,23,6,17,
1169,0,23,7,16,
1170,0,24,6,18,
1171,0,23,6,17,
1172,0,24,7,16,1
1173,0,25,7,18,
1174,0,24,7,17,
1175,0,22,6,16,
1176,0,21,6,15,
1177,0,24,7,17,
1178,0,24,7,17,
1179,0,21,6,15,
1180,0,24,7,17,
1181,0,22,6,16,
1182,0,23,6,17,
1183,0,23,7,16,
1184,0,23,6,17,
1185,0,22,6,16,
1186,0,26,7,19,
1187,0,24,6,18,
1188,0,23,6,17,
1189,0,23,7,16,
1190,0,22,6,16,
1191,0,22,7,15,
1192,0,22,6,16,
1193,0,21,6,15,
1194,0,24,7,17,
1195,0,23,6,17,
1196,0,22,6,16,
1197,0,24,7,17,
1198,0,23,6,17,
1199,0,23,7,16,
1200,0,23,6,17,
1201,0,25,7,18,
1202,0,25,7,17,1
1203,0,22,6,16,
1204,0,22,7,15,
1205,0,26,8,18,
1206,0,21,6,15,
1207,0,23,7,16,
1208,0,23,7,16,
1209,0,22,6,16,
1210,0,24,7,17,
1211,0,22,6,16,
1212,0,23,6,17,
1213,0,23,7,16,
1214,0,26,7,19,
1215,0,24,6,18,
1216,0,24,6,18,
1217,0,24,7,17,
1218,0,22,6,16,
1219,0,22,6,16,
1220,0,25,7,18,
1221,0,29,12,17,
1222,0,28,12,16,
1223,0,28,13,15,
1224,0,28,12,16,
1225,0,29,13,16,
1226,0,30,13,17,
1227,0,26,11,15,
1228,0,29,12,17,
1229,0,27,11,16,
1230,0,28,12,16,
1231,0,27,11,16,
1232,0,28,12,16,
1233,0,30,13,16,1
1234,0,31,13,18,
1235,0,30,13,17,
1236,0,30,13,17,
1237,0,29,12,17,
1238,0,30,12,18,
1239,0,30,13,17,
1240,0,28,11,17,
1241,0,30,13,17,
1242,0,31,13,18,
1243,0,28,12,16,
1244,0,30,13,17,
1245,0,28,11,17,
1246,0,31,13,18,
1247,0,31,13,18,
1248,0,28,12,16,
1249,0,30,13,17,
1250,0,28,12,16,
1251,0,29,13,16,
1252,0,28,12,16,
1253,0,30,13,17,
1254,0,30,13,17,
1255,0,28,12,16,
1256,0,29,12,17,
1257,0,30,13,17,
1258,0,31,14,17,
1259,0,27,11,16,
1260,0,30,13,17,
1261,0,27,11,16,
1262,0,29,13,16,
1263,0,28,11,16,1
1264,0,30,13,17,
1265,0,30,12,18,
1266,0,29,13,16,
1267,0,29,12,17,
1268,0,30,13,17,
1269,0,29,12,17,
1270,0,28,12,16,
1271,0,30,13,17,
1272,0,30,13,17,
1273,0,28,12,16,
1274,0,29,12,17,
1275,0,28,12,16,
1276,0,31,13,18,
1277,0,28,12,16,
1278,0,30,13,17,
1279,0,29,12,17,
1280,0,30,13,17,
1281,0,28,12,16,
1282,0,26,11,15,
1283,0,24,7,17,
1284,0,22,7,15,
1285,0,24,6,18,
1286,0,24,6,18,
1287,0,25,7,18,
1288,0,23,6,17,
1289,0,24,6,18,
1290,0,22,6,16,
1291,0,23,7,16,
1292,0,24,6,18,
1293,0,25,7,17,1
1294,0,23,7,16,
1295,0,22,7,15,
1296,0,24,7,17,
1297,0,22,6,16,
1298,0,21,6,15,
1299,0,23,7,16,
1300,0,23,6,17,
1301,0,23,6,17,
1302,0,23,7,16,
1303,0,21,6,15,
1304,0,24,7,17,
1305,0,23,6,17,
1306,0,25,7,18,
1307,0,23,6,17,
1308,0,22,6,16,
1309,0,24,7,17,
1310,0,23,6,17,
1311,0,23,7,16,
1312,0,24,6,18,
1313,0,23,6,17,
1314,0,22,7,15,
1315,0,24,7,17,
1316,0,22,6,16,
1317,0,21,6,15,
1318,0,24,7,17,
1319,0,23,6,17,
1320,0,23,7,16,
1321,0,23,6,17,
1322,0,24,7,17,
1323,0,22,6,16,
1324,0,26,7,18,1
1325,0,24,7,17,
1326,0,22,6,16,
1327,0,24,7,17,
1328,0,24,6,18,
1329,0,24,7,17,
1330,0,23,6,17,
1331,0,23,7,16,
1332,0,21,6,15,
1333,0,24,8,16,
1334,0,22,6,16,
1335,0,22,6,16,
1336,0,25,7,18,
1337,0,23,6,17,
1338,0,23,7,16,
1339,0,24,7,17,
1340,0,22,6,16,
1341,0,25,7,18,
1342,0,23,6,17,
1343,0,22,6,16,
1344,0,26,7,19,
1345,0,26,7,19,
1346,0,23,6,17,
1347,0,22,6,16,
1348,0,22,7,15,
1349,0,22,6,16,
1350,0,21,6,15,
1351,0,24,7,17,
1352,0,24,7,17,
1353,0,23,6,17,
1354,0,25,7,17,1
1355,0,24,7,17,
1356,0,24,7,17,
1357,0,24,7,17,
1358,0,25,6,19,
1359,0,23,6,17,
1360,0,23,7,16,
1361,0,22,6,16,
1362,0,22,7,15,
1363,0,23,7,16,
1364,0,22,6,16,
1365,0,22,7,15,
1366,0,23,6,17,
1367,0,22,6,16,
1368,0,24,7,17,
1369,0,23,6,17,
1370,0,23,7,16,
1371,0,23,6,17,
1372,0,22,6,16,
1373,0,23,7,16,
1374,0,24,6,18,
1375,0,23,6,17,
1376,0,23,7,16,
1377,0,21,6,15,
1378,0,22,7,15,
1379,0,22,6,16,
1380,0,21,6,15,
1381,0,25,7,18,
1382,0,23,6,17,
1383,0,24,7,17,
1384,0,25,7,17,1
1385,0,22,6,16,
1386,0,25,7,18,
1387,0,23,6,17,
1388,0,24,6,18,
1389,0,23,6,17,
1390,0,25,7,18,
1391,0,23,6,17,
1392,0,21,6,15,
1393,0,23,7,16,
1394,0,21,6,15,
1395,0,22,7,15,
1396,0,23,6,17,
1397,0,22,6,16,
1398,0,23,7,16,
1399,0,24,7,17,
1400,0,25,7,18,
1401,0,23,6,17,
1402,0,25,6,19,
1403,0,23,6,17,
1404,0,23,7,16,
1405,0,24,7,17,
1406,0,23,6,17,
1407,0,22,7,15,
1408,0,24,7,17,
1409,0,22,6,16,
1410,0,21,6,15,
1411,0,25,7,18,
1412,0,23,7,16,
1413,0,24,8,16,
1414,0,23,6,17,
1415,0,25,7,17,1
1416,0,22,6,16,
1417,0,24,7,17,
1418,0,23,6,17,
1419,0,25,6,19,
1420,0,24,6,18,
1421,0,24,7,17,
1422,0,21,6,15,
1423,0,23,7,16,
1424,0,24,7,17,
1425,0,22,6,16,
1426,0,23,7,16,
1427,0,22,5,17,
1428,0,25,7,18,
1429,0,23,6,17,
1430,0,24,7,17,
1431,0,22,6,16,
1432,0,24,7,17,
1433,0,22,6,16,
1434,0,25,6,19,
1435,0,24,7,17,
1436,0,23,6,17,
1437,0,25,7,18,
1438,0,22,6,16,
1439,0,22,6,16,
1440,0,21,6,15,
1441,0,24,7,17,
1442,0,23,6,17,
1443,0,23,7,16,
1444,0,23,6,17,
1445,0,25,7,17,1
1446,0,23,6,17,
1447,0,25,7,18,
1448,0,26,9,17,
1449,0,24,7,17,
1450,0,24,6,18,
1451,0,23,7,16,
1452,0,21,6,15,
1453,0,24,7,17,
1454,0,22,6,16,
1455,0,24,7,17,
1456,0,23,6,17,
1457,0,22,6,16,
1458,0,25,7,18,
1459,0,23,6,17,
1460,0,22,6,16,
1461,0,25,7,18,
1462,0,23,6,17,
1463,0,24,7,17,
1464,0,22,6,16,
1465,0,21,6,15,
1466,0,24,7,17,
1467,0,23,7,16,
1468,0,22,6,16,
1469,0,23,7,16,
1470,0,23,6,17,
1471,0,23,7,16,
1472,0,24,7,17,
1473,0,22,6,16,
1474,0,26,7,19,
1475,0,24,6,18,
1476,0,24,6,17,1
1477,0,24,7,17,
1478,0,22,6,16,
1479,0,22,7,15,
1480,0,23,7,16,
1481,0,24,7,17,
1482,0,23,6,17,
1483,0,23,7,16,
1484,0,23,6,17,
1485,0,23,6,17,
1486,0,23,7,16,
1487,0,23,6,17,
1488,0,22,6,16,
1489,0,25,7,18,
1490,0,23,6,17,
1491,0,24,7,17,
1492,0,22,6,16,
1493,0,22,6,16,
1494,0,21,6,15,
1495,0,23,7,16,
1496,0,24,7,17,
1497,0,23,6,17,
1498,0,23,7,16,
1499,0,23,6,17,
1500,0,22,6,16,
1501,0,24,7,17,
1502,0,26,7,19,
1503,0,24,6,18,
1504,0,26,8,18,
1505,0,24,6,18,
1506,0,26,8,17,1
1507,0,23,7,16,
1508,0,24,7,17,
1509,0,22,6,16,
1510,0,21,6,15,
1511,0,24,7,17,
1512,0,23,6,17,
1513,0,24,7,17,
1514,0,23,6,17,
1515,0,23,6,17,
1516,0,26,8,18,
1517,0,23,6,17,
1518,0,25,6,19,
1519,0,23,6,17,
1520,0,23,7,16,
1521,0,22,6,16,
1522,0,21,6,15,
1523,0,23,7,16,
1524,0,21,6,15,
1525,0,22,7,15,
1526,0,23,6,17,
1527,0,24,7,17,
1528,0,22,6,16,
1529,0,22,6,16,
1530,0,25,7,18,
1531,0,23,6,17,
1532,0,22,6,16,
1533,0,24,7,17,
1534,0,25,7,18,
1535,0,23,7,16,
1536,0,24,7,16,1
1537,0,21,6,15,
1538,0,23,7,16,
1539,0,22,7,15,
1540,0,23,6,17,
1541,0,23,6,17,
1542,0,24,7,17,
1543,0,24,6,18,
1544,0,22,6,16,
1545,0,25,7,18,
1546,0,23,6,17,
1547,0,24,7,17,
1548,0,22,6,16,
1549,0,21,6,15,
1550,0,24,7,17,
1551,0,22,6,16,
1552,0,21,6,15,
1553,0,23,7,16,
1554,0,26,10,16,
1555,0,25,8,17,
1556,0,23,7,16,
1557,0,23,6,17,
1558,0,22,6,16,
1559,0,25,7,18,
1560,0,23,7,16,
1561,0,25,7,18,
1562,0,23,6,17,
1563,0,23,7,16,
1564,0,23,7,16,
1565,0,23,7,16,
1566,0,21,6,15,
1567,0,25,9,15,1
1568,0,26,8,18,
1569,0,21,5,16,
1570,0,24,7,17,
1571,0,25,7,18,
1572,0,26,8,18,
1573,0,24,7,17,
1574,0,25,6,19,
1575,0,23,6,17,
1576,0,23,7,16,
1577,0,22,6,16,
1578,0,22,7,15,
1579,0,22,6,16,
1580,0,21,6,15,
1581,0,24,7,17,
1582,0,22,6,16,
1583,0,23,7,16,
1584,0,23,6,17,
1585,0,22,6,16,
1586,0,23,7,16,
1587,0,24,7,17,
1588,0,22,6,16,
1589,0,24,6,18,
1590,0,23,7,16,
1591,0,22,6,16,
1592,0,22,7,15,
1593,0,21,6,15,
1594,0,24,7,17,
1595,0,25,10,15,
1596,0,22,6,16,
1597,0,25,7,17,1
1598,0,24,7,17,
1599,0,23,6,17,
1600,0,23,7,16,
1601,0,23,6,17,
1602,0,22,6,16,
1603,0,25,7,18,
1604,0,23,7,16,
1605,0,23,6,17,
1606,0,22,6,16,
1607,0,24,6,18,
1608,0,24,7,17,
1609,0,22,6,16,
1610,0,21,6,15,
1611,0,23,7,16,
1612,0,22,6,16,
1613,0,21,6,15,
1614,0,24,7,17,
1615,0,22,6,16,
1616,0,24,7,17,
1617,0,23,7,16,
1618,0,23,6,17,
1619,0,24,7,17,
1620,0,23,6,17,
1621,0,22,6,16,
1622,0,25,6,19,
1623,0,24,7,17,
1624,0,22,6,16,
1625,0,25,8,17,
1626,0,21,6,15,
1627,0,25,7,17,1
1628,0,22,6,16,
1629,0,22,7,15,
1630,0,22,6,16,
1631,0,25,7,18,
1632,0,23,6,17,
1633,0,22,6,16,
1634,0,24,7,17,
1635,0,22,6,16,
1636,0,23,6,17,
1637,0,25,7,18,
1638,0,24,6,18,
1639,0,24,7,17,
1640,0,21,5,16,
1641,0,24,7,17,
1642,0,22,6,16,
1643,0,22,7,15,
1644,0,23,6,17,
1645,0,22,6,16,
1646,0,24,7,17,
1647,0,25,7,18,
1648,0,23,6,17,
1649,0,22,6,16,
1650,0,25,7,18,
1651,0,24,6,18,
1652,0,22,6,16,
1653,0,23,7,16,
1654,0,24,6,18,
1655,0,23,6,17,
1656,0,23,7,16,
1657,0,21,6,15,
1658,0,26,8,17,1
1659,0,24,7,17,
1660,0,24,6,18,
1661,0,23,6,17,
1662,0,23,7,16,
1663,0,22,6,16,
1664,0,24,7,17,
1665,0,22,6,16,
1666,0,24,7,17,
1667,0,24,6,18,
1668,0,23,6,17,
1669,0,24,7,17,
1670,0,22,6,16,
1671,0,22,7,15,
1672,0,23,7,16,
1673,0,21,6,15,
1674,0,24,7,17,
1675,0,23,6,17,
1676,0,23,7,16,
1677,0,23,6,17,
1678,0,24,7,17,
1679,0,23,7,16,
1680,0,23,6,17,
1681,0,22,6,16,
1682,0,24,6,18,
1683,0,24,7,17,
1684,0,23,7,16,
1685,0,22,6,16,
1686,0,26,8,18,
1687,0,28,7,21,
1688,0,27,6,20,1
1689,0,28,7,21,
1690,0,27,7,20,
1691,0,30,6,24,
1692,0,31,7,24,
1693,0,32,7,25,
1694,0,33,6,27,
1695,0,33,6,27,
1696,0,37,7,30,
1697,0,35,6,29,
1698,0,35,6,29,
1699,0,36,7,29,
1700,0,38,7,31,
1701,0,38,7,31,
1702,0,38,6,32,
1703,0,38,6,32,
1704,0,40,7,33,
1705,0,40,6,34,
1706,0,39,6,33,
1707,0,42,7,35,
1708,0,40,6,34,
1709,0,42,7,35,
1710,0,42,6,36,
1711,0,42,6,36,
1712,0,44,7,37,
1713,0,43,6,37,
1714,0,45,7,38,
1715,0,45,7,38,
1716,0,46,8,38,
1717,0,47,7,40,
1718,0,47,6,40,1
1719,0,47,8,39,
1720,0,47,7,40,
1721,0,46,6,40,
1722,0,48,7,41,
1723,0,48,6,42,
1724,0,47,6,41,
1725,0,48,7,41,
1726,0,49,7,42,
1727,0,49,6,43,
1728,0,48,6,42,
1729,0,51,7,44,
1730,0,49,6,43,
1731,0,51,7,44,
1732,0,51,6,45,
1733,0,50,6,44,
1734,0,53,7,46,
1735,0,52,6,46,
1736,0,51,6,45,
1737,0,53,7,46,
1738,0,52,6,46,
1739,0,53,7,46,
1740,0,53,7,46,
1741,0,54,6,48,
1742,0,53,6,47,
1743,0,56,7,49,
1744,0,55,6,49,
1745,0,54,6,48,
1746,0,56,8,48,
1747,0,55,7,48,
1748,0,57,7,50,
1749,0,57,6,50,1
1750,0,57,7,50,
1751,0,58,8,50,
1752,0,57,6,51,
1753,0,57,7,50,
1754,0,58,7,51,
1755,0,57,6,51,
1756,0,59,7,52,
1757,0,58,6,52,
1758,0,59,7,52,
1759,0,59,6,53,
1760,0,58,6,52,
1761,0,60,7,53,
1762,0,60,7,53,
1763,0,61,7,54,
1764,0,59,6,53,
1765,0,62,7,55,
1766,0,61,6,55,
1767,0,61,7,54,
1768,0,61,6,55,
1769,0,60,6,54,
1770,0,64,7,57,
1771,0,62,6,56,
1772,0,61,6,55,
1773,0,63,7,56,
1774,0,63,6,57,
1775,0,63,7,56,
1776,0,64,7,57,
1777,0,65,9,56,
1778,0,65,7,58,
1779,0,66,7,58,1
1780,0,63,6,57,
1781,0,65,7,58,
1782,0,65,6,59,
1783,0,65,7,58,
1784,0,65,6,59,
1785,0,64,6,58,
1786,0,67,7,60,
1787,0,65,6,59,
1788,0,68,7,61,
1789,0,66,6,60,
1790,0,65,6,59,
1791,0,69,7,62,
1792,0,67,6,61,
1793,0,68,7,61,
1794,0,67,7,60,
1795,0,69,7,62,
1796,0,67,6,61,
1797,0,70,7,63,
1798,0,68,6,62,
1799,0,67,6,61,
1800,0,70,7,63,
1801,0,69,6,63,
1802,0,69,7,62,
1803,0,69,6,63,
1804,0,68,6,62,
1805,0,71,7,64,
1806,0,70,6,64,
1807,0,71,8,63,
1808,0,69,6,63,
1809,0,73,7,65,1
1810,0,72,7,65,
1811,0,71,6,65,
1812,0,71,7,64,
1813,0,71,6,65,
1814,0,71,6,65,
1815,0,74,8,66,
1816,0,72,7,65,
1817,0,72,6,66,
1818,0,71,6,65,
1819,0,74,7,67,
1820,0,73,6,67,
1821,0,73,7,66,
1822,0,73,6,67,
1823,0,74,7,67,
1824,0,73,6,67,
1825,0,75,7,68,
1826,0,74,6,68,
1827,0,74,7,67,
1828,0,75,7,68,
1829,0,74,6,68,
1830,0,76,7,69,
1831,0,74,6,68,
1832,0,77,7,70,
1833,0,75,6,69,
1834,0,75,6,69,
1835,0,78,7,71,
1836,0,76,6,70,
1837,0,78,8,70,
1838,0,75,6,69,
1839,0,78,7,71,
1840,0,76,6,70,
1841,0,80,8,72,
1842,0,77,6,71,
1843,0,76,6,70,
1844,0,78,7,71,
1845,0,78,6,72,
1846,0,78,7,71,
1847,0,78,6,72,
1848,0,77,6,71,
1849,0,79,7,72,
1850,0,79,6,73,
1851,0,80,7,73,
1852,0,79,7,72,
1853,0,80,7,73,
1854,0,78,6,72,
1855,0,81,7,74,
1856,0,80,6,74,
1857,0,80,7,73,
1858,0,80,6,74,
1859,0,80,6,74,
1860,0,81,7,74,
1861,0,80,7,73,
1862,0,81,6,75,
1863,0,80,6,74,
1864,0,83,8,75,
1865,0,81,7,74,
1866,0,81,7,74,
1867,0,82,8,74,
1868,0,82,7,75,
1869,0,83,7,76,
1870,0,82,6,76,
1871,0,83,7,76,
1872,0,82,7,75,
1873,0,83,7,76,
1874,0,81,6,75,
1875,0,85,8,77,
1876,0,82,6,76,
1877,0,83,7,76,
1878,0,82,6,76,
1879,0,73,6,67,
1880,0,62,7,55,
1881,0,56,7,49,
1882,0,53,6,47,
1883,0,48,7,41,
1884,0,42,6,36,
1885,0,38,6,32,
1886,0,37,6,31,
1887,0,44,7,37,
1888,0,49,6,43,
1889,0,58,7,51,
1890,0,54,6,48,
1891,0,58,7,51,
1892,0,56,6,50,
1893,0,55,6,49,
1894,0,58,7,51,
1895,0,57,6,51,
1896,0,57,7,50,
1897,0,58,7,51,
1898,0,59,7,52,
1899,0,59,7,52,
1900,0,57,6,51,
1901,0,60,7,53,
1902,0,58,6,52,
1903,0,59,7,52,
1904,0,62,7,55,
1905,0,61,7,54,
1906,0,60,7,53,
1907,0,62,7,55,
1908,0,60,6,54,
1909,0,62,7,55,
1910,0,62,6,56,
1911,0,61,6,55,
1912,0,63,7,56,
1913,0,62,6,56,
1914,0,63,7,56,
1915,0,63,6,57,
1916,0,62,6,56,
1917,0,65,7,58,
1918,0,64,6,58,
1919,0,64,7,57,
1920,0,64,6,58,
1921,0,67,7,60,
1922,0,65,6,59,
1923,0,65,7,58,
1924,0,65,6,59,
1925,0,65,6,59,
1926,0,67,7,60,
1927,0,66,6,60,
1928,0,69,8,61,
1929,0,68,7,61,
1930,0,66,6,60,
1931,0,68,7,61,
1932,0,68,7,61,
1933,0,68,6,62,
1934,0,67,6,61,
1935,0,69,7,62,
1936,0,72,10,62,
1937,0,69,7,62,
1938,0,69,6,63,
1939,0,69,7,62,
1940,0,71,7,64,
1941,0,69,6,63,
1942,0,71,7,64,
1943,0,69,6,63,
1944,0,73,7,66,
1945,0,71,6,65,
1946,0,70,6,64,
1947,0,73,7,66,
1948,0,72,6,66,
1949,0,72,7,65,
1950,0,72,6,66,
1951,0,71,6,65,
1952,0,73,7,66,
1953,0,73,6,67,
1954,0,73,7,66,
1955,0,73,6,67,
1956,0,72,6,66,
1957,0,75,7,68,
1958,0,75,7,68,
1959,0,77,8,69,
1960,0,75,6,69,
1961,0,74,6,68,
1962,0,75,7,68,
1963,0,76,7,69,
1964,0,74,6,68,
1965,0,75,7,68,
1966,0,77,7,70,
1967,0,76,6,70,
1968,0,79,7,72,
1969,0,77,7,70,
1970,0,77,6,71,
1971,0,77,7,70,
1972,0,77,6,71,
1973,0,77,6,71,
1974,0,77,7,70,
1975,0,78,6,72,
1976,0,77,6,71,
1977,0,79,7,72,
1978,0,77,6,71,
1979,0,81,7,74,
1980,0,79,6,73,
1981,0,80,7,73,
1982,0,78,6,72,
1983,0,79,7,72,
1984,0,80,6,74,
1985,0,80,7,73,
1986,0,81,7,74,
1987,0,79,6,73,
1988,0,81,7,74,
1989,0,81,6,75,
1990,0,81,7,74,
1991,0,82,7,75,
1992,0,81,6,75,
1993,0,82,7,75,
1994,0,83,7,76,
1995,0,81,6,75,
1996,0,83,7,76,
1997,0,81,6,75,
1998,0,83,7,76,
1999,0,81,6,75,
2000,0,83,7,76,
2001,0,82,6,76,
2002,0,82,7,75,
2003,0,82,6,76,
2004,0,81,6,75,
2005,0,70,7,63,
2006,0,58,7,51,
2007,0,53,6,47,
2008,0,50,6,44,
2009,0,44,7,37,
2010,0,34,6,28,
2011,0,26,6,20,
2012,0,24,7,17,
2013,0,26,6,20,
2014,0,40,7,33,
2015,0,39,6,33,
2016,0,40,7,33,
2017,0,41,6,35,
2018,0,40,6,34,
2019,0,43,7,36,
2020,0,43,7,36,
2021,0,42,6,36,
2022,0,43,7,36,
2023,0,45,7,38,
2024,0,44,6,38,
2025,0,45,7,38,
2026,0,45,6,39,
2027,0,46,7,39,
2028,0,46,7,39,
2029,0,47,6,41,
2030,0,47,7,40,
2031,0,49,7,42,
2032,0,47,6,41,
2033,0,50,7,43,
2034,0,49,6,43,
2035,0,48,6,42,
2036,0,51,7,44,
2037,0,50,6,44,
2038,0,50,7,43,
2039,0,51,6,45,
2040,0,50,6,44,
2041,0,53,7,46,
2042,0,51,6,45,
2043,0,54,7,47,
2044,0,53,6,47,
2045,0,52,6,46,
2046,0,55,7,48,
2047,0,54,6,48,
2048,0,54,7,47,
2049,0,56,8,48,
2050,0,55,7,48,
2051,0,57,8,49,
2052,0,58,7,51,
2053,0,55,6,49,
2054,0,58,9,49,
2055,0,58,7,51,
2056,0,57,6,51,
2057,0,58,7,51,
2058,0,58,7,51,
2059,0,58,6,52,
2060,0,57,6,51,
2061,0,61,7,54,
2062,0,59,6,53,
2063,0,58,6,52,
2064,0,61,7,54,
2065,0,59,6,53,
2066,0,60,7,53,
2067,0,60,6,54,
2068,0,61,7,54,
2069,0,62,7,55,
2070,0,61,6,55,
2071,0,62,7,55,
2072,0,63,7,56,
2073,0,61,6,55,
2074,0,63,7,56,
2075,0,63,6,57,
2076,0,63,7,56,
2077,0,63,6,57,
2078,0,63,6,57,
2079,0,66,7,59,
2080,0,64,6,58,
2081,0,64,7,57,
2082,0,65,6,59,
2083,0,65,7,58,
2084,0,66,7,59,
2085,0,65,6,59,
2086,0,66,7,59,
2087,0,67,7,60,
2088,0,66,7,59,
2089,0,68,7,61,
2090,0,67,7,60,
2091,0,67,6,61,
2092,0,66,6,60,
2093,0,69,7,62,
2094,0,67,6,61,
2095,0,68,7,61,
2096,0,68,6,62,
2097,0,70,7,63,
2098,0,69,6,63,
2099,0,69,7,62,
2100,0,69,6,63,
2101,0,70,7,63,
2102,0,71,7,64,
2103,0,69,6,63,
2104,0,72,7,65,
2105,0,71,6,65,
2106,0,70,6,64,
2107,0,72,7,65,
2108,0,71,6,65,
2109,0,72,7,65,
2110,0,72,6,66,
2111,0,72,7,65,
2112,0,73,7,66,
2113,0,75,7,68,
2114,0,73,6,67,
2115,0,74,7,67,
2116,0,72,6,66,
2117,0,74,7,67,
2118,0,74,7,67,
2119,0,74,6,68,
2120,0,74,7,67,
2121,0,75,7,68,
2122,0,75,6,69,
2123,0,76,7,69,
2124,0,74,6,68,
2125,0,76,7,69,
2126,0,74,6,68,
2127,0,77,7,70,
2128,0,76,7,69,
2129,0,76,6,70,
2130,0,75,6,69,
2131,0,79,7,72,
2132,0,77,6,71,
2133,0,78,7,71,
2134,0,76,6,70,
2135,0,78,7,71,
2136,0,78,6,72,
2137,0,78,7,71,
2138,0,78,6,72,
2139,0,77,6,71,
2140,0,81,8,73,
2141,0,79,7,72,
2142,0,79,7,72,
2143,0,78,6,72,
2144,0,81,8,73,
2145,0,79,6,73,
2146,0,80,7,73,
2147,0,80,6,74,
2148,0,80,7,73,
2149,0,82,7,75,
2150,0,81,6,75,
2151,0,83,8,75,
2152,0,80,6,74,
2153,0,82,7,75,
2154,0,80,6,74,
2155,0,82,7,75,
2156,0,82,6,76,
2157,0,81,6,75,
2158,0,84,7,77,
2159,0,82,6,76,
2160,0,82,7,75,
2161,0,82,6,76,
2162,0,81,6,75,
2163,0,82,7,75,
2164,0,82,7,75,
2165,0,80,6,74,
2166,0,68,6,62,
2167,0,58,7,51,
2168,0,53,6,47,
2169,0,50,6,44,
2170,0,43,6,37,
2171,0,33,7,26,
2172,0,27,7,20,
2173,0,22,6,16,
2174,0,31,8,23,
2175,0,39,6,33,
2176,0,39,6,33,
2177,0,41,7,34,
2178,0,42,7,35,
2179,0,41,7,34,
2180,0,42,6,36,
2181,0,41,6,35,
2182,0,44,7,37,
2183,0,43,6,37,
2184,0,44,7,37,
2185,0,44,6,38,
2186,0,45,6,39,
2187,0,45,7,38,
2188,0,46,6,40,
2189,0,45,6,39,
2190,0,48,7,41,
2191,0,46,6,40,
2192,0,48,7,41,
2193,0,48,7,41,
2194,0,47,6,41,
2195,0,51,7,44,
2196,0,49,6,43,
2197,0,49,6,43,
2198,0,51,7,44,
2199,0,49,6,43,
2200,0,53,7,46,
2201,0,51,7,44,
2202,0,52,6,46,
2203,0,51,6,45,
2204,0,53,7,46,
2205,0,53,7,46,
2206,0,53,7,46,
2207,0,55,7,48,
2208,0,53,6,47,
2209,0,55,8,47,
2210,0,55,6,49,
2211,0,54,6,48,
2212,0,56,7,49,
2213,0,58,7,51,
2214,0,56,6,50,
2215,0,55,6,49,
2216,0,58,7,51,
2217,0,57,6,51,
2218,0,57,7,50,
2219,0,58,6,52,
2220,0,57,6,51,
2221,0,59,7,52,
2222,0,59,6,53,
2223,0,58,6,52,
2224,0,60,7,53,
2225,0,58,6,52,
2226,0,60,7,53,
2227,0,60,6,54,
2228,0,59,6,53,
2229,0,62,7,55,
2230,0,60,6,54,
2231,0,63,8,55,
2232,0,61,6,55,
2233,0,63,7,56,
2234,0,64,8,56,
2235,0,62,7,55,
2236,0,63,6,57,
2237,0,62,6,56,
2238,0,64,7,57,
2239,0,66,8,58,
2240,0,64,6,58,
2241,0,65,7,58,
2242,0,63,6,57,
2243,0,65,7,58,
2244,0,65,6,59,
2245,0,65,7,58,
2246,0,67,7,60,
2247,0,65,6,59,
2248,0,68,7,61,
2249,0,66,6,60,
2250,0,66,6,60,
2251,0,69,7,62,
2252,0,67,6,61,
2253,0,68,7,61,
2254,0,67,6,61,
2255,0,69,7,62,
2256,0,67,6,61,
2257,0,68,7,61,
2258,0,69,6,63,
2259,0,68,6,62,
2260,0,71,7,64,
2261,0,69,6,63,
2262,0,70,7,63,
2263,0,71,7,64,
2264,0,69,6,63,
2265,0,71,7,64,
2266,0,71,7,64,
2267,0,71,6,65,
2268,0,70,6,64,
2269,0,72,7,65,
2270,0,72,7,65,
2271,0,73,7,66,
2272,0,71,6,65,
2273,0,73,7,66,
2274,0,72,6,66,
2275,0,74,8,66,
2276,0,73,6,67,
2277,0,72,6,66,
2278,0,75,7,68,
2279,0,74,6,68,
2280,0,73,6,67,
2281,0,75,7,68,
2282,0,74,6,68,
2283,0,75,7,68,
2284,0,75,6,69,
2285,0,74,6,68,
2286,0,76,7,69,
2287,0,75,6,69,
2288,0,75,6,69,
2289,0,77,7,70,
2290,0,75,6,69,
2291,0,76,7,69,
2292,0,77,6,71,
2293,0,78,7,71,
2294,0,76,6,70,
2295,0,79,8,71,
2296,0,78,7,71,
2297,0,77,6,71,
2298,0,79,7,72,
2299,0,78,6,72,
2300,0,78,7,71,
2301,0,78,6,72,
2302,0,78,6,72,
2303,0,80,7,73,
2304,0,79,6,73,
2305,0,79,7,72,
2306,0,80,6,74,
2307,0,80,6,74,
2308,0,80,7,73,
2309,0,80,7,73,
2310,0,80,7,73,
2311,0,82,7,75,
2312,0,81,6,75,
2313,0,81,7,74,
2314,0,81,6,75,
2315,0,82,7,75,
2316,0,82,6,76,
2317,0,82,7,75,
2318,0,82,6,76,
2319,0,81,6,75,
2320,0,83,7,76,
2321,0,82,6,76,
2322,0,83,8,75,
2323,0,88,13,75,
2324,0,87,12,75,
2325,0,89,13,76,
2326,0,89,12,77,
2327,0,80,13,67,
2328,0,68,12,56,
2329,0,62,12,50,
2330,0,58,10,48,
2331,0,49,7,42,
2332,0,41,5,36,
2333,0,38,7,31,
2334,0,40,7,33,
2335,0,43,6,37,
2336,0,54,8,46,
2337,0,54,6,48,
2338,0,56,7,49,
2339,0,56,7,49,
2340,0,57,7,50,
2341,0,55,6,49,
2342,0,59,7,52,
2343,0,57,6,51,
2344,0,56,6,50,
2345,0,59,7,52,
2346,0,58,7,51,
2347,0,58,6,52,
2348,0,58,6,52,
2349,0,60,7,53,
2350,0,58,6,52,
2351,0,59,7,52,
2352,0,60,6,54,
2353,0,62,7,55,
2354,0,60,7,53,
2355,0,61,6,55,
2356,0,60,6,54,
2357,0,61,7,54,
2358,0,64,8,56,
2359,0,62,6,56,
2360,0,62,7,55,
2361,0,64,7,57,
2362,0,63,6,57,
2363,0,63,7,56,
2364,0,63,6,57,
2365,0,63,6,57,
2366,0,65,7,58,
2367,0,64,6,58,
2368,0,64,7,57,
2369,0,65,6,59,
2370,0,65,6,59,
2371,0,65,7,58,
2372,0,66,6,60,
2373,0,65,6,59,
2374,0,67,7,60,
2375,0,65,6,59,
2376,0,67,7,60,
2377,0,67,6,61,
2378,0,66,6,60,
2379,0,69,7,62,
2380,0,68,6,62,
2381,0,67,6,61,
2382,0,69,7,62,
2383,0,68,7,61,
2384,0,71,7,64,
2385,0,69,6,63,
2386,0,70,7,63,
2387,0,68,6,62,
2388,0,72,7,65,
2389,0,70,6,64,
2390,0,69,6,63,
2391,0,71,7,64,
2392,0,70,6,64,
2393,0,71,7,64,
2394,0,71,6,65,
2395,0,70,6,64,
2396,0,73,7,66,
2397,0,72,6,66,
2398,0,71,6,65,
2399,0,73,8,65,
2400,0,75,8,67,
2401,0,73,6,67,
2402,0,73,7,66,
2403,0,73,6,67,
2404,0,72,6,66,
2405,0,75,7,68,
2406,0,74,6,68,
2407,0,73,6,67,
2408,0,75,7,68,
2409,0,75,6,69,
2410,0,75,7,68,
2411,0,75,6,69,
2412,0,74,6,68,
2413,0,77,8,69,
2414,0,77,7,70,
2415,0,76,6,70,
2416,0,77,7,70,
2417,0,75,6,69,
2418,0,80,9,71,
2419,0,77,7,70,
2420,0,77,6,71,
2421,0,78,7,71,
2422,0,78,7,71,
2423,0,78,6,72,
2424,0,78,7,71,
2425,0,78,6,72,
2426,0,78,6,72,
2427,0,78,6,72,
2428,0,80,7,73,
2429,0,79,6,73,
2430,0,79,7,72,
2431,0,79,6,73,
2432,0,79,6,73,
2433,0,81,7,74,
2434,0,80,6,74,
2435,0,81,7,74,
2436,0,81,7,74,
2437,0,81,6,75,
2438,0,81,7,74,
2439,0,81,6,75,
2440,0,80,6,74,
2441,0,82,7,75,
2442,0,81,6,75,
2443,0,83,7,76,
2444,0,82,6,76,
2445,0,83,7,76,
2446,0,82,6,76,
2447,0,83,7,76,
2448,0,81,6,75,
2449,0,83,7,76,
2450,0,81,6,75,
2451,0,85,8,77,
2452,0,80,6,74,
2453,0,68,6,62,
2454,0,58,7,51,
2455,0,53,6,47,
2456,0,49,6,43,
2457,0,43,6,37,
2458,0,33,7,26,
2459,0,26,6,20,
2460,0,22,6,16,
2461,0,29,7,22,
2462,0,39,7,32,
2463,0,40,6,34,
2464,0,39,6,33,
2465,0,42,7,35,
2466,0,41,6,35,
2467,0,42,7,35,
2468,0,43,7,36,
2469,0,42,6,36,
2470,0,45,7,38,
2471,0,44,6,38,
2472,0,43,6,37,
2473,0,47,7,40,
2474,0,46,7,39,
2475,0,46,6,40,
2476,0,45,6,39,
2477,0,47,7,40,
2478,0,49,8,41,
2479,0,49,7,42,
2480,0,48,6,42,
2481,0,48,6,42,
2482,0,51,7,44,
2483,0,49,6,43,
2484,0,49,6,43,
2485,0,52,8,44,
2486,0,53,9,44,
2487,0,51,6,45,
2488,0,50,6,44,
2489,0,53,7,46,
2490,0,52,6,46,
2491,0,51,6,45,
2492,0,54,7,47,
2493,0,53,6,47,
2494,0,54,7,47,
2495,0,54,6,48,
2496,0,55,7,48,
2497,0,54,6,48,
2498,0,57,7,50,
2499,0,55,6,49,
2500,0,55,6,49,
2501,0,58,7,51,
2502,0,56,6,50,
2503,0,57,7,50,
2504,0,57,7,50,
2505,0,58,7,51,
2506,0,58,6,52,
2507,0,59,7,52,
2508,0,58,7,51,
2509,0,60,7,53,
2510,0,59,6,53,
2511,0,59,7,52,
2512,0,60,7,53,
2513,0,60,7,53,
2514,0,62,7,55,
2515,0,60,6,54,
2516,0,61,7,54,
2517,0,61,6,55,
2518,0,60,6,54,
2519,0,64,7,57,
2520,0,62,6,56,
2521,0,61,6,55,
2522,0,64,7,57,
2523,0,64,7,57,
2524,0,63,7,56,
2525,0,63,6,57,
2526,0,63,6,57,
2527,0,65,7,58,
2528,0,64,6,58,
2529,0,63,6,57,
2530,0,66,7,59,
2531,0,65,6,59,
2532,0,65,7,58,
2533,0,66,6,60,
2534,0,65,6,59,
2535,0,67,7,60,
2536,0,65,6,59,
2537,0,67,7,60,
2538,0,66,6,60,
2539,0,68,7,61,
2540,0,67,6,61,
2541,0,68,7,61,
2542,0,69,7,62,
2543,0,67,6,61,
2544,0,69,7,62,
2545,0,69,6,63,
2546,0,69,7,62,
2547,0,68,6,62,
2548,0,71,7,64,
2549,0,70,6,64,
2550,0,70,7,63,
2551,0,71,7,64,
2552,0,69,6,63,
2553,0,72,7,65,
2554,0,71,6,65,
2555,0,71,7,64,
2556,0,71,6,65,
2557,0,72,6,66,
2558,0,72,7,65,
2559,0,72,6,66,
2560,0,71,6,65,
2561,0,74,7,67,
2562,0,73,6,67,
2563,0,73,7,66,
2564,0,73,6,67,
2565,0,72,6,66,
2566,0,76,7,69,
2567,0,74,6,68,
2568,0,75,7,68,
2569,0,73,6,67,
2570,0,77,7,70,
2571,0,74,6,68,
2572,0,77,8,69,
2573,0,75,6,69,
2574,0,75,7,68,
2575,0,76,6,70,
2576,0,76,6,70,
2577,0,76,7,69,
2578,0,76,6,70,
2579,0,76,6,70,
2580,0,78,7,71,
2581,0,76,6,70,
2582,0,78,7,71,
2583,0,77,6,71,
2584,0,78,7,71,
2585,0,78,6,72,
2586,0,79,7,72,
2587,0,79,7,72,
2588,0,78,6,72,
2589,0,80,7,73,
2590,0,79,6,73,
2591,0,79,7,72,
2592,0,79,6,73,
2593,0,80,7,73,
2594,0,80,6,74,
2595,0,85,11,74,
2596,0,86,12,74,
2597,0,85,12,73,
2598,0,88,13,75,
2599,0,87,13,74,
2600,0,86,12,74,
2601,0,87,13,74,
2602,0,88,13,75,
2603,0,89,13,76,
2604,0,88,13,75,
2605,0,88,12,76,
2606,0,89,13,76,
2607,0,89,13,76,
2608,0,88,12,76,
2609,0,90,13,77,
2610,0,88,12,76,
2611,0,88,12,76,
2612,0,88,12,76,
2613,0,89,12,77,
2614,0,88,12,76,
2615,0,88,13,75,
2616,0,88,12,76,
2617,0,89,13,76,
2618,0,89,12,77,
2619,0,81,12,69,
2620,0,71,13,58,
2621,0,61,13,48,
2622,0,61,13,48,
2623,0,55,12,43,
2624,0,49,11,38,
2625,0,48,13,35,
2626,0,49,13,36,
2627,0,54,13,41,
2628,0,61,13,48,
2629,0,60,12,48,
2630,0,61,12,49,
2631,0,62,13,49,
2632,0,63,13,50,
2633,0,63,13,50,
2634,0,63,13,50,
2635,0,63,13,50,
2636,0,65,13,52,
2637,0,65,13,52,
2638,0,64,13,51,
2639,0,65,12,53,
2640,0,66,13,53,
2641,0,65,13,52,
2642,0,65,13,52,
2643,0,67,13,54,
2644,0,67,13,54,
2645,0,65,12,53,
2646,0,66,12,54,
2647,0,68,13,55,
2648,0,68,13,55,
2649,0,68,13,55,
2650,0,68,12,56,
2651,0,69,13,56,
2652,0,68,13,55,
2653,0,69,13,56,
2654,0,70,13,57,
2655,0,69,12,57,
2656,0,70,13,57,
2657,0,70,13,57,
2658,0,70,12,58,
2659,0,71,13,58,
2660,0,72,13,59,
2661,0,70,12,58,
2662,0,72,13,59,
2663,0,71,13,58,
2664,0,72,13,59,
2665,0,72,13,59,
2666,0,73,13,60,
2667,0,74,13,61,
2668,0,73,13,60,
2669,0,73,12,61,
2670,0,74,13,61,
2671,0,75,13,62,
2672,0,73,12,61,
2673,0,75,13,62,
2674,0,74,13,61,
2675,0,75,13,62,
2676,0,73,11,62,
2677,0,76,13,63,
2678,0,76,13,63,
2679,0,76,13,63,
2680,0,76,12,64,
2681,0,76,12,64,
2682,0,68,13,55,
2683,0,54,12,42,
2684,0,42,12,30,
2685,0,30,13,17,
