window-id,queue-size-CL,queue-size-LL,10.0.0.13:49328 -> 10.0.1.13:3000,10.0.1.13:3000 -> 10.0.0.13:49328,10.0.0.13:56198 -> 10.0.1.13:1000
0,0,39,11,28,
1,0,35,9,26,
2,0,34,10,24,
3,0,31,9,22,
4,0,29,8,21,
5,0,27,8,19,
6,0,26,8,18,
7,0,25,8,17,
8,0,29,12,17,
9,0,30,12,18,
10,0,29,13,16,
11,0,29,12,17,
12,0,29,13,16,
13,0,31,13,18,
14,0,27,11,16,
15,0,30,13,17,
16,0,28,12,16,
17,0,29,13,16,
18,0,30,12,18,
19,0,32,14,18,
20,0,28,11,17,
21,0,30,13,17,
22,0,30,14,16,
23,0,28,12,16,
24,0,28,11,17,
25,0,29,13,16,
26,0,27,12,15,
27,0,28,12,16,
28,0,29,13,16,
29,0,28,13,15,
30,0,28,12,16,
31,0,27,12,15,
32,0,29,13,16,
33,0,28,13,15,
34,0,29,13,16,
35,0,29,12,17,
36,0,30,13,17,
37,0,31,13,18,
38,0,28,11,17,
39,0,30,13,17,
40,0,29,12,17,
41,0,29,12,17,
42,0,30,13,17,
43,0,32,13,19,
44,0,29,11,18,
45,0,31,13,18,
46,0,29,12,17,
47,0,28,11,17,
48,0,29,12,17,
49,0,31,13,18,
50,0,29,11,18,
51,0,31,13,18,
52,0,30,12,18,
53,0,30,13,17,
54,0,31,13,18,
55,0,31,13,18,
56,0,31,13,18,
57,0,27,11,16,
58,0,29,13,16,
59,0,30,13,17,
60,0,30,13,17,
61,0,29,13,16,
62,0,28,12,16,
63,0,30,13,17,
64,0,30,13,17,
65,0,29,13,16,
66,0,28,12,16,
67,0,31,14,17,
68,0,32,14,18,
69,0,30,13,17,
70,0,30,13,17,
71,0,29,12,17,
72,0,31,13,18,
73,0,31,13,18,
74,0,28,11,17,
75,0,31,13,18,
76,0,27,11,16,
77,0,29,13,16,
78,0,25,8,17,
79,0,22,7,15,
80,0,24,7,17,
81,0,23,6,17,
82,0,26,7,19,
83,0,24,6,18,
84,0,24,7,17,
85,0,23,7,16,
86,0,24,7,17,
87,0,22,6,16,
88,0,22,6,16,
89,0,21,6,15,
90,0,24,7,17,
91,0,23,6,17,
92,0,22,6,16,
93,0,23,7,16,
94,0,22,6,16,
95,0,24,7,17,
96,0,23,6,17,
97,0,23,7,16,
98,0,24,6,18,
99,0,23,6,17,
100,0,24,7,17,
101,0,22,6,16,
102,0,21,6,15,
103,0,23,7,16,
104,0,22,6,16,
105,0,22,7,15,
106,0,23,6,17,
107,0,22,6,16,
108,0,25,8,17,
109,0,23,6,17,
110,0,22,6,16,
111,0,23,7,16,
112,0,24,6,18,
113,0,24,7,17,
114,0,24,7,17,
115,0,24,6,18,
116,0,22,6,16,
117,0,24,7,17,
118,0,23,6,17,
119,0,22,6,16,
120,0,25,7,18,
121,0,22,6,16,
122,0,23,7,16,
123,0,25,6,19,
124,0,24,7,17,
125,0,24,7,17,
126,0,25,7,18,
127,0,25,6,19,
128,0,24,6,18,
129,0,23,7,16,
130,0,23,6,17,
131,0,24,7,17,
132,0,23,7,16,
133,0,25,8,17,
134,0,23,6,17,
135,0,24,6,18,
136,0,23,6,17,
137,0,24,7,17,
138,0,25,8,17,
139,0,23,7,16,
140,0,22,6,16,
141,0,23,6,17,
142,0,29,12,17,
143,0,29,13,16,
144,0,30,14,16,
145,0,29,12,17,
146,0,29,13,16,
147,0,32,13,19,
148,0,30,11,19,
149,0,31,13,18,
150,0,30,13,17,
151,0,27,12,15,
152,0,29,13,16,
153,0,26,11,15,
154,0,28,13,15,
155,0,29,13,16,
156,0,29,13,16,
157,0,29,13,16,
158,0,27,11,16,
159,0,31,13,18,
160,0,29,12,17,
161,0,30,13,17,
162,0,29,13,16,
163,0,28,12,16,
164,0,30,13,17,
165,0,29,12,17,
166,0,29,13,16,
167,0,28,12,16,
168,0,28,10,18,
169,0,24,7,17,
170,0,24,7,17,
171,0,24,6,18,
172,0,24,7,17,
173,0,24,6,18,
174,0,26,7,19,
175,0,23,7,16,
176,0,24,7,17,
177,0,24,7,17,
178,0,22,6,16,
179,0,25,7,18,
180,0,22,6,16,
181,0,23,6,17,
182,0,22,6,16,
183,0,26,7,19,
184,0,24,7,17,
185,0,24,7,17,
186,0,23,6,17,
187,0,23,6,17,
188,0,24,7,17,
189,0,23,6,17,
190,0,25,7,18,
191,0,22,6,16,
192,0,26,7,19,
193,0,25,7,18,
194,0,23,6,17,
195,0,23,7,16,
196,0,21,6,15,
197,0,22,7,15,
198,0,23,7,16,
199,0,23,6,17,
200,0,22,6,16,
201,0,25,7,18,
202,0,23,6,17,
203,0,22,6,16,
204,0,24,7,17,
205,0,25,8,17,
206,0,23,6,17,
207,0,23,7,16,
208,0,24,6,18,
209,0,23,6,17,
210,0,24,7,17,
211,0,22,6,16,
212,0,21,6,15,
213,0,23,7,16,
214,0,22,6,16,
215,0,22,7,15,
216,0,24,6,18,
217,0,24,6,18,
218,0,24,7,17,
219,0,23,6,17,
220,0,23,6,17,
221,0,24,7,17,
222,0,23,6,17,
223,0,23,7,16,
224,0,22,7,15,
225,0,24,6,18,
226,0,23,6,17,
227,0,25,7,18,
228,0,23,6,17,
229,0,21,6,15,
230,0,26,8,18,
231,0,24,6,18,
232,0,23,7,16,
233,0,23,7,16,
234,0,25,7,18,
235,0,24,6,18,
236,0,24,7,17,
237,0,22,6,16,
238,0,22,6,16,
239,0,23,6,17,
240,0,22,7,15,
241,0,23,6,17,
242,0,22,6,16,
243,0,24,7,17,
244,0,22,6,16,
245,0,23,7,16,
246,0,23,6,17,
247,0,22,6,16,
248,0,26,7,19,
249,0,24,6,18,
250,0,24,7,17,
251,0,24,7,17,
252,0,23,7,16,
253,0,22,6,16,
254,0,23,6,17,
255,0,22,7,15,
256,0,23,6,17,
257,0,23,6,17,
258,0,23,7,16,
259,0,26,8,18,
260,0,23,7,16,
261,0,24,7,17,
262,0,24,6,18,
263,0,25,7,18,
264,0,23,6,17,
265,0,24,7,17,
266,0,23,6,17,
267,0,24,7,17,
268,0,25,7,18,
269,0,24,7,17,
270,0,21,5,16,
271,0,23,7,16,
272,0,21,6,15,
273,0,24,7,17,
274,0,22,7,15,
275,0,23,6,17,
276,0,25,7,18,
277,0,25,6,19,
278,0,24,7,17,
279,0,25,7,18,
280,0,23,6,17,
281,0,25,7,18,
282,0,24,7,17,
283,0,24,6,18,
284,0,24,7,17,
285,0,23,6,17,
286,0,23,7,16,
287,0,24,7,17,
288,0,22,6,16,
289,0,25,7,18,
290,0,25,6,19,
291,0,24,7,17,
292,0,24,6,18,
293,0,24,6,18,
294,0,22,6,16,
295,0,25,7,18,
296,0,23,6,17,
297,0,24,7,17,
298,0,24,6,18,
299,0,23,6,17,
300,0,25,7,18,
301,0,24,6,18,
302,0,22,6,16,
303,0,21,6,15,
304,0,24,7,17,
305,0,23,7,16,
306,0,22,6,16,
307,0,23,6,17,
308,0,24,7,17,
309,0,23,6,17,
310,0,23,7,16,
311,0,23,7,16,
312,0,25,7,18,
313,0,24,6,18,
314,0,25,8,17,
315,0,23,7,16,
316,0,21,6,15,
317,0,25,7,18,
318,0,23,6,17,
319,0,26,7,19,
320,0,23,6,17,
321,0,23,7,16,
322,0,23,6,17,
323,0,24,7,17,
324,0,23,7,16,
325,0,24,6,18,
326,0,23,7,16,
327,0,23,7,16,
328,0,22,6,16,
329,0,23,7,16,
330,0,22,6,16,
331,0,21,6,15,
332,0,26,7,19,
333,0,23,6,17,
334,0,23,6,17,
335,0,22,6,16,
336,0,24,7,17,
337,0,23,6,17,
338,0,25,7,18,
339,0,23,7,16,
340,0,24,6,18,
341,0,24,7,17,
342,0,22,6,16,
343,0,24,7,17,
344,0,22,7,15,
345,0,21,6,15,
346,0,25,7,18,
347,0,23,6,17,
348,0,24,7,17,
349,0,23,6,17,
350,0,27,11,16,
351,0,24,7,17,
352,0,22,6,16,
353,0,22,7,15,
354,0,23,6,17,
355,0,25,7,18,
356,0,22,6,16,
357,0,23,6,17,
358,0,24,7,17,
359,0,25,7,18,
360,0,22,6,16,
361,0,24,7,17,
362,0,22,6,16,
363,0,22,7,15,
364,0,25,6,19,
365,0,23,6,17,
366,0,25,7,18,
367,0,23,6,17,
368,0,25,7,18,
369,0,23,6,17,
370,0,22,6,16,
371,0,25,7,18,
372,0,23,6,17,
373,0,23,7,16,
374,0,24,7,17,
375,0,26,8,18,
376,0,25,7,18,
377,0,24,6,18,
378,0,23,6,17,
379,0,23,7,16,
380,0,22,6,16,
381,0,24,7,17,
382,0,24,6,18,
383,0,22,6,16,
384,0,24,7,17,
385,0,22,6,16,
386,0,22,7,15,
387,0,23,7,16,
388,0,22,6,16,
389,0,22,7,15,
390,0,24,6,18,
391,0,23,6,17,
392,0,24,7,17,
393,0,22,6,16,
394,0,23,6,17,
395,0,26,8,18,
396,0,23,6,17,
397,0,23,6,17,
398,0,23,7,16,
399,0,23,6,17,
400,0,24,7,17,
401,0,23,6,17,
402,0,24,8,16,
403,0,22,7,15,
404,0,23,7,16,
405,0,24,7,17,
406,0,24,6,18,
407,0,22,6,16,
408,0,23,7,16,
409,0,23,6,17,
410,0,24,6,18,
411,0,24,7,17,
412,0,22,6,16,
413,0,22,7,15,
414,0,24,8,16,
415,0,24,7,17,
416,0,22,6,16,
417,0,21,6,15,
418,0,22,7,15,
419,0,26,7,19,
420,0,24,6,18,
421,0,24,7,17,
422,0,26,8,18,
423,0,22,6,16,
424,0,25,7,18,
425,0,23,6,17,
426,0,22,6,16,
427,0,22,6,16,
428,0,24,7,17,
429,0,25,7,18,
430,0,23,7,16,
431,0,23,6,17,
432,0,22,6,16,
433,0,26,7,19,
434,0,24,5,19,
435,0,25,7,18,
436,0,25,7,18,
437,0,24,6,18,
438,0,24,7,17,
439,0,23,6,17,
440,0,23,7,16,
441,0,27,9,18,
442,0,24,6,18,
443,0,22,6,16,
444,0,24,7,17,
445,0,24,7,17,
446,0,23,7,16,
447,0,23,6,17,
448,0,24,7,17,
449,0,24,7,17,
450,0,22,6,16,
451,0,21,6,15,
452,0,24,7,17,
453,0,23,7,16,
454,0,24,7,17,
455,0,25,7,18,
456,0,23,6,17,
457,0,26,7,19,
458,0,24,6,18,
459,0,23,7,16,
460,0,21,6,15,
461,0,25,7,18,
462,0,23,6,17,
463,0,23,7,16,
464,0,23,6,17,
465,0,23,7,16,
466,0,24,7,17,
467,0,25,6,19,
468,0,23,6,17,
469,0,24,7,17,
470,0,22,6,16,
471,0,23,7,16,
472,0,24,6,18,
473,0,24,7,17,
474,0,23,6,17,
475,0,24,7,17,
476,0,22,6,16,
477,0,24,7,17,
478,0,23,6,17,
479,0,22,6,16,
480,0,25,7,18,
481,0,24,6,18,
482,0,24,7,17,
483,0,22,6,16,
484,0,21,6,15,
485,0,23,7,16,
486,0,23,7,16,
487,0,22,7,15,
488,0,23,6,17,
489,0,23,6,17,
490,0,23,7,16,
491,0,23,6,17,
492,0,22,6,16,
493,0,24,7,17,
494,0,23,6,17,
495,0,23,7,16,
496,0,25,7,18,
497,0,24,7,17,
498,0,24,6,18,
499,0,24,7,17,
500,0,23,7,16,
501,0,21,6,15,
502,0,22,7,15,
503,0,24,7,17,
504,0,24,6,18,
505,0,23,7,16,
506,0,24,7,17,
507,0,23,6,17,
508,0,22,7,15,
509,0,23,6,17,
510,0,24,6,18,
511,0,22,6,16,
512,0,23,7,16,
513,0,23,6,17,
514,0,23,7,16,
515,0,24,7,17,
516,0,23,6,17,
517,0,23,7,16,
518,0,25,7,18,
519,0,23,6,17,
520,0,24,7,17,
521,0,22,6,16,
522,0,22,7,15,
523,0,24,6,18,
524,0,23,6,17,
525,0,26,7,19,
526,0,24,7,17,
527,0,21,6,15,
528,0,23,7,16,
529,0,26,10,16,
530,0,31,13,18,
531,0,30,13,17,
532,0,28,11,17,
533,0,28,12,16,
534,0,29,13,16,
535,0,31,12,19,
536,0,30,12,18,
537,0,30,12,18,
538,0,31,13,18,
539,0,30,13,17,
540,0,29,12,17,
541,0,30,12,18,
542,0,31,13,18,
543,0,30,13,17,
544,0,28,11,17,
545,0,31,13,18,
546,0,27,12,15,
547,0,28,12,16,
548,0,29,13,16,
549,0,28,13,15,
550,0,28,12,16,
551,0,27,12,15,
552,0,29,13,16,
553,0,28,13,15,
554,0,29,14,15,
555,0,29,13,16,
556,0,31,13,18,
557,0,29,12,17,
558,0,28,12,16,
559,0,30,13,17,
560,0,30,13,17,
561,0,31,13,18,
562,0,29,12,17,
563,0,28,12,16,
564,0,30,12,18,
565,0,28,12,16,
566,0,30,13,17,
567,0,29,12,17,
568,0,30,12,18,
569,0,31,13,18,
570,0,30,13,17,
571,0,30,12,18,
572,0,30,13,17,
573,0,30,12,18,
574,0,30,13,17,
575,0,29,12,17,
576,0,29,13,16,
577,0,26,10,16,
578,0,28,13,15,
579,0,29,13,16,
580,0,30,13,17,
581,0,28,12,16,
582,0,30,13,17,
583,0,29,12,17,
584,0,30,13,17,
585,0,29,13,16,
586,0,26,10,16,
587,0,29,13,16,
588,0,29,12,17,
589,0,28,12,16,
590,0,29,12,17,
591,0,25,9,16,
592,0,24,8,16,
593,0,23,6,17,
594,0,23,6,17,
595,0,23,6,17,
596,0,25,7,18,
597,0,23,6,17,
598,0,23,7,16,
599,0,25,7,18,
600,0,24,6,18,
601,0,23,6,17,
602,0,23,7,16,
603,0,21,6,15,
604,0,24,7,17,
605,0,22,6,16,
606,0,22,7,15,
607,0,24,7,17,
608,0,24,6,18,
609,0,27,8,19,
610,0,24,6,18,
611,0,23,6,17,
612,0,25,8,17,
613,0,22,6,16,
614,0,22,7,15,
615,0,24,7,17,
616,0,25,7,18,
617,0,25,7,18,
618,0,24,7,17,
619,0,24,6,18,
620,0,24,6,18,
621,0,23,6,17,
622,0,23,7,16,
623,0,22,7,15,
624,0,25,7,18,
625,0,23,6,17,
626,0,23,7,16,
627,0,23,6,17,
628,0,22,6,16,
629,0,25,7,18,
630,0,23,7,16,
631,0,25,7,18,
632,0,25,7,18,
633,0,23,6,17,
634,0,22,6,16,
635,0,22,7,15,
636,0,22,6,16,
637,0,21,6,15,
638,0,25,7,18,
639,0,23,6,17,
640,0,22,6,16,
641,0,24,7,17,
642,0,23,6,17,
643,0,23,7,16,
644,0,23,7,16,
645,0,23,6,17,
646,0,22,6,16,
647,0,25,7,18,
648,0,21,6,15,
649,0,26,7,19,
650,0,23,6,17,
651,0,24,7,17,
652,0,24,6,18,
653,0,24,7,17,
654,0,22,6,16,
655,0,24,7,17,
656,0,24,7,17,
657,0,22,6,16,
658,0,23,7,16,
659,0,24,6,18,
660,0,24,8,16,
661,0,23,6,17,
662,0,22,6,16,
663,0,24,7,17,
664,0,22,6,16,
665,0,22,7,15,
666,0,23,6,17,
667,0,22,6,16,
668,0,25,7,18,
669,0,24,6,18,
670,0,24,7,17,
671,0,24,6,18,
672,0,22,6,16,
673,0,25,8,17,
674,0,23,6,17,
675,0,24,7,17,
676,0,22,6,16,
677,0,24,7,17,
678,0,22,7,15,
679,0,22,6,16,
680,0,23,7,16,
681,0,23,6,17,
682,0,25,7,18,
683,0,24,6,18,
684,0,22,6,16,
685,0,24,7,17,
686,0,24,7,17,
687,0,22,7,15,
688,0,25,6,19,
689,0,25,7,18,
690,0,26,8,18,
691,0,23,6,17,
692,0,25,6,19,
693,0,23,6,17,
694,0,24,7,17,
695,0,22,6,16,
696,0,22,7,15,
697,0,23,7,16,
698,0,21,6,15,
699,0,24,7,17,
700,0,23,6,17,
701,0,23,7,16,
702,0,24,6,18,
703,0,25,6,19,
704,0,23,6,17,
705,0,23,6,17,
706,0,25,7,18,
707,0,23,7,16,
708,0,23,6,17,
709,0,22,6,16,
710,0,24,7,17,
711,0,25,6,19,
712,0,23,6,17,
713,0,25,8,17,
714,0,25,7,18,
715,0,24,8,16,
716,0,23,7,16,
717,0,24,8,16,
718,0,22,6,16,
719,0,25,7,18,
720,0,25,7,18,
721,0,23,6,17,
722,0,25,7,18,
723,0,24,6,18,
724,0,24,7,17,
725,0,22,6,16,
726,0,21,6,15,
727,0,23,7,16,
728,0,21,6,15,
729,0,22,7,15,
730,0,23,6,17,
731,0,22,6,16,
732,0,24,7,17,
733,0,29,12,17,
734,0,31,13,18,
735,0,29,12,17,
736,0,31,13,18,
737,0,30,13,17,
738,0,28,12,16,
739,0,27,11,16,
740,0,29,13,16,
741,0,31,14,17,
742,0,27,11,16,
743,0,30,13,17,
744,0,26,11,15,
745,0,30,13,17,
746,0,29,12,17,
747,0,29,12,17,
748,0,28,12,16,
749,0,28,12,16,
750,0,29,11,18,
751,0,30,12,18,
752,0,31,13,18,
753,0,29,11,18,
754,0,31,13,18,
755,0,31,12,19,
756,0,30,12,18,
757,0,29,12,17,
758,0,28,11,17,
759,0,30,12,18,
760,0,30,12,18,
761,0,28,12,16,
762,0,30,12,18,
763,0,28,11,17,
764,0,30,13,17,
765,0,30,13,17,
766,0,31,13,18,
767,0,31,13,18,
768,0,30,13,17,
769,0,27,10,17,
770,0,27,11,16,
771,0,27,12,15,
772,0,29,13,16,
773,0,29,13,16,
774,0,30,13,17,
775,0,28,12,16,
776,0,28,13,15,
777,0,27,10,17,
778,0,22,7,15,
779,0,24,6,18,
780,0,24,6,18,
781,0,22,6,16,
782,0,23,7,16,
783,0,23,6,17,
784,0,24,7,17,
785,0,24,6,18,
786,0,22,6,16,
787,0,25,7,18,
788,0,25,6,19,
789,0,24,7,17,
790,0,24,6,18,
791,0,23,6,17,
792,0,23,7,16,
793,0,22,6,16,
794,0,21,6,15,
795,0,23,7,16,
796,0,23,7,16,
797,0,22,6,16,
798,0,24,7,17,
799,0,25,7,18,
800,0,24,7,17,
801,0,23,6,17,
802,0,23,7,16,
803,0,22,6,16,
804,0,26,8,18,
805,0,22,6,16,
806,0,26,7,19,
807,0,25,7,18,
808,0,24,7,17,
809,0,24,7,17,
810,0,23,7,16,
811,0,25,7,18,
812,0,24,6,18,
813,0,22,6,16,
814,0,23,7,16,
815,0,22,6,16,
816,0,24,7,17,
817,0,23,6,17,
818,0,23,7,16,
819,0,24,6,18,
820,0,23,6,17,
821,0,24,7,17,
822,0,22,6,16,
823,0,21,6,15,
824,0,23,7,16,
825,0,22,6,16,
826,0,24,7,17,
827,0,24,7,17,
828,0,22,6,16,
829,0,23,7,16,
830,0,26,8,18,
831,0,23,6,17,
832,0,23,6,17,
833,0,24,7,17,
834,0,24,6,18,
835,0,24,6,18,
836,0,24,7,17,
837,0,24,6,18,
838,0,23,7,16,
839,0,25,8,17,
840,0,22,6,16,
841,0,23,7,16,
842,0,23,7,16,
843,0,21,6,15,
844,0,24,7,17,
845,0,22,6,16,
846,0,23,6,17,
847,0,23,7,16,
848,0,23,6,17,
849,0,23,6,17,
850,0,23,7,16,
851,0,24,6,18,
852,0,23,6,17,
853,0,23,7,16,
854,0,22,6,16,
855,0,22,7,15,
856,0,20,6,14,
857,0,24,7,17,
858,0,25,7,18,
859,0,22,6,16,
860,0,26,8,18,
861,0,23,6,17,
862,0,22,6,16,
863,0,25,7,18,
864,0,24,6,18,
865,0,25,7,18,
866,0,23,6,17,
867,0,25,7,18,
868,0,22,6,16,
869,0,25,7,18,
870,0,24,6,18,
871,0,23,6,17,
872,0,24,7,17,
873,0,23,6,17,
874,0,22,6,16,
875,0,22,7,15,
876,0,23,6,17,
877,0,22,6,16,
878,0,24,7,17,
879,0,23,6,17,
880,0,22,6,16,
881,0,24,7,17,
882,0,22,6,16,
883,0,24,7,17,
884,0,24,6,18,
885,0,24,7,17,
886,0,22,6,16,
887,0,22,7,15,
888,0,22,7,15,
889,0,23,7,16,
890,0,28,11,17,
891,0,27,10,17,
892,0,23,7,16,
893,0,29,12,17,
894,0,29,13,16,
895,0,28,12,16,
896,0,29,11,18,
897,0,26,7,19,
898,0,27,10,17,
899,0,30,11,19,
900,0,27,9,18,
901,0,27,9,18,
902,0,27,9,18,
903,0,24,7,17,
904,0,25,8,17,
905,0,29,13,16,
906,0,28,12,16,
907,0,26,9,17,
908,0,27,10,17,
909,0,25,9,16,
910,0,28,11,17,
911,0,28,11,17,
912,0,28,12,16,
913,0,27,11,16,
914,0,24,7,17,
915,0,28,10,17,1
916,0,24,7,17,
917,0,23,7,16,
918,0,22,7,15,
919,0,25,7,18,
920,0,25,7,18,
921,0,25,7,18,
922,0,22,6,16,
923,0,26,7,18,1
924,0,25,7,18,
925,0,23,6,17,
926,0,23,7,16,
927,0,25,7,18,
928,0,23,6,17,
929,0,23,7,16,
930,0,25,7,17,1
931,0,22,6,16,
932,0,23,7,16,
933,0,23,7,16,
934,0,24,6,18,
935,0,23,6,17,
936,0,24,7,17,
937,0,22,6,16,
938,0,21,6,15,
939,0,23,7,16,
940,0,21,6,15,
941,0,22,7,15,
942,0,23,6,17,
943,0,22,6,16,
944,0,24,7,17,
945,0,26,7,18,1
946,0,23,6,17,
947,0,22,6,16,
948,0,25,8,17,
949,0,22,6,16,
950,0,22,7,15,
951,0,22,6,16,
952,0,21,6,15,
953,0,24,7,17,
954,0,23,6,17,
955,0,22,6,16,
956,0,24,7,17,
957,0,22,6,16,
958,0,23,7,16,
959,0,21,6,15,
960,0,24,8,16,
961,0,23,6,16,1
962,0,23,6,17,
963,0,24,7,17,
964,0,23,6,17,
965,0,27,8,19,
966,0,23,6,17,
967,0,24,6,18,
968,0,22,6,16,
969,0,24,7,17,
970,0,22,6,16,
971,0,22,7,15,
972,0,25,6,19,
973,0,23,6,17,
974,0,26,7,19,
975,0,23,6,17,
976,0,24,7,17,
977,0,21,6,15,
978,0,26,7,19,
979,0,24,7,17,
980,0,23,6,17,
981,0,24,7,17,
982,0,21,6,15,
983,0,25,7,18,
984,0,23,6,17,
985,0,24,6,18,
986,0,27,9,18,
987,0,24,6,18,
988,0,23,7,16,
989,0,23,6,17,
990,0,22,6,16,
991,0,25,8,16,1
992,0,25,7,18,
993,0,23,6,17,
994,0,23,7,16,
995,0,25,8,17,
996,0,22,6,16,
997,0,25,7,18,
998,0,23,6,17,
999,0,22,7,15,
1000,0,23,6,17,
1001,0,22,6,16,
1002,0,25,7,18,
1003,0,23,6,17,
1004,0,22,6,16,
1005,0,24,7,17,
1006,0,22,6,16,
1007,0,23,7,16,
1008,0,24,6,18,
1009,0,24,7,17,
1010,0,22,7,15,
1011,0,24,7,17,
1012,0,21,6,15,
1013,0,25,7,18,
1014,0,22,6,16,
1015,0,24,7,17,
1016,0,23,6,17,
1017,0,25,7,18,
1018,0,25,7,18,
1019,0,23,6,17,
1020,0,22,6,16,
1021,0,22,6,15,1
1022,0,23,7,16,
1023,0,25,8,17,
1024,0,22,6,16,
1025,0,25,8,17,
1026,0,21,6,15,
1027,0,24,7,17,
1028,0,23,6,17,
1029,0,23,7,16,
1030,0,23,6,17,
1031,0,23,6,17,
1032,0,23,7,16,
1033,0,23,6,17,
1034,0,22,6,16,
1035,0,25,7,18,
1036,0,24,6,18,
1037,0,24,7,17,
1038,0,22,6,16,
1039,0,21,6,15,
1040,0,23,7,16,
1041,0,22,7,15,
1042,0,22,6,16,
1043,0,25,8,17,
1044,0,25,9,16,
1045,0,23,6,17,
1046,0,23,6,17,
1047,0,27,8,19,
1048,0,24,7,17,
1049,0,23,5,18,
1050,0,23,7,16,
1051,0,23,7,16,
1052,0,24,7,16,1
1053,0,23,6,17,
1054,0,24,7,17,
1055,0,22,7,15,
1056,0,24,6,18,
1057,0,24,6,18,
1058,0,23,6,17,
1059,0,24,6,18,
1060,0,22,6,16,
1061,0,25,7,18,
1062,0,24,6,18,
1063,0,24,7,17,
1064,0,22,6,16,
1065,0,21,6,15,
1066,0,23,7,16,
1067,0,22,6,16,
1068,0,21,6,15,
1069,0,24,7,17,
1070,0,22,6,16,
1071,0,23,7,16,
1072,0,23,7,16,
1073,0,23,6,17,
1074,0,24,6,18,
1075,0,22,6,16,
1076,0,26,7,19,
1077,0,27,9,18,
1078,0,30,13,17,
1079,0,30,11,19,
1080,0,31,13,18,
1081,0,29,11,18,
1082,0,31,13,17,1
1083,0,30,12,18,
1084,0,31,13,18,
1085,0,30,12,18,
1086,0,30,13,17,
1087,0,27,10,17,
1088,0,23,7,16,
1089,0,24,7,17,
1090,0,22,6,16,
1091,0,25,7,18,
1092,0,25,7,18,
1093,0,23,7,16,
1094,0,23,6,17,
1095,0,25,6,19,
1096,0,24,6,18,
1097,0,24,7,17,
1098,0,23,7,16,
1099,0,22,7,15,
1100,0,24,7,17,
1101,0,22,6,16,
1102,0,23,7,16,
1103,0,22,5,17,
1104,0,24,7,17,
1105,0,23,6,17,
1106,0,22,6,16,
1107,0,23,7,16,
1108,0,24,8,16,
1109,0,23,6,17,
1110,0,25,7,18,
1111,0,23,6,17,
1112,0,25,7,17,1
1113,0,22,6,16,
1114,0,21,6,15,
1115,0,24,7,17,
1116,0,22,6,16,
1117,0,22,7,15,
1118,0,24,7,17,
1119,0,22,6,16,
1120,0,25,7,18,
1121,0,23,6,17,
1122,0,23,7,16,
1123,0,23,6,17,
1124,0,23,6,17,
1125,0,23,7,16,
1126,0,25,7,18,
1127,0,23,6,17,
1128,0,22,7,15,
1129,0,23,7,16,
1130,0,23,7,16,
1131,0,21,6,15,
1132,0,23,7,16,
1133,0,27,7,20,
1134,0,23,6,17,
1135,0,22,6,16,
1136,0,25,7,18,
1137,0,24,6,18,
1138,0,25,7,18,
1139,0,23,6,17,
1140,0,22,6,16,
1141,0,22,7,15,
1142,0,21,6,15,
1143,0,26,7,18,1
1144,0,23,6,17,
1145,0,26,7,19,
1146,0,25,6,19,
1147,0,23,6,17,
1148,0,24,7,17,
1149,0,22,6,16,
1150,0,24,7,17,
1151,0,22,6,16,
1152,0,21,6,15,
1153,0,24,7,17,
1154,0,23,6,17,
1155,0,23,7,16,
1156,0,23,6,17,
1157,0,22,6,16,
1158,0,24,7,17,
1159,0,23,6,17,
1160,0,25,7,18,
1161,0,25,6,19,
1162,0,23,6,17,
1163,0,25,7,18,
1164,0,24,7,17,
1165,0,23,6,17,
1166,0,22,6,16,
1167,0,22,7,15,
1168,0,23,7,16,
1169,0,25,7,18,
1170,0,22,6,16,
1171,0,23,6,17,
1172,0,22,6,16,
1173,0,24,7,16,1
1174,0,24,7,17,
1175,0,24,7,17,
1176,0,22,6,16,
1177,0,25,8,17,
1178,0,26,6,20,
1179,0,24,6,18,
1180,0,23,6,17,
1181,0,23,7,16,
1182,0,22,6,16,
1183,0,22,7,15,
1184,0,22,6,16,
1185,0,21,6,15,
1186,0,24,7,17,
1187,0,23,6,17,
1188,0,22,6,16,
1189,0,23,7,16,
1190,0,24,7,17,
1191,0,23,7,16,
1192,0,23,6,17,
1193,0,22,6,16,
1194,0,24,7,17,
1195,0,25,7,18,
1196,0,24,6,18,
1197,0,23,6,17,
1198,0,24,7,17,
1199,0,25,8,17,
1200,0,23,7,16,
1201,0,21,6,15,
1202,0,23,7,16,
1203,0,27,8,18,1
1204,0,22,6,16,
1205,0,23,6,17,
1206,0,22,6,16,
1207,0,25,7,18,
1208,0,23,6,17,
1209,0,22,6,16,
1210,0,24,7,17,
1211,0,23,6,17,
1212,0,23,7,16,
1213,0,24,7,17,
1214,0,23,7,16,
1215,0,21,6,15,
1216,0,24,7,17,
1217,0,22,6,16,
1218,0,24,7,17,
1219,0,23,6,17,
1220,0,23,7,16,
1221,0,23,6,17,
1222,0,22,6,16,
1223,0,23,7,16,
1224,0,25,7,18,
1225,0,24,6,18,
1226,0,23,6,17,
1227,0,24,7,17,
1228,0,22,6,16,
1229,0,22,7,15,
1230,0,22,6,16,
1231,0,21,6,15,
1232,0,24,7,17,
1233,0,23,7,16,
1234,0,24,7,16,1
1235,0,23,7,16,
1236,0,23,6,17,
1237,0,23,7,16,
1238,0,24,7,17,
1239,0,22,6,16,
1240,0,25,7,18,
1241,0,24,6,18,
1242,0,24,7,17,
1243,0,22,6,16,
1244,0,21,6,15,
1245,0,24,7,17,
1246,0,22,6,16,
1247,0,21,6,15,
1248,0,25,7,18,
1249,0,23,6,17,
1250,0,23,7,16,
1251,0,23,6,17,
1252,0,22,6,16,
1253,0,24,7,17,
1254,0,26,8,18,
1255,0,10,2,8,
1259,0,24,9,15,
1260,0,25,6,19,
1261,0,28,8,20,
1262,0,28,7,21,
1263,0,27,6,21,
1264,0,33,7,25,1
1265,0,31,7,24,
1266,0,32,7,25,
1267,0,35,7,28,
1268,0,35,7,28,
1269,0,36,8,28,
1270,0,36,7,29,
1271,0,36,6,30,
1272,0,36,7,29,
1273,0,37,6,31,
1274,0,40,8,32,
1275,0,37,6,31,
1276,0,41,7,34,
1277,0,39,6,33,
1278,0,39,6,33,
1279,0,42,7,35,
1280,0,41,6,35,
1281,0,41,7,34,
1282,0,42,6,36,
1283,0,41,6,35,
1284,0,47,10,37,
1285,0,43,6,37,
1286,0,43,6,37,
1287,0,45,7,38,
1288,0,44,6,38,
1289,0,45,7,38,
1290,0,45,6,39,
1291,0,47,7,40,
1292,0,45,6,39,
1293,0,46,7,39,
1294,0,49,7,41,1
1295,0,46,6,40,
1296,0,49,7,42,
1297,0,48,7,41,
1298,0,48,6,42,
1299,0,52,8,44,
1300,0,48,6,42,
1301,0,50,7,43,
1302,0,50,6,44,
1303,0,50,7,43,
1304,0,51,6,45,
1305,0,51,6,45,
1306,0,51,7,44,
1307,0,52,6,46,
1308,0,51,6,45,
1309,0,53,7,46,
1310,0,52,6,46,
1311,0,53,7,46,
1312,0,53,6,47,
1313,0,52,6,46,
1314,0,57,8,49,
1315,0,55,7,48,
1316,0,54,6,48,
1317,0,55,7,48,
1318,0,55,6,49,
1319,0,54,6,48,
1320,0,57,7,50,
1321,0,56,6,50,
1322,0,57,7,50,
1323,0,57,7,50,
1324,0,58,7,51,
1325,0,57,6,50,1
1326,0,58,8,50,
1327,0,60,7,53,
1328,0,58,6,52,
1329,0,58,7,51,
1330,0,60,8,52,
1331,0,58,6,52,
1332,0,61,7,54,
1333,0,59,6,53,
1334,0,58,6,52,
1335,0,62,7,55,
1336,0,61,7,54,
1337,0,60,7,53,
1338,0,61,6,55,
1339,0,60,6,54,
1340,0,62,7,55,
1341,0,63,7,56,
1342,0,63,7,56,
1343,0,61,6,55,
1344,0,63,7,56,
1345,0,64,8,56,
1346,0,64,7,57,
1347,0,62,6,56,
1348,0,64,7,57,
1349,0,63,6,57,
1350,0,66,8,58,
1351,0,63,6,57,
1352,0,66,7,59,
1353,0,64,7,57,
1354,0,64,7,57,
1355,0,66,6,59,1
1356,0,64,6,58,
1357,0,67,8,59,
1358,0,65,6,59,
1359,0,67,7,60,
1360,0,65,6,59,
1361,0,67,7,60,
1362,0,66,6,60,
1363,0,66,7,59,
1364,0,67,6,61,
1365,0,66,6,60,
1366,0,68,7,61,
1367,0,66,6,60,
1368,0,68,7,61,
1369,0,68,6,62,
1370,0,67,6,61,
1371,0,68,7,61,
1372,0,69,7,62,
1373,0,69,6,63,
1374,0,68,6,62,
1375,0,71,8,63,
1376,0,69,6,63,
1377,0,70,7,63,
1378,0,70,6,64,
1379,0,69,6,63,
1380,0,71,7,64,
1381,0,70,7,63,
1382,0,71,6,65,
1383,0,70,6,64,
1384,0,72,7,65,
1385,0,74,7,66,1
1386,0,71,6,65,
1387,0,71,6,65,
1388,0,74,7,67,
1389,0,72,6,66,
1390,0,72,7,65,
1391,0,72,6,66,
1392,0,72,6,66,
1393,0,74,7,67,
1394,0,73,6,67,
1395,0,73,7,66,
1396,0,73,6,67,
1397,0,74,6,68,
1398,0,74,7,67,
1399,0,74,6,68,
1400,0,73,6,67,
1401,0,75,7,68,
1402,0,76,7,69,
1403,0,75,6,69,
1404,0,75,7,68,
1405,0,75,6,69,
1406,0,76,7,69,
1407,0,76,6,70,
1408,0,75,6,69,
1409,0,77,7,70,
1410,0,75,6,69,
1411,0,78,7,71,
1412,0,77,6,71,
1413,0,77,7,70,
1414,0,77,6,71,
1415,0,77,6,71,
1416,0,79,7,71,1
1417,0,78,7,71,
1418,0,79,7,72,
1419,0,77,6,71,
1420,0,78,7,71,
1421,0,78,6,72,
1422,0,78,7,71,
1423,0,80,7,73,
1424,0,79,6,73,
1425,0,79,7,72,
1426,0,79,6,73,
1427,0,79,7,72,
1428,0,79,6,73,
1429,0,79,6,73,
1430,0,81,7,74,
1431,0,80,6,74,
1432,0,81,7,74,
1433,0,81,7,74,
1434,0,80,6,74,
1435,0,82,7,75,
1436,0,83,7,76,
1437,0,81,6,75,
1438,0,81,7,74,
1439,0,81,6,75,
1440,0,82,6,76,
1441,0,83,8,75,
1442,0,82,6,76,
1443,0,82,7,75,
1444,0,83,7,76,
1445,0,83,7,76,
1446,0,84,7,76,1
1447,0,84,7,77,
1448,0,82,6,76,
1449,0,83,7,76,
1450,0,83,7,76,
1451,0,81,6,75,
1452,0,71,7,64,
1453,0,58,6,52,
1454,0,53,6,47,
1455,0,51,7,44,
1456,0,45,6,39,
1457,0,40,6,34,
1458,0,36,6,30,
1459,0,40,7,33,
1460,0,48,8,40,
1461,0,54,6,48,
1462,0,56,7,49,
1463,0,56,7,49,
1464,0,56,6,50,
1465,0,56,7,49,
1466,0,57,7,50,
1467,0,58,7,51,
1468,0,57,7,50,
1469,0,58,7,51,
1470,0,57,6,51,
1471,0,60,8,52,
1472,0,58,6,52,
1473,0,58,6,52,
1474,0,60,7,53,
1475,0,58,6,52,
1476,0,64,8,55,1
1477,0,60,6,54,
1478,0,63,8,55,
1479,0,59,6,53,
1480,0,61,7,54,
1481,0,61,6,55,
1482,0,60,6,54,
1483,0,65,8,57,
1484,0,62,6,56,
1485,0,62,7,55,
1486,0,63,6,57,
1487,0,62,6,56,
1488,0,64,7,57,
1489,0,63,6,57,
1490,0,64,7,57,
1491,0,65,7,58,
1492,0,63,6,57,
1493,0,65,7,58,
1494,0,65,6,59,
1495,0,66,7,59,
1496,0,66,7,59,
1497,0,65,6,59,
1498,0,67,7,60,
1499,0,66,7,59,
1500,0,66,6,60,
1501,0,67,7,60,
1502,0,69,8,61,
1503,0,66,6,60,
1504,0,68,7,61,
1505,0,68,6,62,
1506,0,69,7,62,
1507,0,70,7,62,1
1508,0,70,7,63,
1509,0,68,6,62,
1510,0,70,7,63,
1511,0,68,6,62,
1512,0,69,7,62,
1513,0,70,7,63,
1514,0,70,6,64,
1515,0,70,6,64,
1516,0,72,8,64,
1517,0,71,7,64,
1518,0,71,6,65,
1519,0,70,6,64,
1520,0,72,7,65,
1521,0,71,6,65,
1522,0,74,7,67,
1523,0,73,7,66,
1524,0,74,8,66,
1525,0,72,6,66,
1526,0,73,7,66,
1527,0,73,7,66,
1528,0,73,6,67,
1529,0,73,7,66,
1530,0,74,6,68,
1531,0,75,7,68,
1532,0,77,8,69,
1533,0,73,6,67,
1534,0,76,7,69,
1535,0,76,7,69,
1536,0,75,7,68,
1537,0,77,8,68,1
1538,0,77,7,70,
1539,0,77,7,70,
1540,0,77,8,69,
1541,0,76,6,70,
1542,0,75,6,69,
1543,0,78,7,71,
1544,0,76,6,70,
1545,0,79,7,72,
1546,0,77,6,71,
1547,0,76,6,70,
1548,0,79,7,72,
1549,0,78,6,72,
1550,0,78,7,71,
1551,0,78,6,72,
1552,0,78,6,72,
1553,0,80,7,73,
1554,0,80,7,73,
1555,0,79,6,73,
1556,0,78,6,72,
1557,0,82,8,74,
1558,0,80,7,73,
1559,0,81,7,74,
1560,0,79,6,73,
1561,0,81,7,74,
1562,0,81,6,75,
1563,0,82,7,75,
1564,0,82,7,75,
1565,0,80,6,74,
1566,0,83,7,76,
1567,0,83,6,76,1
1568,0,82,7,75,
1569,0,82,6,76,
1570,0,82,7,75,
1571,0,82,6,76,
1572,0,82,6,76,
1573,0,82,7,75,
1574,0,82,6,76,
1575,0,82,7,75,
1576,0,82,6,76,
1577,0,77,6,71,
1578,0,66,7,59,
1579,0,54,6,48,
1580,0,52,6,46,
1581,0,50,7,43,
1582,0,40,6,34,
1583,0,32,6,26,
1584,0,28,8,20,
1585,0,23,6,17,
1586,0,34,7,27,
1587,0,40,7,33,
1588,0,42,7,35,
1589,0,40,6,34,
1590,0,40,6,34,
1591,0,43,7,36,
1592,0,41,6,35,
1593,0,44,7,37,
1594,0,43,6,37,
1595,0,44,7,37,
1596,0,44,6,38,
1597,0,47,7,40,
1598,0,47,7,39,1
1599,0,48,8,40,
1600,0,47,7,40,
1601,0,48,8,40,
1602,0,47,6,41,
1603,0,47,7,40,
1604,0,48,6,42,
1605,0,48,6,42,
1606,0,49,7,42,
1607,0,49,6,43,
1608,0,48,6,42,
1609,0,51,7,44,
1610,0,49,6,43,
1611,0,51,7,44,
1612,0,51,6,45,
1613,0,50,6,44,
1614,0,54,7,47,
1615,0,52,6,46,
1616,0,53,7,46,
1617,0,55,8,47,
1618,0,52,6,46,
1619,0,55,7,48,
1620,0,54,6,48,
1621,0,54,7,47,
1622,0,56,7,49,
1623,0,56,7,49,
1624,0,55,6,49,
1625,0,57,7,50,
1626,0,57,7,50,
1627,0,55,6,49,
1628,0,60,8,51,1
1629,0,56,6,50,
1630,0,59,7,52,
1631,0,58,6,52,
1632,0,57,6,51,
1633,0,59,7,52,
1634,0,59,6,53,
1635,0,59,7,52,
1636,0,59,6,53,
1637,0,60,7,53,
1638,0,61,7,54,
1639,0,60,6,54,
1640,0,61,7,54,
1641,0,61,6,55,
1642,0,60,6,54,
1643,0,62,7,55,
1644,0,64,7,57,
1645,0,62,6,56,
1646,0,63,7,56,
1647,0,65,7,58,
1648,0,66,8,58,
1649,0,63,7,56,
1650,0,64,6,58,
1651,0,63,6,57,
1652,0,65,7,58,
1653,0,64,7,57,
1654,0,67,7,60,
1655,0,65,6,59,
1656,0,64,6,58,
1657,0,66,7,59,
1658,0,67,6,60,1
1659,0,66,7,59,
1660,0,66,6,60,
1661,0,67,7,60,
1662,0,66,6,60,
1663,0,68,7,61,
1664,0,67,6,61,
1665,0,67,6,61,
1666,0,69,7,62,
1667,0,67,6,61,
1668,0,68,7,61,
1669,0,69,6,63,
1670,0,69,7,62,
1671,0,69,6,63,
1672,0,68,6,62,
1673,0,72,7,65,
1674,0,70,6,64,
1675,0,69,6,63,
1676,0,71,7,64,
1677,0,70,6,64,
1678,0,74,8,66,
1679,0,70,6,64,
1680,0,72,7,65,
1681,0,72,6,66,
1682,0,71,6,65,
1683,0,73,7,66,
1684,0,71,6,65,
1685,0,74,7,67,
1686,0,73,6,67,
1687,0,74,7,67,
1688,0,73,7,66,
1689,0,73,6,66,1
1690,0,76,7,69,
1691,0,74,6,68,
1692,0,74,7,67,
1693,0,75,7,68,
1694,0,74,6,68,
1695,0,76,7,69,
1696,0,75,6,69,
1697,0,75,7,68,
1698,0,75,6,69,
1699,0,75,6,69,
1700,0,78,7,71,
1701,0,76,6,70,
1702,0,76,7,69,
1703,0,77,6,71,
1704,0,76,6,70,
1705,0,78,8,70,
1706,0,78,7,71,
1707,0,76,6,70,
1708,0,79,8,71,
1709,0,79,7,72,
1710,0,80,7,73,
1711,0,78,6,72,
1712,0,78,7,71,
1713,0,79,7,72,
1714,0,81,8,73,
1715,0,78,6,72,
1716,0,81,8,73,
1717,0,80,6,74,
1718,0,80,7,73,
1719,0,82,7,74,1
1720,0,81,7,74,
1721,0,79,6,73,
1722,0,83,8,75,
1723,0,80,6,74,
1724,0,82,7,75,
1725,0,81,6,75,
1726,0,81,7,74,
1727,0,82,6,76,
1728,0,81,6,75,
1729,0,83,7,76,
1730,0,81,6,75,
1731,0,84,7,77,
1732,0,82,6,76,
1733,0,81,6,75,
1734,0,83,7,76,
1735,0,82,6,76,
1736,0,83,8,75,
1737,0,82,6,76,
1738,0,72,7,65,
1739,0,60,7,53,
1740,0,53,6,47,
1741,0,52,7,45,
1742,0,47,7,40,
1743,0,36,6,30,
1744,0,28,6,22,
1745,0,24,7,17,
1746,0,28,7,21,
1747,0,37,6,31,
1748,0,39,7,32,
1749,0,41,7,33,1
1750,0,43,7,36,
1751,0,42,7,35,
1752,0,42,6,36,
1753,0,42,7,35,
1754,0,44,7,37,
1755,0,42,6,36,
1756,0,45,7,38,
1757,0,44,7,37,
1758,0,45,6,39,
1759,0,45,6,39,
1760,0,46,7,39,
1761,0,46,6,40,
1762,0,47,7,40,
1763,0,48,7,41,
1764,0,47,6,41,
1765,0,50,7,43,
1766,0,48,6,42,
1767,0,48,6,42,
1768,0,50,7,43,
1769,0,50,7,43,
1770,0,50,7,43,
1771,0,51,7,44,
1772,0,50,6,44,
1773,0,53,8,45,
1774,0,53,7,46,
1775,0,52,6,46,
1776,0,51,6,45,
1777,0,55,7,48,
1778,0,53,6,47,
1779,0,53,7,46,
1780,0,55,6,48,1
1781,0,55,7,48,
1782,0,55,7,48,
1783,0,55,6,49,
1784,0,54,6,48,
1785,0,58,7,51,
1786,0,56,6,50,
1787,0,55,6,49,
1788,0,58,7,51,
1789,0,57,6,51,
1790,0,57,7,50,
1791,0,58,6,52,
1792,0,57,6,51,
1793,0,59,7,52,
1794,0,59,6,53,
1795,0,58,6,52,
1796,0,60,7,53,
1797,0,58,6,52,
1798,0,60,7,53,
1799,0,60,7,53,
1800,0,60,6,54,
1801,0,60,6,54,
1802,0,62,7,55,
1803,0,62,7,55,
1804,0,65,8,57,
1805,0,64,8,56,
1806,0,62,7,55,
1807,0,62,6,56,
1808,0,64,7,57,
1809,0,62,6,56,
1810,0,65,8,56,1
1811,0,64,6,58,
1812,0,63,6,57,
1813,0,65,7,58,
1814,0,64,7,57,
1815,0,65,6,59,
1816,0,64,6,58,
1817,0,66,7,59,
1818,0,66,6,60,
1819,0,68,8,60,
1820,0,66,6,60,
1821,0,65,6,59,
1822,0,69,7,62,
1823,0,67,6,61,
1824,0,72,11,61,
1825,0,69,8,61,
1826,0,67,6,61,
1827,0,69,7,62,
1828,0,68,6,62,
1829,0,68,7,61,
1830,0,68,6,62,
1831,0,72,8,64,
1832,0,69,7,62,
1833,0,69,6,63,
1834,0,62,4,58,
1835,0,40,,40,
1836,0,17,,17,
1841,0,12,4,8,
1842,0,25,8,17,
1843,0,33,6,27,
1844,0,49,7,42,
1845,0,48,6,42,
1846,0,49,7,42,
1847,0,49,6,43,
1848,0,50,7,43,
1849,0,50,7,43,
1850,0,53,7,46,
1851,0,51,6,45,
1852,0,50,6,44,
1853,0,53,7,46,
1854,0,51,6,45,
1855,0,52,7,45,
1856,0,53,6,47,
1857,0,53,7,46,
1858,0,54,6,48,
1859,0,55,7,48,
1860,0,54,7,47,
1861,0,55,7,48,
1862,0,56,7,49,
1863,0,54,6,48,
1864,0,56,7,49,
1865,0,57,7,50,
1866,0,56,7,49,
1867,0,58,7,51,
1868,0,58,7,51,
1869,0,57,6,51,
1870,0,57,6,51,
1871,0,59,7,52,
1872,0,58,6,52,
1873,0,59,7,52,
1874,0,59,6,53,
1875,0,58,6,52,
1876,0,61,7,54,
1877,0,60,6,54,
1878,0,59,6,53,
1879,0,60,7,53,
1880,0,63,8,55,
1881,0,60,6,54,
1882,0,62,7,55,
1883,0,61,6,55,
1884,0,64,7,57,
1885,0,62,6,56,
1886,0,61,6,55,
1887,0,64,7,57,
1888,0,63,7,56,
1889,0,63,6,57,
1890,0,64,7,57,
1891,0,65,7,58,
1892,0,63,6,57,
1893,0,65,7,58,
1894,0,66,7,59,
1895,0,68,10,58,
1896,0,67,7,60,
1897,0,66,6,60,
1898,0,67,8,59,
1899,0,66,7,59,
1900,0,66,6,60,
1901,0,68,7,61,
1902,0,68,7,61,
1903,0,66,6,60,
1904,0,69,7,62,
1905,0,68,6,62,
1906,0,67,6,61,
1907,0,69,7,62,
1908,0,68,6,62,
1909,0,69,7,62,
1910,0,71,7,64,
1911,0,69,6,63,
1912,0,69,7,62,
1913,0,70,6,64,
1914,0,70,6,64,
1915,0,70,7,63,
1916,0,70,6,64,
1917,0,70,6,64,
1918,0,71,7,64,
1919,0,72,7,65,
1920,0,73,7,66,
1921,0,72,6,66,
1922,0,71,6,65,
1923,0,74,7,67,
1924,0,72,6,66,
1925,0,73,7,66,
1926,0,73,7,66,
1927,0,73,7,66,
1928,0,74,7,67,
1929,0,76,7,69,
1930,0,74,6,68,
1931,0,73,6,67,
1932,0,75,7,68,
1933,0,74,7,67,
1934,0,75,6,69,
1935,0,74,6,68,
1936,0,76,7,69,
1937,0,74,6,68,
1938,0,77,7,70,
1939,0,76,6,70,
1940,0,75,6,69,
1941,0,77,7,70,
1942,0,77,7,70,
1943,0,76,6,70,
1944,0,78,7,71,
1945,0,77,6,71,
1946,0,77,7,70,
1947,0,77,6,71,
1948,0,77,6,71,
1949,0,80,7,73,
1950,0,77,6,71,
1951,0,78,7,71,
1952,0,80,7,73,
1953,0,79,6,73,
1954,0,79,7,72,
1955,0,79,6,73,
1956,0,81,8,73,
1957,0,80,7,73,
1958,0,83,8,75,
1959,0,80,6,74,
1960,0,81,7,74,
1961,0,80,6,74,
1962,0,81,7,74,
1963,0,81,6,75,
1964,0,81,7,74,
1965,0,82,7,75,
1966,0,80,6,74,
1967,0,84,7,77,
1968,0,82,6,76,
1969,0,81,6,75,
1970,0,83,7,76,
1971,0,83,7,76,
1972,0,82,7,75,
1973,0,82,6,76,
1974,0,85,9,76,
1975,0,83,7,76,
1976,0,83,7,76,
1977,0,80,7,73,
1978,0,69,8,61,
1979,0,56,6,50,
1980,0,54,8,46,
1981,0,50,6,44,
1982,0,42,6,36,
1983,0,32,6,26,
1984,0,26,6,20,
1985,0,23,7,16,
1986,0,32,9,23,
1987,0,39,6,33,
1988,0,42,7,35,
1989,0,40,6,34,
1990,0,41,7,34,
1991,0,41,6,35,
1992,0,43,7,36,
1993,0,41,6,35,
1994,0,45,7,38,
1995,0,42,6,36,
1996,0,45,7,38,
1997,0,44,6,38,
1998,0,45,7,38,
1999,0,45,6,39,
2000,0,46,7,39,
2001,0,47,7,40,
2002,0,46,6,40,
2003,0,49,7,42,
2004,0,48,6,42,
2005,0,47,6,41,
2006,0,51,7,44,
2007,0,49,6,43,
2008,0,49,7,42,
2009,0,50,6,44,
2010,0,49,6,43,
2011,0,51,7,44,
2012,0,52,7,45,
2013,0,51,6,45,
2014,0,51,6,45,
2015,0,54,7,47,
2016,0,52,6,46,
2017,0,54,7,47,
2018,0,52,6,46,
2019,0,55,7,48,
2020,0,55,7,48,
2021,0,54,6,48,
2022,0,54,6,48,
2023,0,57,8,49,
2024,0,54,6,48,
2025,0,57,7,50,
2026,0,56,6,50,
2027,0,56,7,49,
2028,0,57,6,51,
2029,0,56,6,50,
2030,0,59,7,52,
2031,0,58,6,52,
2032,0,57,6,51,
2033,0,59,7,52,
2034,0,58,6,52,
2035,0,60,7,53,
2036,0,59,6,53,
2037,0,60,7,53,
2038,0,60,6,54,
2039,0,61,7,54,
2040,0,60,7,53,
2041,0,61,6,55,
2042,0,60,6,54,
2043,0,61,7,54,
2044,0,63,7,56,
2045,0,62,6,56,
2046,0,62,7,55,
2047,0,64,7,57,
2048,0,63,6,57,
2049,0,63,7,56,
2050,0,63,6,57,
2051,0,65,8,57,
2052,0,65,7,58,
2053,0,63,6,57,
2054,0,65,7,58,
2055,0,65,7,58,
2056,0,65,6,59,
2057,0,64,6,58,
2058,0,66,7,59,
2059,0,66,6,60,
2060,0,66,7,59,
2061,0,67,7,60,
2062,0,66,6,60,
2063,0,68,7,61,
2064,0,67,6,61,
2065,0,66,6,60,
2066,0,69,7,62,
2067,0,67,6,61,
2068,0,68,7,61,
2069,0,69,7,62,
2070,0,69,6,63,
2071,0,68,6,62,
2072,0,70,7,63,
2073,0,69,6,63,
2074,0,69,6,63,
2075,0,71,7,64,
2076,0,69,6,63,
2077,0,73,9,64,
2078,0,72,8,64,
2079,0,71,6,65,
2080,0,72,7,65,
2081,0,71,7,64,
2082,0,74,7,67,
2083,0,72,6,66,
2084,0,71,6,65,
2085,0,73,7,66,
2086,0,72,6,66,
2087,0,75,7,68,
2088,0,73,6,67,
2089,0,73,7,66,
2090,0,74,6,68,
2091,0,74,6,68,
2092,0,74,7,67,
2093,0,76,7,69,
2094,0,74,6,68,
2095,0,75,7,68,
2096,0,75,7,68,
2097,0,75,6,69,
2098,0,74,6,68,
2099,0,78,8,70,
2100,0,78,7,71,
2101,0,76,6,70,
2102,0,77,7,70,
2103,0,77,7,70,
2104,0,77,6,71,
2105,0,77,7,70,
2106,0,77,6,71,
2107,0,78,8,70,
2108,0,80,7,73,
2109,0,86,12,74,
2110,0,84,11,73,
2111,0,85,11,74,
2112,0,84,12,72,
2113,0,86,13,73,
2114,0,85,11,74,
2115,0,86,12,74,
2116,0,85,11,74,
2117,0,86,12,74,
2118,0,88,11,77,
2119,0,86,11,75,
2120,0,87,12,75,
2121,0,87,11,76,
2122,0,88,12,76,
2123,0,88,13,75,
2124,0,85,10,75,
2125,0,82,7,75,
2126,0,82,7,75,
2127,0,81,6,75,
2128,0,83,7,76,
2129,0,83,8,75,
2130,0,83,7,76,
2131,0,83,7,76,
2132,0,83,7,76,
2133,0,82,6,76,
2134,0,83,7,76,
2135,0,82,7,75,
2136,0,82,6,76,
2137,0,70,6,64,
2138,0,58,7,51,
2139,0,53,6,47,
2140,0,50,6,44,
2141,0,46,7,39,
2142,0,38,8,30,
2143,0,28,6,22,
2144,0,26,7,19,
2145,0,28,8,20,
2146,0,39,6,33,
2147,0,39,6,33,
2148,0,41,7,34,
2149,0,41,6,35,
2150,0,40,6,34,
2151,0,43,7,36,
2152,0,41,6,35,
2153,0,44,7,37,
2154,0,43,7,36,
2155,0,45,7,38,
2156,0,43,6,37,
2157,0,46,7,39,
2158,0,45,6,39,
2159,0,47,7,40,
2160,0,47,7,40,
2161,0,46,6,40,
2162,0,47,7,40,
2163,0,49,7,42,
2164,0,48,7,41,
2165,0,49,7,42,
2166,0,48,6,42,
2167,0,51,7,44,
2168,0,52,8,44,
2169,0,50,7,43,
2170,0,53,8,45,
2171,0,53,8,45,
2172,0,52,7,45,
2173,0,51,6,45,
2174,0,54,8,46,
2175,0,52,6,46,
2176,0,52,6,46,
2177,0,55,8,47,
2178,0,53,6,47,
2179,0,55,7,48,
2180,0,55,7,48,
2181,0,55,7,48,
2182,0,56,7,49,
2183,0,54,6,48,
2184,0,58,7,51,
2185,0,57,7,50,
2186,0,55,6,49,
2187,0,58,7,51,
2188,0,57,6,51,
2189,0,57,7,50,
2190,0,58,6,52,
2191,0,57,6,51,
2192,0,59,7,52,
2193,0,59,6,53,
2194,0,58,6,52,
2195,0,60,7,53,
2196,0,59,6,53,
2197,0,62,7,55,
2198,0,60,7,53,
2199,0,60,6,54,
2200,0,61,7,54,
2201,0,62,7,55,
2202,0,61,6,55,
2203,0,62,7,55,
2204,0,63,8,55,
2205,0,61,6,55,
2206,0,64,7,57,
2207,0,63,6,57,
2208,0,63,7,56,
2209,0,63,6,57,
2210,0,63,6,57,
2211,0,66,7,59,
2212,0,64,6,58,
2213,0,63,6,57,
2214,0,66,7,59,
2215,0,64,6,58,
2216,0,66,7,59,
2217,0,66,7,59,
2218,0,66,6,60,
2219,0,65,6,59,
2220,0,67,7,60,
2221,0,68,7,61,
2222,0,67,6,61,
2223,0,69,8,61,
2224,0,67,7,60,
2225,0,68,6,62,
2226,0,67,6,61,
2227,0,69,7,62,
2228,0,68,6,62,
2229,0,68,6,62,
2230,0,70,7,63,
2231,0,70,7,63,
2232,0,69,6,63,
2233,0,70,7,63,
2234,0,70,6,64,
2235,0,69,6,63,
2236,0,71,7,64,
2237,0,72,7,65,
2238,0,71,6,65,
2239,0,70,6,64,
2240,0,71,7,64,
2241,0,72,6,66,
2242,0,72,7,65,
2243,0,73,7,66,
2244,0,71,6,65,
2245,0,77,11,66,
2246,0,74,7,67,
2247,0,72,6,66,
2248,0,74,7,67,
2249,0,72,6,66,
2250,0,74,7,67,
2251,0,74,6,68,
2252,0,74,7,67,
2253,0,74,6,68,
2254,0,76,7,69,
2255,0,75,6,69,
2256,0,74,6,68,
2257,0,76,7,69,
2258,0,74,6,68,
2259,0,80,9,71,
2260,0,76,6,70,
2261,0,76,7,69,
2262,0,75,6,69,
2263,0,78,7,71,
2264,0,77,6,71,
2265,0,78,7,71,
2266,0,79,8,71,
2267,0,78,7,71,
2268,0,77,6,71,
2269,0,79,7,72,
2270,0,78,7,71,
2271,0,78,6,72,
2272,0,78,6,72,
2273,0,81,7,74,
2274,0,79,6,73,
2275,0,78,6,72,
2276,0,80,7,73,
2277,0,81,7,74,
2278,0,79,6,73,
2279,0,81,7,74,
2280,0,79,6,73,
2281,0,81,7,74,
2282,0,80,6,74,
2283,0,82,7,75,
2284,0,82,7,75,
2285,0,81,6,75,
2286,0,81,7,74,
2287,0,83,7,76,
2288,0,82,6,76,
2289,0,82,7,75,
2290,0,84,7,77,
2291,0,82,6,76,
2292,0,83,7,76,
2293,0,83,7,76,
2294,0,81,6,75,
2295,0,82,7,75,
2296,0,84,8,76,
2297,0,78,6,72,
2298,0,66,6,60,
2299,0,56,7,49,
2300,0,53,6,47,
2301,0,49,6,43,
2302,0,42,6,36,
2303,0,33,7,26,
2304,0,26,6,20,
2305,0,24,7,17,
2306,0,30,6,24,
2307,0,38,6,32,
2308,0,42,7,35,
2309,0,40,6,34,
2310,0,40,6,34,
2311,0,42,7,35,
2312,0,41,6,35,
2313,0,43,7,36,
2314,0,43,6,37,
2315,0,45,7,38,
2316,0,43,6,37,
2317,0,47,7,40,
2318,0,45,6,39,
2319,0,46,7,39,
2320,0,46,6,40,
2321,0,46,7,39,
2322,0,46,6,40,
2323,0,48,7,41,
2324,0,47,6,41,
2325,0,50,7,43,
2326,0,49,7,42,
2327,0,49,7,42,
2328,0,49,7,42,
2329,0,52,8,44,
2330,0,51,7,44,
2331,0,50,6,44,
2332,0,52,7,45,
2333,0,51,6,45,
2334,0,51,6,45,
2335,0,53,7,46,
2336,0,53,6,47,
2337,0,53,7,46,
2338,0,54,7,47,
2339,0,53,6,47,
2340,0,55,7,48,
2341,0,53,6,47,
2342,0,55,7,48,
2343,0,55,6,49,
2344,0,55,7,48,
2345,0,57,7,50,
2346,0,56,7,49,
2347,0,56,6,50,
2348,0,57,7,50,
2349,0,57,6,51,
2350,0,61,9,52,
2351,0,58,6,52,
2352,0,58,7,51,
2353,0,57,6,51,
2354,0,60,7,53,
2355,0,59,7,52,
2356,0,60,7,53,
2357,0,59,6,53,
2358,0,61,7,54,
2359,0,61,7,54,
2360,0,60,6,54,
2361,0,62,7,55,
2362,0,60,6,54,
2363,0,63,7,56,
2364,0,62,6,56,
2365,0,62,7,55,
2366,0,62,6,56,
2367,0,63,6,57,
2368,0,63,7,56,
2369,0,63,6,57,
2370,0,62,6,56,
2371,0,65,7,58,
2372,0,63,6,57,
2373,0,66,7,59,
2374,0,65,6,59,
2375,0,66,7,59,
2376,0,65,6,59,
2377,0,65,7,58,
2378,0,66,6,60,
2379,0,66,7,59,
2380,0,66,7,59,
2381,0,67,7,60,
2382,0,68,7,61,
2383,0,67,6,61,
2384,0,68,7,61,
2385,0,67,6,61,
2386,0,68,7,61,
2387,0,69,7,62,
2388,0,68,7,61,
2389,0,70,7,63,
2390,0,68,6,62,
2391,0,70,7,63,
2392,0,69,6,63,
2393,0,69,6,63,
2394,0,71,7,64,
2395,0,69,6,63,
2396,0,70,7,63,
2397,0,71,6,65,
2398,0,71,7,64,
2399,0,71,7,64,
2400,0,72,7,65,
2401,0,71,6,65,
2402,0,73,7,66,
2403,0,71,6,65,
2404,0,73,7,66,
2405,0,73,7,66,
2406,0,73,6,67,
2407,0,73,7,66,
2408,0,73,6,67,
2409,0,73,7,66,
2410,0,75,7,68,
2411,0,75,7,68,
2412,0,73,6,67,
2413,0,75,7,68,
2414,0,76,7,69,
2415,0,76,7,69,
2416,0,75,6,69,
2417,0,75,7,68,
2418,0,75,6,69,
2419,0,76,6,70,
2420,0,76,7,69,
2421,0,76,6,70,
2422,0,75,6,69,
2423,0,77,7,70,
2424,0,76,6,70,
2425,0,77,7,70,
2426,0,77,6,71,
2427,0,76,6,70,
2428,0,80,7,73,
2429,0,78,7,71,
2430,0,80,7,73,
2431,0,78,6,72,
2432,0,78,7,71,
2433,0,80,7,73,
2434,0,78,6,72,
2435,0,80,8,72,
2436,0,79,6,73,
2437,0,79,6,73,
2438,0,80,7,73,
2439,0,79,6,73,
2440,0,81,7,74,
2441,0,82,9,73,
2442,0,80,7,73,
2443,0,81,6,75,
2444,0,82,7,75,
2445,0,82,7,75,
2446,0,81,6,75,
2447,0,80,6,74,
2448,0,83,8,75,
2449,0,83,7,76,
2450,0,81,6,75,
2451,0,83,7,76,
2452,0,82,6,76,
2453,0,82,7,75,
2454,0,82,6,76,
2455,0,81,6,75,
2456,0,84,7,77,
2457,0,82,6,76,
2458,0,75,6,69,
2459,0,64,7,57,
2460,0,55,7,48,
2461,0,53,6,47,
2462,0,47,7,40,
2463,0,39,8,31,
2464,0,30,6,24,
2465,0,24,6,18,
2466,0,26,7,19,
2467,0,33,6,27,
2468,0,39,7,32,
2469,0,41,7,34,
2470,0,39,6,33,
2471,0,42,7,35,
2472,0,43,7,36,
2473,0,43,7,36,
2474,0,43,6,37,
2475,0,44,7,37,
2476,0,43,6,37,
2477,0,46,7,39,
2478,0,45,6,39,
2479,0,45,7,38,
2480,0,46,6,40,
2481,0,45,6,39,
2482,0,48,7,41,
2483,0,47,6,41,
2484,0,46,6,40,
2485,0,50,7,43,
2486,0,48,6,42,
2487,0,49,7,42,
2488,0,50,7,43,
2489,0,49,6,43,
2490,0,50,7,43,
2491,0,51,7,44,
2492,0,51,7,44,
2493,0,53,7,46,
2494,0,52,6,46,
2495,0,51,6,45,
2496,0,52,7,45,
2497,0,53,7,46,
2498,0,53,6,47,
2499,0,52,6,46,
2500,0,55,7,48,
2501,0,55,7,48,
2502,0,54,6,48,
2503,0,54,6,48,
2504,0,56,7,49,
2505,0,55,7,48,
2506,0,56,6,50,
2507,0,55,6,49,
2508,0,57,7,50,
2509,0,56,6,50,
2510,0,59,7,52,
2511,0,57,6,51,
2512,0,57,6,51,
2513,0,60,7,53,
2514,0,58,6,52,
2515,0,62,8,54,
2516,0,61,7,54,
2517,0,59,6,53,
2518,0,59,6,53,
2519,0,61,7,54,
2520,0,59,6,53,
2521,0,61,7,54,
2522,0,61,6,55,
2523,0,60,6,54,
2524,0,62,7,55,
2525,0,62,7,55,
2526,0,62,7,55,
2527,0,63,7,56,
2528,0,62,6,56,
2529,0,65,7,58,
2530,0,63,6,57,
2531,0,63,7,56,
2532,0,66,8,58,
2533,0,65,7,58,
2534,0,63,6,57,
2535,0,66,7,59,
2536,0,65,7,58,
2537,0,65,6,59,
2538,0,65,7,58,
2539,0,67,7,60,
2540,0,67,7,60,
2541,0,66,6,60,
2542,0,65,6,59,
2543,0,69,7,62,
2544,0,67,6,61,
2545,0,67,7,60,
2546,0,68,6,62,
2547,0,67,6,61,
2548,0,69,7,62,
2549,0,68,6,62,
2550,0,70,7,63,
2551,0,69,7,62,
2552,0,70,7,63,
2553,0,69,7,62,
2554,0,70,7,63,
2555,0,71,7,64,
2556,0,69,6,63,
2557,0,73,8,65,
2558,0,71,6,65,
2559,0,70,6,64,
2560,0,73,8,65,
2561,0,71,6,65,
2562,0,73,8,65,
2563,0,72,7,65,
2564,0,73,7,66,
2565,0,71,6,65,
2566,0,73,8,65,
2567,0,73,7,66,
2568,0,73,6,67,
2569,0,74,7,67,
2570,0,73,7,66,
2571,0,74,6,68,
2572,0,73,6,67,
2573,0,75,7,68,
2574,0,74,6,68,
2575,0,74,7,67,
2576,0,75,6,69,
2577,0,77,7,70,
2578,0,75,6,69,
2579,0,75,7,68,
2580,0,77,7,70,
2581,0,75,6,69,
2582,0,76,7,69,
2583,0,76,7,69,
2584,0,76,6,70,
2585,0,76,6,70,
2586,0,78,7,71,
2587,0,79,7,72,
2588,0,77,6,71,
2589,0,77,6,71,
2590,0,79,7,72,
2591,0,78,6,72,
2592,0,80,7,73,
2593,0,78,7,71,
2594,0,81,8,73,
2595,0,78,6,72,
2596,0,81,7,74,
2597,0,78,6,72,
2598,0,79,7,72,
2599,0,81,8,73,
2600,0,80,7,73,
2601,0,80,6,74,
2602,0,80,7,73,
2603,0,82,7,75,
2604,0,80,6,74,
2605,0,83,7,76,
2606,0,81,6,75,
2607,0,80,6,74,
2608,0,84,7,77,
2609,0,82,6,76,
2610,0,82,7,75,
2611,0,83,7,76,
2612,0,81,6,75,
2613,0,83,7,76,
2614,0,82,6,76,
2615,0,81,6,75,
2616,0,83,7,76,
2617,0,83,7,76,
2618,0,82,7,75,
2619,0,75,6,69,
2620,0,63,7,56,
2621,0,53,7,46,
2622,0,53,7,46,
2623,0,51,10,41,
2624,0,37,6,31,
2625,0,29,6,23,
2626,0,25,7,18,
2627,0,26,6,20,
2628,0,35,7,28,
2629,0,38,6,32,
2630,0,41,7,34,
2631,0,42,7,35,
2632,0,41,7,34,
2633,0,42,6,36,
2634,0,41,6,35,
2635,0,45,7,38,
2636,0,43,6,37,
2637,0,44,7,37,
2638,0,45,7,38,
2639,0,48,9,39,
2640,0,54,13,41,
2641,0,53,12,41,
2642,0,52,12,40,
2643,0,53,10,43,
2644,0,54,11,43,
2645,0,55,12,43,
2646,0,54,12,42,
2647,0,55,12,43,
2648,0,55,11,44,
2649,0,57,10,47,
2650,0,56,11,45,
2651,0,59,12,47,
2652,0,59,11,48,
2653,0,60,13,47,
2654,0,59,11,48,
2655,0,59,11,48,
2656,0,59,11,48,
2657,0,59,12,47,
2658,0,63,13,50,
2659,0,60,11,49,
2660,0,60,12,48,
2661,0,63,13,50,
2662,0,63,11,52,
2663,0,63,11,52,
2664,0,62,12,50,
2665,0,64,13,51,
2666,0,65,12,53,
2667,0,63,11,52,
2668,0,63,11,52,
2669,0,65,12,53,
2670,0,64,11,53,
2671,0,66,11,55,
2672,0,65,11,54,
2673,0,67,12,55,
2674,0,67,12,55,
2675,0,67,11,56,
2676,0,66,11,55,
2677,0,69,12,57,
2678,0,68,10,58,
2679,0,67,12,55,
2680,0,70,12,58,
2681,0,69,12,57,
2682,0,69,11,58,
2683,0,72,12,60,
2684,0,70,10,60,
2685,0,69,11,58,
2686,0,71,13,58,
2687,0,70,12,58,
2688,0,71,13,58,
2689,0,71,12,59,
2690,0,71,12,59,
2691,0,72,12,60,
2692,0,71,12,59,
2693,0,73,12,61,
2694,0,73,12,61,
2695,0,73,12,61,
2696,0,73,11,62,
2697,0,74,12,62,
2698,0,74,12,62,
2699,0,73,10,63,
2700,0,75,12,63,
2701,0,75,11,64,
2702,0,74,11,63,
2703,0,76,13,63,
2704,0,73,11,62,
2705,0,75,11,64,
2706,0,76,12,64,
2707,0,77,11,66,
2708,0,76,12,64,
2709,0,80,14,66,
2710,0,77,11,66,
2711,0,78,12,66,
2712,0,78,12,66,
2713,0,78,11,67,
2714,0,81,14,67,
2715,0,81,13,68,
2716,0,79,12,67,
2717,0,81,13,68,
2718,0,79,11,68,
2719,0,80,11,69,
2720,0,81,12,69,
2721,0,80,12,68,
2722,0,80,11,69,
2723,0,81,11,70,
2724,0,83,13,70,
2725,0,81,10,71,
2726,0,84,12,72,
2727,0,82,12,70,
2728,0,83,13,70,
2729,0,82,12,70,
2730,0,82,11,71,
2731,0,83,12,71,
2732,0,83,12,71,
2733,0,84,12,72,
2734,0,85,13,72,
2735,0,85,13,72,
2736,0,84,11,73,
2737,0,84,12,72,
2738,0,87,13,74,
2739,0,85,11,74,
2740,0,87,13,74,
2741,0,87,11,76,
2742,0,85,11,74,
2743,0,86,12,74,
2744,0,85,12,73,
2745,0,85,11,74,
2746,0,87,11,76,
2747,0,88,12,76,
2748,0,87,12,75,
2749,0,88,13,75,
2750,0,88,12,76,
2751,0,88,11,77,
2752,0,89,12,77,
2753,0,87,11,76,
2754,0,89,12,77,
2755,0,89,12,77,
2756,0,89,12,77,
2757,0,88,10,78,
2758,0,88,11,77,
2759,0,89,12,77,
2760,0,88,12,76,
2761,0,88,11,77,
2762,0,89,12,77,
2763,0,83,7,76,
2764,0,75,7,68,
2765,0,63,7,56,
2766,0,53,6,47,
2767,0,53,7,46,
2768,0,47,6,41,
2769,0,41,6,35,
2770,0,39,7,32,
2771,0,38,6,32,
2772,0,41,6,35,
2773,0,51,7,44,
2774,0,56,7,49,
2775,0,55,6,49,
2776,0,57,7,50,
2777,0,55,6,49,
2778,0,56,7,49,
2779,0,57,6,51,
2780,0,56,6,50,
2781,0,59,7,52,
2782,0,58,6,52,
2783,0,58,7,51,
2784,0,58,6,52,
2785,0,58,6,52,
2786,0,59,7,52,
2787,0,61,7,54,
2788,0,59,6,53,
2789,0,60,7,53,
2790,0,61,7,54,
2791,0,59,6,53,
2792,0,62,7,55,
2793,0,60,6,54,
2794,0,63,7,56,
2795,0,62,6,56,
2796,0,63,7,56,
2797,0,61,6,55,
2798,0,63,7,56,
2799,0,64,7,57,
2800,0,63,6,57,
2801,0,65,7,58,
2802,0,65,7,58,
2803,0,63,6,57,
2804,0,66,9,57,
2805,0,66,8,58,
2806,0,65,7,58,
2807,0,65,6,59,
2808,0,64,6,58,
2809,0,68,7,61,
2810,0,66,6,60,
2811,0,67,7,60,
2812,0,67,7,60,
2813,0,69,8,61,
2814,0,66,6,60,
2815,0,68,7,61,
2816,0,67,6,61,
2817,0,68,7,61,
2818,0,68,6,62,
2819,0,67,6,61,
2820,0,69,7,62,
2821,0,68,6,62,
2822,0,70,7,63,
2823,0,69,6,63,
2824,0,70,7,63,
2825,0,72,8,64,
2826,0,69,6,63,
2827,0,73,8,65,
2828,0,70,6,64,
2829,0,72,7,65,
2830,0,71,7,64,
2831,0,71,6,65,
2832,0,71,6,65,
2833,0,72,7,65,
2834,0,72,6,66,
2835,0,74,8,66,
2836,0,72,7,65,
2837,0,74,7,67,
2838,0,72,6,66,
2839,0,75,7,68,
2840,0,73,6,67,
2841,0,73,7,66,
2842,0,75,7,68,
2843,0,73,6,67,
2844,0,75,7,68,
2845,0,73,6,67,
2846,0,77,7,70,
2847,0,75,6,69,
2848,0,74,6,68,
2849,0,76,7,69,
2850,0,75,6,69,
2851,0,78,7,71,
2852,0,76,6,70,
2853,0,76,7,69,
2854,0,76,6,70,
2855,0,76,6,70,
2856,0,79,7,72,
2857,0,79,7,72,
2858,0,77,6,71,
2859,0,77,7,70,
2860,0,79,7,72,
2861,0,80,7,73,
2862,0,78,6,72,
2863,0,77,6,71,
2864,0,80,7,73,
2865,0,80,7,73,
2866,0,79,6,73,
2867,0,79,7,72,
2868,0,79,6,73,
2869,0,79,6,73,
2870,0,81,7,74,
2871,0,79,6,73,
2872,0,81,7,74,
2873,0,81,8,73,
2874,0,81,6,75,
2875,0,81,7,74,
2876,0,81,6,75,
2877,0,81,6,75,
2878,0,82,7,75,
2879,0,82,6,76,
2880,0,82,7,75,
2881,0,82,6,76,
2882,0,82,7,75,
2883,0,82,6,76,
2884,0,82,6,76,
2885,0,82,7,75,
2886,0,82,6,76,
2887,0,83,8,75,
2888,0,82,7,75,
2889,0,79,7,72,
2890,0,67,7,60,
2891,0,55,6,49,
2892,0,52,6,46,
2893,0,49,7,42,
2894,0,40,6,34,
2895,0,34,8,26,
2896,0,25,6,19,
2897,0,25,7,18,
2898,0,32,7,25,
2899,0,41,7,34,
2900,0,40,6,34,
2901,0,41,7,34,
2902,0,42,7,35,
2903,0,42,8,34,
2904,0,43,7,36,
2905,0,47,8,39,
2906,0,43,6,37,
2907,0,44,7,37,
2908,0,45,7,38,
2909,0,45,6,39,
2910,0,45,7,38,
2911,0,46,6,40,
2912,0,46,7,39,
2913,0,48,7,41,
2914,0,46,6,40,
2915,0,49,7,42,
2916,0,48,6,42,
2917,0,47,6,41,
2918,0,50,7,43,
2919,0,48,6,42,
2920,0,52,8,44,
2921,0,50,7,43,
2922,0,51,7,44,
2923,0,51,6,45,
2924,0,50,6,44,
2925,0,52,7,45,
2926,0,53,8,45,
2927,0,52,7,45,
2928,0,54,7,47,
2929,0,52,6,46,
2930,0,54,7,47,
2931,0,54,6,48,
2932,0,55,7,48,
2933,0,53,6,47,
2934,0,55,7,48,
2935,0,57,7,50,
2936,0,55,7,48,
2937,0,56,6,50,
2938,0,56,7,49,
2939,0,58,7,51,
2940,0,57,6,51,
2941,0,56,6,50,
2942,0,59,7,52,
2943,0,57,6,51,
2944,0,60,7,53,
2945,0,58,6,52,
2946,0,59,7,52,
2947,0,59,6,53,
2948,0,58,6,52,
2949,0,63,8,55,
2950,0,59,6,53,
2951,0,62,8,54,
2952,0,63,7,56,
2953,0,61,6,55,
2954,0,61,7,54,
2955,0,62,6,56,
2956,0,62,7,55,
2957,0,63,7,56,
2958,0,61,6,55,
2959,0,65,7,58,
2960,0,63,6,57,
2961,0,63,7,56,
2962,0,64,6,58,
2963,0,65,7,58,
2964,0,64,7,57,
2965,0,65,7,58,
2966,0,64,6,58,
2967,0,69,9,60,
2968,0,65,6,59,
2969,0,65,7,58,
2970,0,66,6,60,
2971,0,65,6,59,
2972,0,68,7,61,
2973,0,67,6,61,
2974,0,67,7,60,
2975,0,67,6,61,
2976,0,67,7,60,
2977,0,68,6,62,
2978,0,68,6,62,
2979,0,69,7,62,
2980,0,68,7,61,
2981,0,69,6,63,
2982,0,69,7,62,
2983,0,70,7,63,
2984,0,68,6,62,
2985,0,72,7,65,
2986,0,74,9,65,
2987,0,74,10,64,
2988,0,70,6,64,
2989,0,71,7,64,
2990,0,71,6,65,
2991,0,70,6,64,
2992,0,73,7,66,
2993,0,73,8,65,
2994,0,72,6,66,
2995,0,73,8,65,
2996,0,71,6,65,
2997,0,74,7,67,
2998,0,72,6,66,
2999,0,75,7,68,
3000,0,73,6,67,
3001,0,72,6,66,
3002,0,75,7,68,
3003,0,74,6,68,
3004,0,75,7,68,
3005,0,74,7,67,
3006,0,75,6,69,
3007,0,74,6,68,
3008,0,76,7,69,
3009,0,75,7,68,
3010,0,77,7,70,
3011,0,78,8,70,
3012,0,75,6,69,
3013,0,77,7,70,
3014,0,75,6,69,
3015,0,79,7,72,
3016,0,77,6,71,
3017,0,78,8,70,
3018,0,78,7,71,
3019,0,77,6,71,
3020,0,79,7,72,
3021,0,79,7,72,
3022,0,78,7,71,
3023,0,78,6,72,
3024,0,79,6,73,
3025,0,80,7,73,
3026,0,79,7,72,
3027,0,79,6,73,
3028,0,79,7,72,
3029,0,81,7,74,
3030,0,79,6,73,
3031,0,82,7,75,
3032,0,80,7,73,
3033,0,80,6,74,
3034,0,81,7,74,
3035,0,82,7,75,
3036,0,80,6,74,
3037,0,82,7,75,
3038,0,81,6,75,
3039,0,82,7,75,
3040,0,83,7,76,
3041,0,81,6,75,
3042,0,83,7,76,
3043,0,81,6,75,
3044,0,84,7,77,
3045,0,83,7,76,
3046,0,82,6,76,
3047,0,83,7,76,
3048,0,81,6,75,
3049,0,80,7,73,
3050,0,67,6,61,
3051,0,56,7,49,
3052,0,54,7,47,
3053,0,50,7,43,
3054,0,39,6,33,
3055,0,32,7,25,
3056,0,26,6,20,
3057,0,24,7,17,
3058,0,33,7,26,
3059,0,38,6,32,
3060,0,41,7,34,
3061,0,39,6,33,
3062,0,42,7,35,
3063,0,42,6,36,
3064,0,42,7,35,
3065,0,43,6,37,
3066,0,43,7,36,
3067,0,45,7,38,
3068,0,43,6,37,
3069,0,47,7,40,
3070,0,45,6,39,
3071,0,47,8,39,
3072,0,46,6,40,
3073,0,46,6,40,
3074,0,48,7,41,
3075,0,46,6,40,
3076,0,50,7,43,
3077,0,52,9,43,
3078,0,49,7,42,
3079,0,50,7,43,
3080,0,51,7,44,
3081,0,49,6,43,
3082,0,52,7,45,
3083,0,51,6,45,
3084,0,50,6,44,
3085,0,53,7,46,
3086,0,54,8,46,
3087,0,51,6,45,
3088,0,55,7,48,
3089,0,53,6,47,
3090,0,54,7,47,
3091,0,54,7,47,
3092,0,56,7,49,
3093,0,54,6,48,
3094,0,57,7,50,
3095,0,55,6,49,
3096,0,56,7,49,
3097,0,56,6,50,
3098,0,55,6,49,
3099,0,60,8,52,
3100,0,56,6,50,
3101,0,58,7,51,
3102,0,59,7,52,
3103,0,58,6,52,
3104,0,58,7,51,
3105,0,59,6,53,
3106,0,58,6,52,
3107,0,61,7,54,
3108,0,60,7,53,
3109,0,59,6,53,
3110,0,61,7,54,
3111,0,59,6,53,
3112,0,63,7,56,
3113,0,61,6,55,
3114,0,61,7,54,
3115,0,63,7,56,
3116,0,61,6,55,
3117,0,64,7,57,
3118,0,62,6,56,
3119,0,63,7,56,
3120,0,63,6,57,
3121,0,62,6,56,
3122,0,67,8,59,
3123,0,64,6,58,
3124,0,64,7,57,
3125,0,64,6,58,
3126,0,65,7,58,
3127,0,66,7,59,
3128,0,64,6,58,
3129,0,68,8,60,
3130,0,67,7,60,
3131,0,66,7,59,
3132,0,67,7,60,
3133,0,68,7,61,
3134,0,66,6,60,
3135,0,68,7,61,
3136,0,66,6,60,
3137,0,70,7,63,
3138,0,71,7,64,
3139,0,68,7,61,
3140,0,69,7,62,
3141,0,69,6,63,
3142,0,68,6,62,
3143,0,71,7,64,
3144,0,69,6,63,
3145,0,71,7,64,
3146,0,70,7,63,
3147,0,70,6,64,
3148,0,69,6,63,
3149,0,72,7,65,
3150,0,71,6,65,
3151,0,71,7,64,
3152,0,70,6,64,
3153,0,72,7,65,
3154,0,73,7,66,
3155,0,71,6,65,
3156,0,73,7,66,
3157,0,73,6,67,
3158,0,72,6,66,
3159,0,74,7,67,
3160,0,72,6,66,
3161,0,75,7,68,
3162,0,75,7,68,
3163,0,74,7,67,
3164,0,74,6,68,
3165,0,73,6,67,
3166,0,76,7,69,
3167,0,75,6,69,
3168,0,80,10,70,
3169,0,76,7,69,
3170,0,77,7,70,
3171,0,75,6,69,
3172,0,78,7,71,
3173,0,76,6,70,
3174,0,77,7,70,
3175,0,77,6,71,
3176,0,77,7,70,
3177,0,78,7,71,
3178,0,78,7,71,
3179,0,77,6,71,
3180,0,80,7,73,
3181,0,78,6,72,
3182,0,77,6,71,
3183,0,79,7,72,
3184,0,78,6,72,
3185,0,80,7,73,
3186,0,79,6,73,
3187,0,81,7,74,
3188,0,79,6,73,
3189,0,79,6,73,
3190,0,80,7,73,
3191,0,82,7,75,
3192,0,80,6,74,
3193,0,82,9,73,
3194,0,81,6,75,
3195,0,80,6,74,
3196,0,83,7,76,
3197,0,83,7,76,
3198,0,81,6,75,
3199,0,82,7,75,
3200,0,83,7,76,
3201,0,82,6,76,
3202,0,84,7,77,
3203,0,82,6,76,
3204,0,81,6,75,
3205,0,83,7,76,
3206,0,81,6,75,
3207,0,84,7,77,
3208,0,82,7,75,
3209,0,73,6,67,
3210,0,61,6,55,
3211,0,55,7,48,
3212,0,52,6,46,
3213,0,47,7,40,
3214,0,36,6,30,
3215,0,31,8,23,
3216,0,23,6,17,
3217,0,27,7,20,
3218,0,37,6,31,
3219,0,39,7,32,
3220,0,40,6,34,
3221,0,41,7,34,
3222,0,42,7,35,
3223,0,43,8,35,
3224,0,42,7,35,
3225,0,43,6,37,
3226,0,44,7,37,
3227,0,44,6,38,
3228,0,45,7,38,
3229,0,46,7,39,
3230,0,44,6,38,
3231,0,48,7,41,
3232,0,48,7,41,
3233,0,47,6,41,
3234,0,47,7,40,
3235,0,48,6,42,
3236,0,49,7,42,
3237,0,47,6,41,
3238,0,50,7,43,
3239,0,50,7,43,
3240,0,50,6,44,
3241,0,50,7,43,
3242,0,52,7,45,
3243,0,50,6,44,
3244,0,52,7,45,
3245,0,51,6,45,
3246,0,54,7,47,
3247,0,52,6,46,
3248,0,52,6,46,
3249,0,54,7,47,
3250,0,54,6,48,
3251,0,57,8,49,
3252,0,54,6,48,
3253,0,56,7,49,
3254,0,56,7,49,
3255,0,54,6,48,
3256,0,58,7,51,
3257,0,56,6,50,
3258,0,56,7,49,
3259,0,58,8,50,
3260,0,57,7,50,
3261,0,58,7,51,
3262,0,59,7,52,
3263,0,59,7,52,
3264,0,60,7,53,
3265,0,60,7,53,
3266,0,61,7,54,
3267,0,59,6,53,
3268,0,60,7,53,
3269,0,60,6,54,
3270,0,59,6,53,
3271,0,63,7,56,
3272,0,61,6,55,
3273,0,63,7,56,
3274,0,61,7,54,
3275,0,62,6,56,
3276,0,64,7,57,
3277,0,61,6,55,
3278,0,64,7,57,
3279,0,63,6,57,
3280,0,65,7,58,
3281,0,63,6,57,
3282,0,64,7,57,
3283,0,64,6,58,
3284,0,65,7,58,
3285,0,64,6,58,
3286,0,67,7,60,
3287,0,65,6,59,
3288,0,65,7,58,
3289,0,66,6,60,
3290,0,67,7,60,
3291,0,65,6,59,
3292,0,67,7,60,
3293,0,67,6,61,
3294,0,67,7,60,
3295,0,67,6,61,
3296,0,68,8,60,
3297,0,68,6,62,
3298,0,70,7,63,
3299,0,67,6,61,
3300,0,71,7,64,
3301,0,69,6,63,
3302,0,69,7,62,
3303,0,69,6,63,
3304,0,70,7,63,
3305,0,70,6,64,
3306,0,70,6,64,
3307,0,70,7,63,
3308,0,71,6,65,
3309,0,71,7,64,
3310,0,71,7,64,
3311,0,72,7,65,
3312,0,71,6,65,
3313,0,74,7,67,
3314,0,73,7,66,
3315,0,73,7,66,
3316,0,72,6,66,
3317,0,73,7,66,
3318,0,73,6,67,
3319,0,74,7,67,
3320,0,77,9,68,
3321,0,76,7,69,
3322,0,75,7,68,
3323,0,74,7,67,
3324,0,74,6,68,
3325,0,75,7,68,
3326,0,75,6,69,
3327,0,76,7,69,
3328,0,75,6,69,
3329,0,75,7,68,
3330,0,76,6,70,
3331,0,76,7,69,
3332,0,76,6,70,
3333,0,75,6,69,
3334,0,79,7,72,
3335,0,77,6,71,
3336,0,77,7,70,
3337,0,77,6,71,
3338,0,77,7,70,
3339,0,78,7,71,
3340,0,78,6,72,
3341,0,81,7,74,
3342,0,78,6,72,
3343,0,79,7,72,
3344,0,79,7,72,
3345,0,79,7,72,
3346,0,79,6,73,
3347,0,78,6,72,
3348,0,82,7,75,
3349,0,80,6,74,
3350,0,85,10,75,
3351,0,79,6,73,
3352,0,81,7,74,
3353,0,82,7,75,
3354,0,83,7,76,
3355,0,81,7,74,
3356,0,81,7,74,
3357,0,81,7,74,
3358,0,83,7,76,
3359,0,82,7,75,
3360,0,82,6,76,
3361,0,81,6,75,
3362,0,84,7,77,
3363,0,83,7,76,
3364,0,82,6,76,
3365,0,82,7,75,
3366,0,82,6,76,
3367,0,81,6,75,
3368,0,79,7,72,
3369,0,67,6,61,
3370,0,56,7,49,
3371,0,52,6,46,
3372,0,50,7,43,
3373,0,41,6,35,
3374,0,33,7,26,
3375,0,28,8,20,
3376,0,23,6,17,
3377,0,32,7,25,
3378,0,39,6,33,
3379,0,40,7,33,
3380,0,40,6,34,
3381,0,42,7,35,
3382,0,41,7,34,
3383,0,43,7,36,
3384,0,45,7,38,
3385,0,43,6,37,
3386,0,44,7,37,
3387,0,45,7,38,
3388,0,44,6,38,
3389,0,46,7,39,
3390,0,44,6,38,
3391,0,48,7,41,
3392,0,46,6,40,
3393,0,47,7,40,
3394,0,47,6,41,
3395,0,47,6,41,
3396,0,49,7,42,
3397,0,48,6,42,
3398,0,51,7,44,
3399,0,49,6,43,
3400,0,50,7,43,
3401,0,50,6,44,
3402,0,51,7,44,
3403,0,52,7,45,
3404,0,50,6,44,
3405,0,55,8,47,
3406,0,52,6,46,
3407,0,53,7,46,
3408,0,53,6,47,
3409,0,52,6,46,
3410,0,55,7,48,
3411,0,55,7,48,
3412,0,54,6,48,
3413,0,55,7,48,
3414,0,55,6,49,
3415,0,54,6,48,
3416,0,57,7,50,
3417,0,56,7,49,
3418,0,57,7,50,
3419,0,57,6,51,
3420,0,57,7,50,
3421,0,57,6,51,
3422,0,58,7,51,
3423,0,59,7,52,
3424,0,57,6,51,
3425,0,60,7,53,
3426,0,59,6,53,
3427,0,59,7,52,
3428,0,61,7,54,
3429,0,59,6,53,
3430,0,61,7,54,
3431,0,60,6,54,
3432,0,62,8,54,
3433,0,63,7,56,
3434,0,64,7,57,
3435,0,62,6,56,
3436,0,63,7,56,
3437,0,62,7,55,
3438,0,63,6,57,
3439,0,63,7,56,
3440,0,63,6,57,
3441,0,66,8,58,
3442,0,65,7,58,
3443,0,64,6,58,
3444,0,66,8,58,
3445,0,65,7,58,
3446,0,67,7,60,
3447,0,65,6,59,
3448,0,66,7,59,
3449,0,67,7,60,
3450,0,65,6,59,
3451,0,67,7,60,
3452,0,66,6,60,
3453,0,69,7,62,
3454,0,67,6,61,
3455,0,66,6,60,
3456,0,69,7,62,
3457,0,67,6,61,
3458,0,69,7,62,
3459,0,68,6,62,
3460,0,71,7,64,
3461,0,69,6,63,
3462,0,68,6,62,
3463,0,70,7,63,
3464,0,71,7,64,
3465,0,69,6,63,
3466,0,71,7,64,
3467,0,72,7,65,
3468,0,71,7,64,
3469,0,71,6,65,
3470,0,70,6,64,
3471,0,73,7,66,
3472,0,73,7,66,
3473,0,73,7,66,
3474,0,72,7,65,
3475,0,74,8,66,
3476,0,72,6,66,
3477,0,75,7,68,
3478,0,75,7,68,
3479,0,73,6,67,
3480,0,73,7,66,
3481,0,74,6,68,
3482,0,74,7,67,
3483,0,74,6,68,
3484,0,76,7,69,
3485,0,75,6,69,
3486,0,75,7,68,
3487,0,75,6,69,
3488,0,74,6,68,
3489,0,77,7,70,
3490,0,75,6,69,
3491,0,78,7,71,
3492,0,75,6,69,
3493,0,78,8,70,
3494,0,77,6,71,
3495,0,77,7,70,
3496,0,78,8,70,
3497,0,78,7,71,
3498,0,77,6,71,
3499,0,79,7,72,
3500,0,78,6,72,
3501,0,79,7,72,
3502,0,77,6,71,
3503,0,80,7,73,
3504,0,79,6,73,
3505,0,80,7,73,
3506,0,79,7,72,
3507,0,79,6,73,
3508,0,86,11,75,
3509,0,87,12,75,
3510,0,87,10,77,
3511,0,86,11,75,
3512,0,88,11,77,
3513,0,87,12,75,
3514,0,87,11,76,
3515,0,87,11,76,
3516,0,89,10,79,
3517,0,89,11,78,
3518,0,88,11,77,
3519,0,89,12,77,
3520,0,88,11,77,
3521,0,89,12,77,
3522,0,91,12,79,
3523,0,88,11,77,
3524,0,89,12,77,
3525,0,88,11,77,
3526,0,82,12,70,
3527,0,68,11,57,
3528,0,60,12,48,
3529,0,58,12,46,
3530,0,47,9,38,
3531,0,43,14,29,
3532,0,33,11,22,
3533,0,34,12,22,
3534,0,43,10,33,
3535,0,46,12,34,
3536,0,46,11,35,
3537,0,49,12,37,
3538,0,48,11,37,
3539,0,50,11,39,
3540,0,48,12,36,
3541,0,50,11,39,
3542,0,51,13,38,
3543,0,50,11,39,
3544,0,52,12,40,
3545,0,52,11,41,
3546,0,53,11,42,
3547,0,53,12,41,
3548,0,53,12,41,
3549,0,53,11,42,
3550,0,54,11,43,
3551,0,56,12,44,
3552,0,56,12,44,
3553,0,55,12,43,
3554,0,57,12,45,
3555,0,56,11,45,
3556,0,58,13,45,
3557,0,57,11,46,
3558,0,57,11,46,
3559,0,59,12,47,
3560,0,58,10,48,
3561,0,60,11,49,
3562,0,62,13,49,
3563,0,60,11,49,
3564,0,61,12,49,
3565,0,61,12,49,
3566,0,61,10,51,
3567,0,62,12,50,
3568,0,62,11,51,
3569,0,64,13,51,
3570,0,58,8,50,
3571,0,57,7,50,
3572,0,58,7,51,
3573,0,56,6,50,
3574,0,60,7,53,
3575,0,57,6,51,
3576,0,59,7,52,
3577,0,57,6,51,
3578,0,59,7,52,
3579,0,59,6,53,
3580,0,59,7,52,
3581,0,61,7,54,
3582,0,59,6,53,
3583,0,62,7,55,
3584,0,60,6,54,
3585,0,62,7,55,
3586,0,60,6,54,
3587,0,62,7,55,
3588,0,62,6,56,
3589,0,62,7,55,
3590,0,62,6,56,
3591,0,64,7,57,
3592,0,65,7,58,
3593,0,64,7,57,
3594,0,64,6,58,
3595,0,64,7,57,
3596,0,65,7,58,
3597,0,63,6,57,
3598,0,66,7,59,
3599,0,65,7,58,
3600,0,65,6,59,
3601,0,64,6,58,
3602,0,68,7,61,
3603,0,66,6,60,
3604,0,65,6,59,
3605,0,68,7,61,
3606,0,68,7,61,
3607,0,67,6,61,
3608,0,67,7,60,
3609,0,68,6,62,
3610,0,67,6,61,
3611,0,70,7,63,
3612,0,68,6,62,
3613,0,68,6,62,
3614,0,70,7,63,
3615,0,68,6,62,
3616,0,71,7,64,
3617,0,70,6,64,
3618,0,70,7,63,
3619,0,70,6,64,
3620,0,70,6,64,
3621,0,71,7,64,
3622,0,72,7,65,
3623,0,71,7,64,
3624,0,72,7,65,
3625,0,72,7,65,
3626,0,72,7,65,
3627,0,72,6,66,
3628,0,71,6,65,
3629,0,74,7,67,
3630,0,73,6,67,
3631,0,72,6,66,
3632,0,74,7,67,
3633,0,73,6,67,
3634,0,74,7,67,
3635,0,74,6,68,
3636,0,60,2,58,
3637,0,37,,37,
3638,0,13,,13,
