window-id,queue-size-CL,queue-size-LL,10.0.0.13:60361 -> 10.0.1.13:3000,10.0.1.13:3000 -> 10.0.0.13:60361,10.0.0.13:45672 -> 10.0.1.13:1000
0,0,30,10,20,
1,0,33,9,24,
2,0,31,11,20,
3,0,28,8,20,
4,0,26,7,19,
5,0,23,7,16,
6,0,25,8,17,
7,0,25,8,17,
8,0,24,8,16,
9,0,23,7,16,
10,0,25,8,17,
11,0,24,8,16,
12,0,26,8,18,
13,0,23,7,16,
14,0,24,8,16,
15,0,23,7,16,
16,0,24,8,16,
17,0,25,8,17,
18,0,25,7,18,
19,0,25,8,17,
20,0,24,8,16,
21,0,25,8,17,
22,0,26,8,18,
23,0,25,8,17,
24,0,23,7,16,
25,0,25,9,16,
26,0,24,8,16,
27,0,23,7,16,
28,0,22,7,15,
29,0,22,6,16,
30,0,23,7,16,
31,0,23,6,17,
32,0,23,7,16,
33,0,23,6,17,
34,0,22,6,16,
35,0,25,8,17,
36,0,22,7,15,
37,0,23,6,17,
38,0,22,6,16,
39,0,24,7,17,
40,0,22,6,16,
41,0,25,7,18,
42,0,23,6,17,
43,0,22,6,16,
44,0,26,7,19,
45,0,24,6,18,
46,0,25,7,18,
47,0,23,6,17,
48,0,24,7,17,
49,0,22,6,16,
50,0,23,6,17,
51,0,26,7,19,
52,0,23,6,17,
53,0,22,6,16,
54,0,24,7,17,
55,0,22,6,16,
56,0,22,7,15,
57,0,24,6,18,
58,0,23,6,17,
59,0,25,7,18,
60,0,24,7,17,
61,0,23,7,16,
62,0,25,7,18,
63,0,23,6,17,
64,0,24,7,17,
65,0,22,7,15,
66,0,22,7,15,
67,0,23,6,17,
68,0,22,6,16,
69,0,25,7,18,
70,0,24,6,18,
71,0,23,6,17,
72,0,25,7,18,
73,0,23,6,17,
74,0,23,7,16,
75,0,23,6,17,
76,0,22,6,16,
77,0,24,7,17,
78,0,23,6,17,
79,0,22,6,16,
80,0,28,11,17,
81,0,29,12,17,
82,0,31,13,18,
83,0,28,12,16,
84,0,29,13,16,
85,0,28,12,16,
86,0,29,12,17,
87,0,29,13,16,
88,0,29,13,16,
89,0,30,12,18,
90,0,31,13,18,
91,0,30,13,17,
92,0,28,12,16,
93,0,29,13,16,
94,0,27,12,15,
95,0,27,12,15,
96,0,27,12,15,
97,0,29,13,16,
98,0,26,11,15,
99,0,29,13,16,
100,0,29,12,17,
101,0,30,13,17,
102,0,30,13,17,
103,0,28,12,16,
104,0,28,11,17,
105,0,30,13,17,
106,0,29,12,17,
107,0,28,11,17,
108,0,29,11,18,
109,0,30,12,18,
110,0,30,13,17,
111,0,30,12,18,
112,0,30,12,18,
113,0,31,13,18,
114,0,29,12,17,
115,0,31,13,18,
116,0,29,13,16,
117,0,29,13,16,
118,0,29,13,16,
119,0,31,13,18,
120,0,28,12,16,
121,0,30,13,17,
122,0,27,11,16,
123,0,30,14,16,
124,0,28,12,16,
125,0,26,11,15,
126,0,28,11,17,
127,0,28,12,16,
128,0,29,13,16,
129,0,26,11,15,
130,0,30,13,17,
131,0,27,11,16,
132,0,28,11,17,
133,0,30,12,18,
134,0,30,13,17,
135,0,29,12,17,
136,0,27,11,16,
137,0,29,12,17,
138,0,29,13,16,
139,0,28,11,17,
140,0,28,12,16,
141,0,29,12,17,
142,0,28,12,16,
143,0,31,14,17,
144,0,29,12,17,
145,0,30,13,17,
146,0,31,13,18,
147,0,29,12,17,
148,0,29,13,16,
149,0,29,12,17,
150,0,28,12,16,
151,0,30,13,17,
152,0,28,13,15,
153,0,27,12,15,
154,0,32,13,19,
155,0,30,12,18,
156,0,29,13,16,
157,0,27,11,16,
158,0,30,13,17,
159,0,31,13,18,
160,0,29,12,17,
161,0,30,12,18,
162,0,30,13,17,
163,0,29,13,16,
164,0,28,12,16,
165,0,29,12,17,
166,0,30,12,18,
167,0,29,13,16,
168,0,28,11,17,
169,0,30,13,17,
170,0,28,12,16,
171,0,30,13,17,
172,0,29,12,17,
173,0,29,13,16,
174,0,27,11,16,
175,0,24,7,17,
176,0,23,6,17,
177,0,22,7,15,
178,0,23,7,16,
179,0,23,6,17,
180,0,25,7,18,
181,0,24,6,18,
182,0,25,6,19,
183,0,23,6,17,
184,0,25,7,18,
185,0,24,6,18,
186,0,24,7,17,
187,0,24,7,17,
188,0,23,6,17,
189,0,25,7,18,
190,0,24,6,18,
191,0,23,7,16,
192,0,23,6,17,
193,0,24,6,18,
194,0,23,6,17,
195,0,25,7,18,
196,0,24,7,17,
197,0,24,6,18,
198,0,24,6,18,
199,0,22,6,16,
200,0,25,7,18,
201,0,24,6,18,
202,0,24,7,17,
203,0,22,6,16,
204,0,24,7,17,
205,0,24,6,18,
206,0,25,7,18,
207,0,22,6,16,
208,0,24,7,17,
209,0,23,6,17,
210,0,23,7,16,
211,0,24,7,17,
212,0,22,6,16,
213,0,26,7,19,
214,0,24,6,18,
215,0,24,6,18,
216,0,24,7,17,
217,0,24,7,17,
218,0,22,6,16,
219,0,24,7,17,
220,0,23,6,17,
221,0,23,7,16,
222,0,24,7,17,
223,0,23,6,17,
224,0,25,7,18,
225,0,22,6,16,
226,0,24,6,18,
227,0,24,7,17,
228,0,22,6,16,
229,0,22,7,15,
230,0,22,6,16,
231,0,21,6,15,
232,0,27,7,20,
233,0,24,6,18,
234,0,23,6,17,
235,0,26,9,17,
236,0,25,7,18,
237,0,24,6,18,
238,0,22,6,16,
239,0,22,7,15,
240,0,24,7,17,
241,0,24,6,18,
242,0,21,6,15,
243,0,26,7,19,
244,0,24,6,18,
245,0,24,7,17,
246,0,23,7,16,
247,0,24,7,17,
248,0,24,7,17,
249,0,25,6,19,
250,0,24,7,17,
251,0,24,6,18,
252,0,23,6,17,
253,0,23,7,16,
254,0,24,7,17,
255,0,26,8,18,
256,0,23,6,17,
257,0,24,7,17,
258,0,23,7,16,
259,0,23,6,17,
260,0,22,6,16,
261,0,25,7,18,
262,0,23,6,17,
263,0,22,6,16,
264,0,24,7,17,
265,0,27,9,18,
266,0,24,7,17,
267,0,24,7,17,
268,0,23,6,17,
269,0,23,6,17,
270,0,26,7,19,
271,0,22,6,16,
272,0,23,7,16,
273,0,25,7,18,
274,0,22,6,16,
275,0,23,6,17,
276,0,22,6,16,
277,0,24,7,17,
278,0,22,6,16,
279,0,23,7,16,
280,0,23,6,17,
281,0,23,6,17,
282,0,23,7,16,
283,0,24,6,18,
284,0,23,6,17,
285,0,23,7,16,
286,0,24,7,17,
287,0,22,6,16,
288,0,24,7,17,
289,0,24,6,18,
290,0,23,6,17,
291,0,24,6,18,
292,0,22,6,16,
293,0,25,7,18,
294,0,24,7,17,
295,0,25,7,18,
296,0,22,6,16,
297,0,21,6,15,
298,0,24,7,17,
299,0,25,6,19,
300,0,23,6,17,
301,0,24,7,17,
302,0,23,6,17,
303,0,24,7,17,
304,0,23,6,17,
305,0,22,6,16,
306,0,24,7,17,
307,0,22,6,16,
308,0,25,8,17,
309,0,24,6,18,
310,0,23,6,17,
311,0,23,6,17,
312,0,22,7,15,
313,0,22,6,16,
314,0,24,7,17,
315,0,23,6,17,
316,0,22,6,16,
317,0,23,7,16,
318,0,26,8,18,
319,0,23,6,17,
320,0,23,6,17,
321,0,23,7,16,
322,0,24,6,18,
323,0,23,7,16,
324,0,23,7,16,
325,0,23,6,17,
326,0,24,7,17,
327,0,24,6,18,
328,0,25,7,18,
329,0,23,6,17,
330,0,26,8,18,
331,0,23,6,17,
332,0,23,7,16,
333,0,22,6,16,
334,0,24,7,17,
335,0,22,6,16,
336,0,25,7,18,
337,0,23,6,17,
338,0,22,6,16,
339,0,23,7,16,
340,0,23,7,16,
341,0,23,6,17,
342,0,21,6,15,
343,0,26,7,19,
344,0,23,6,17,
345,0,23,7,16,
346,0,24,6,18,
347,0,22,6,16,
348,0,27,7,20,
349,0,24,6,18,
350,0,24,8,16,
351,0,24,6,18,
352,0,23,6,17,
353,0,25,7,18,
354,0,23,6,17,
355,0,23,7,16,
356,0,23,7,16,
357,0,24,7,17,
358,0,23,7,16,
359,0,23,7,16,
360,0,22,5,17,
361,0,25,7,18,
362,0,25,7,18,
363,0,24,6,18,
364,0,22,6,16,
365,0,25,8,17,
366,0,22,6,16,
367,0,24,7,17,
368,0,23,7,16,
369,0,21,5,16,
370,0,24,7,17,
371,0,23,7,16,
372,0,23,6,17,
373,0,25,7,18,
374,0,23,6,17,
375,0,23,6,17,
376,0,25,7,18,
377,0,23,6,17,
378,0,24,8,16,
379,0,23,6,17,
380,0,22,6,16,
381,0,24,7,17,
382,0,23,6,17,
383,0,22,6,16,
384,0,25,7,18,
385,0,23,6,17,
386,0,25,8,17,
387,0,21,6,15,
388,0,25,8,17,
389,0,22,6,16,
390,0,24,8,16,
391,0,23,6,17,
392,0,23,6,17,
393,0,23,7,16,
394,0,23,6,17,
395,0,24,6,18,
396,0,22,6,16,
397,0,25,7,18,
398,0,24,6,18,
399,0,25,7,18,
400,0,22,6,16,
401,0,26,7,19,
402,0,23,6,17,
403,0,23,6,17,
404,0,22,6,16,
405,0,24,7,17,
406,0,23,6,17,
407,0,23,7,16,
408,0,23,6,17,
409,0,24,7,17,
410,0,24,7,17,
411,0,22,6,16,
412,0,22,6,16,
413,0,21,6,15,
414,0,23,7,16,
415,0,21,6,15,
416,0,23,7,16,
417,0,24,6,18,
418,0,24,7,17,
419,0,22,6,16,
420,0,24,6,18,
421,0,22,6,16,
422,0,25,7,18,
423,0,24,6,18,
424,0,24,7,17,
425,0,22,6,16,
426,0,25,7,18,
427,0,24,6,18,
428,0,23,6,17,
429,0,23,7,16,
430,0,23,6,17,
431,0,24,6,18,
432,0,22,7,15,
433,0,22,6,16,
434,0,21,6,15,
435,0,24,7,17,
436,0,23,6,17,
437,0,23,7,16,
438,0,23,7,16,
439,0,23,7,16,
440,0,24,6,18,
441,0,22,6,16,
442,0,24,6,18,
443,0,25,7,18,
444,0,24,6,18,
445,0,23,7,16,
446,0,24,7,17,
447,0,24,8,16,
448,0,23,6,17,
449,0,21,6,15,
450,0,24,7,17,
451,0,22,6,16,
452,0,24,7,17,
453,0,24,7,17,
454,0,23,6,17,
455,0,23,6,17,
456,0,24,7,17,
457,0,22,6,16,
458,0,24,7,17,
459,0,26,6,20,
460,0,24,6,18,
461,0,23,6,17,
462,0,24,7,17,
463,0,22,6,16,
464,0,23,7,16,
465,0,23,6,17,
466,0,25,7,18,
467,0,23,6,17,
468,0,24,7,17,
469,0,23,6,17,
470,0,24,7,17,
471,0,22,6,16,
472,0,21,6,15,
473,0,23,7,16,
474,0,21,6,15,
475,0,22,7,15,
476,0,23,6,17,
477,0,24,7,17,
478,0,22,6,16,
479,0,25,7,18,
480,0,24,6,18,
481,0,23,6,17,
482,0,24,7,17,
483,0,24,7,17,
484,0,24,7,17,
485,0,24,6,18,
486,0,23,6,17,
487,0,24,7,17,
488,0,23,6,17,
489,0,23,7,16,
490,0,24,6,18,
491,0,24,7,17,
492,0,22,6,16,
493,0,22,7,15,
494,0,23,6,17,
495,0,22,6,16,
496,0,24,7,17,
497,0,23,6,17,
498,0,24,7,17,
499,0,23,7,16,
500,0,25,7,18,
501,0,24,6,18,
502,0,24,7,17,
503,0,23,6,17,
504,0,22,6,16,
505,0,22,7,15,
506,0,23,6,17,
507,0,23,6,17,
508,0,22,7,15,
509,0,23,6,17,
510,0,23,6,17,
511,0,23,6,17,
512,0,24,7,17,
513,0,22,6,16,
514,0,23,8,15,
515,0,22,6,16,
516,0,23,6,17,
517,0,24,7,17,
518,0,24,6,18,
519,0,23,6,17,
520,0,23,7,16,
521,0,24,6,18,
522,0,23,6,17,
523,0,22,6,16,
524,0,24,7,17,
525,0,22,6,16,
526,0,21,6,15,
527,0,24,7,17,
528,0,22,6,16,
529,0,25,8,17,
530,0,23,7,16,
531,0,23,6,17,
532,0,22,6,16,
533,0,24,6,18,
534,0,22,6,16,
535,0,25,7,18,
536,0,23,6,17,
537,0,23,7,16,
538,0,26,10,16,
539,0,22,6,16,
540,0,23,6,17,
541,0,25,7,18,
542,0,23,6,17,
543,0,22,6,16,
544,0,24,7,17,
545,0,22,6,16,
546,0,23,7,16,
547,0,24,7,17,
548,0,24,6,18,
549,0,23,6,17,
550,0,23,7,16,
551,0,22,6,16,
552,0,21,6,15,
553,0,24,7,17,
554,0,23,6,17,
555,0,23,7,16,
556,0,23,6,17,
557,0,22,6,16,
558,0,24,7,17,
559,0,23,7,16,
560,0,24,7,17,
561,0,24,6,18,
562,0,23,6,17,
563,0,23,7,16,
564,0,25,6,19,
565,0,23,6,17,
566,0,25,7,18,
567,0,24,6,18,
568,0,25,7,18,
569,0,23,6,17,
570,0,21,6,15,
571,0,24,7,17,
572,0,23,6,17,
573,0,24,6,18,
574,0,22,6,16,
575,0,26,8,18,
576,0,23,7,16,
577,0,24,7,17,
578,0,22,6,16,
579,0,24,7,17,
580,0,25,7,18,
581,0,24,6,18,
582,0,23,6,17,
583,0,24,7,17,
584,0,22,6,16,
585,0,21,6,15,
586,0,23,7,16,
587,0,21,6,15,
588,0,22,7,15,
589,0,23,6,17,
590,0,24,7,17,
591,0,24,6,18,
592,0,24,6,18,
593,0,22,6,16,
594,0,24,7,17,
595,0,22,6,16,
596,0,23,7,16,
597,0,24,6,18,
598,0,23,6,17,
599,0,23,7,16,
600,0,22,6,16,
601,0,21,6,15,
602,0,23,7,16,
603,0,21,6,15,
604,0,24,7,17,
605,0,25,7,18,
606,0,24,7,17,
607,0,25,7,18,
608,0,23,6,17,
609,0,27,8,19,
610,0,23,6,17,
611,0,24,7,17,
612,0,23,6,17,
613,0,24,7,17,
614,0,23,6,17,
615,0,23,6,17,
616,0,21,6,15,
617,0,24,7,17,
618,0,23,6,17,
619,0,22,6,16,
620,0,22,6,16,
621,0,23,7,16,
622,0,24,7,17,
623,0,24,7,17,
624,0,23,7,16,
625,0,23,6,17,
626,0,23,6,17,
627,0,23,7,16,
628,0,24,8,16,
629,0,29,13,16,
630,0,29,13,16,
631,0,30,12,18,
632,0,29,12,17,
633,0,30,13,17,
634,0,27,11,16,
635,0,30,13,17,
636,0,29,12,17,
637,0,28,12,16,
638,0,29,12,17,
639,0,30,13,17,
640,0,30,13,17,
641,0,27,11,16,
642,0,31,12,19,
643,0,30,12,18,
644,0,30,13,17,
645,0,31,12,19,
646,0,30,12,18,
647,0,29,11,18,
648,0,30,13,17,
649,0,28,11,17,
650,0,31,13,18,
651,0,28,11,17,
652,0,30,13,17,
653,0,27,11,16,
654,0,27,12,15,
655,0,29,12,17,
656,0,28,13,15,
657,0,29,13,16,
658,0,27,10,17,
659,0,29,13,16,
660,0,29,12,17,
661,0,31,13,18,
662,0,29,12,17,
663,0,27,11,16,
664,0,28,12,16,
665,0,29,13,16,
666,0,29,12,17,
667,0,30,13,17,
668,0,29,13,16,
669,0,29,12,17,
670,0,29,13,16,
671,0,30,13,17,
672,0,31,12,19,
673,0,28,11,17,
674,0,28,12,16,
675,0,30,14,16,
676,0,29,12,17,
677,0,27,11,16,
678,0,29,13,16,
679,0,30,13,17,
680,0,28,12,16,
681,0,30,13,17,
682,0,27,11,16,
683,0,30,13,17,
684,0,26,10,16,
685,0,29,12,17,
686,0,30,13,17,
687,0,29,13,16,
688,0,28,12,16,
689,0,29,13,16,
690,0,30,13,17,
691,0,29,13,16,
692,0,30,13,17,
693,0,28,11,17,
694,0,30,13,17,
695,0,27,11,16,
696,0,31,13,18,
697,0,30,12,18,
698,0,28,10,18,
699,0,32,14,18,
700,0,30,13,17,
701,0,28,11,17,
702,0,30,12,18,
703,0,29,11,18,
704,0,30,13,17,
705,0,27,11,16,
706,0,27,11,16,
707,0,28,13,15,
708,0,29,13,16,
709,0,25,10,15,
710,0,31,13,18,
711,0,30,12,18,
712,0,29,13,16,
713,0,30,13,17,
714,0,29,12,17,
715,0,30,13,17,
716,0,29,12,17,
717,0,26,11,15,
718,0,30,13,17,
719,0,28,12,16,
720,0,28,11,17,
721,0,30,13,17,
722,0,30,12,18,
723,0,29,13,16,
724,0,31,13,18,
725,0,29,11,18,
726,0,29,12,17,
727,0,29,12,17,
728,0,31,13,18,
729,0,29,11,18,
730,0,29,13,16,
731,0,30,12,18,
732,0,28,11,17,
733,0,29,13,16,
734,0,29,12,17,
735,0,29,12,17,
736,0,30,12,18,
737,0,28,12,16,
738,0,30,13,17,
739,0,30,13,17,
740,0,27,11,16,
741,0,29,12,17,
742,0,31,13,18,
743,0,28,12,16,
744,0,28,12,16,
745,0,31,12,19,
746,0,31,13,18,
747,0,30,13,17,
748,0,28,12,16,
749,0,29,12,17,
750,0,29,13,16,
751,0,30,12,18,
752,0,30,13,17,
753,0,30,13,17,
754,0,29,12,17,
755,0,31,13,18,
756,0,30,12,18,
757,0,28,12,16,
758,0,30,12,18,
759,0,28,11,17,
760,0,31,13,18,
761,0,28,12,16,
762,0,29,13,16,
763,0,28,12,16,
764,0,29,12,17,
765,0,30,13,17,
766,0,30,13,17,
767,0,29,11,18,
768,0,29,12,17,
769,0,29,12,17,
770,0,28,12,16,
771,0,28,12,16,
772,0,29,13,16,
773,0,29,13,16,
774,0,29,13,16,
775,0,26,11,15,
776,0,27,11,16,
777,0,28,12,16,
778,0,28,13,15,
779,0,28,12,16,
780,0,29,13,16,
781,0,28,12,16,
782,0,27,11,16,
783,0,29,13,16,
784,0,31,13,18,
785,0,27,12,15,
786,0,29,12,17,
787,0,30,13,17,
788,0,28,12,16,
789,0,29,13,16,
790,0,28,12,16,
791,0,29,13,16,
792,0,30,12,18,
793,0,30,13,17,
794,0,30,12,18,
795,0,28,12,16,
796,0,30,14,16,
797,0,29,12,17,
798,0,27,11,16,
799,0,28,12,16,
800,0,30,13,17,
801,0,29,12,17,
802,0,29,13,16,
803,0,31,12,19,
804,0,29,11,18,
805,0,30,13,17,
806,0,29,12,17,
807,0,30,13,17,
808,0,30,13,17,
809,0,28,13,15,
810,0,27,12,15,
811,0,29,13,16,
812,0,30,13,17,
813,0,28,12,16,
814,0,29,12,17,
815,0,29,12,17,
816,0,30,13,17,
817,0,28,12,16,
818,0,29,13,16,
819,0,29,12,17,
820,0,29,12,17,
821,0,30,13,17,
822,0,30,12,18,
823,0,29,12,17,
824,0,29,11,18,
825,0,27,10,17,
826,0,28,12,16,
827,0,29,13,16,
828,0,31,13,18,
829,0,28,12,16,
830,0,30,13,17,
831,0,28,12,16,
832,0,30,13,17,
833,0,30,13,17,
834,0,28,13,15,
835,0,29,12,17,
836,0,25,10,15,
837,0,24,7,17,
838,0,24,7,17,
839,0,22,6,16,
840,0,24,7,17,
841,0,24,7,17,
842,0,23,7,16,
843,0,24,7,17,
844,0,25,7,18,
845,0,26,7,19,
846,0,24,6,18,
847,0,24,7,17,
848,0,22,6,16,
849,0,23,6,17,
850,0,25,6,19,
851,0,23,6,17,
852,0,24,7,17,
853,0,22,6,16,
854,0,24,7,17,
855,0,22,6,16,
856,0,25,7,18,
857,0,24,6,18,
858,0,23,6,17,
859,0,23,7,16,
860,0,22,6,16,
861,0,22,7,15,
862,0,22,6,16,
863,0,23,7,16,
864,0,23,6,17,
865,0,25,7,18,
866,0,24,6,18,
867,0,24,7,17,
868,0,22,6,16,
869,0,25,7,18,
870,0,23,6,17,
871,0,24,7,17,
872,0,22,6,16,
873,0,22,7,15,
874,0,22,6,16,
875,0,25,7,18,
876,0,24,7,17,
877,0,24,6,18,
878,0,24,7,17,
879,0,22,6,16,
880,0,25,7,18,
881,0,23,6,17,
882,0,24,7,17,
883,0,22,6,16,
884,0,23,7,16,
885,0,21,6,15,
886,0,22,6,16,
887,0,27,7,20,
888,0,23,6,17,
889,0,25,7,18,
890,0,28,10,18,
891,0,23,7,16,
892,0,24,8,16,
893,0,29,13,16,
894,0,30,13,17,
895,0,26,8,18,
896,0,25,9,16,
897,0,26,9,17,
898,0,25,8,17,
899,0,30,10,20,
900,0,25,8,17,
901,0,24,6,18,
902,0,28,10,18,
903,0,28,9,19,
904,0,26,9,17,
905,0,27,10,17,
906,0,27,9,18,
907,0,28,11,17,
908,0,27,11,16,
909,0,28,12,16,
910,0,27,11,16,
911,0,28,10,18,
912,0,27,10,16,1
913,0,24,7,17,
914,0,23,7,16,
915,0,23,7,16,
916,0,22,6,16,
917,0,25,7,18,
918,0,24,7,17,
919,0,23,6,17,
920,0,22,6,15,1
921,0,24,7,17,
922,0,22,6,16,
923,0,23,7,16,
924,0,23,6,17,
925,0,23,7,16,
926,0,23,6,17,
927,0,24,7,16,1
928,0,23,7,16,
929,0,24,6,18,
930,0,25,7,18,
931,0,24,6,18,
932,0,24,7,17,
933,0,22,6,16,
934,0,21,6,15,
935,0,23,7,16,
936,0,24,7,17,
937,0,24,7,17,
938,0,24,6,18,
939,0,25,6,19,
940,0,24,6,18,
941,0,23,7,16,
942,0,25,7,17,1
943,0,22,6,16,
944,0,25,7,18,
945,0,26,7,19,
946,0,24,6,18,
947,0,23,6,17,
948,0,23,7,16,
949,0,24,7,17,
950,0,22,6,16,
951,0,21,6,15,
952,0,24,7,17,
953,0,22,6,16,
954,0,23,6,17,
955,0,25,7,18,
956,0,24,6,18,
957,0,22,6,16,
958,0,25,7,17,1
959,0,21,6,15,
960,0,25,8,17,
961,0,23,6,17,
962,0,23,7,16,
963,0,23,6,17,
964,0,22,6,16,
965,0,25,7,18,
966,0,23,6,17,
967,0,21,6,15,
968,0,25,7,18,
969,0,25,7,18,
970,0,23,6,17,
971,0,23,6,17,
972,0,24,7,17,
973,0,23,6,17,
974,0,23,7,16,
975,0,22,7,15,
976,0,22,7,15,
977,0,22,6,16,
978,0,22,7,15,
979,0,23,6,17,
980,0,24,6,18,
981,0,25,7,18,
982,0,24,6,18,
983,0,22,6,16,
984,0,23,7,16,
985,0,24,7,17,
986,0,24,6,18,
987,0,24,6,18,
988,0,23,6,16,1
989,0,24,7,17,
990,0,22,6,16,
991,0,19,5,14,
998,0,10,3,7,
999,0,24,8,16,
1000,0,22,6,16,
1001,0,23,7,16,
1002,0,21,6,15,
1003,0,27,8,19,
1004,0,25,8,17,
1005,0,27,8,19,
1006,0,23,6,17,
1007,0,23,7,16,
1008,0,22,6,16,
1009,0,22,7,15,
1010,0,24,6,18,
1011,0,25,7,18,
1012,0,23,6,17,
1013,0,24,7,17,
1014,0,23,6,17,
1015,0,21,6,15,
1016,0,26,7,19,
1017,0,24,6,18,
1018,0,26,8,17,1
1019,0,23,7,16,
1020,0,25,7,18,
1021,0,24,6,18,
1022,0,25,7,18,
1023,0,22,6,16,
1024,0,24,7,17,
1025,0,24,7,17,
1026,0,23,6,17,
1027,0,23,7,16,
1028,0,25,7,18,
1029,0,23,7,16,
1030,0,24,7,17,
1031,0,22,6,16,
1032,0,22,7,15,
1033,0,22,6,16,
1034,0,23,7,16,
1035,0,25,7,18,
1036,0,24,6,18,
1037,0,25,7,18,
1038,0,24,6,18,
1039,0,23,6,17,
1040,0,25,7,18,
1041,0,23,6,17,
1042,0,23,7,16,
1043,0,23,6,17,
1044,0,25,7,18,
1045,0,10,2,8,
1048,0,5,2,3,
1049,0,25,8,16,1
1050,0,22,6,16,
1051,0,22,7,15,
1052,0,23,6,17,
1053,0,24,8,16,
1054,0,24,8,16,
1055,0,25,6,19,
1056,0,26,7,19,
1057,0,24,6,18,
1058,0,23,6,17,
1059,0,25,7,18,
1060,0,24,7,17,
1061,0,23,7,16,
1062,0,23,6,17,
1063,0,22,6,16,
1064,0,24,7,17,
1065,0,28,8,20,
1066,0,22,6,16,
1067,0,24,7,17,
1068,0,23,6,17,
1069,0,23,7,16,
1070,0,23,6,17,
1071,0,21,6,15,
1072,0,23,7,16,
1073,0,25,8,17,
1074,0,23,6,17,
1075,0,22,6,16,
1076,0,25,8,17,
1077,0,23,6,17,
1078,0,23,7,16,
1079,0,23,6,16,1
1080,0,24,7,17,
1081,0,22,6,16,
1082,0,25,7,18,
1083,0,25,9,16,
1084,0,23,6,17,
1085,0,25,7,18,
1086,0,22,6,16,
1087,0,24,7,17,
1088,0,25,7,18,
1089,0,25,7,18,
1090,0,25,6,19,
1091,0,24,6,18,
1092,0,23,7,16,
1093,0,23,6,17,
1094,0,24,7,17,
1095,0,24,7,17,
1096,0,24,7,17,
1097,0,24,6,18,
1098,0,25,7,18,
1099,0,23,6,17,
1100,0,23,6,17,
1101,0,22,7,15,
1102,0,22,6,16,
1103,0,24,6,18,
1104,0,24,7,17,
1105,0,25,7,18,
1106,0,22,6,16,
1107,0,24,7,17,
1108,0,24,6,18,
1109,0,26,7,18,1
1110,0,24,7,17,
1111,0,22,6,16,
1112,0,24,6,18,
1113,0,25,7,18,
1114,0,25,7,18,
1115,0,23,6,17,
1116,0,24,7,17,
1117,0,24,6,18,
1118,0,24,7,17,
1119,0,23,6,17,
1120,0,22,6,16,
1121,0,25,7,18,
1122,0,24,6,18,
1123,0,22,6,16,
1124,0,23,7,16,
1125,0,24,6,18,
1126,0,23,6,17,
1127,0,21,6,15,
1128,0,23,7,16,
1129,0,24,6,18,
1130,0,23,6,17,
1131,0,25,7,18,
1132,0,23,6,17,
1133,0,22,7,15,
1134,0,22,6,16,
1135,0,21,6,15,
1136,0,24,7,17,
1137,0,22,6,16,
1138,0,23,7,16,
1139,0,23,6,17,
1140,0,23,6,16,1
1141,0,23,7,16,
1142,0,23,6,17,
1143,0,24,7,17,
1144,0,28,11,17,
1145,0,26,12,14,
1146,0,28,13,15,
1147,0,28,12,16,
1148,0,27,11,16,
1149,0,28,12,16,
1150,0,27,11,16,
1151,0,29,13,16,
1152,0,29,12,17,
1153,0,31,13,18,
1154,0,29,13,16,
1155,0,28,12,16,
1156,0,27,11,16,
1157,0,30,13,17,
1158,0,28,11,17,
1159,0,29,13,16,
1160,0,29,12,17,
1161,0,30,13,17,
1162,0,29,12,17,
1163,0,28,12,16,
1164,0,32,13,19,
1165,0,29,11,18,
1166,0,29,12,17,
1167,0,28,12,16,
1168,0,30,12,18,
1169,0,28,12,16,
1170,0,30,13,16,1
1171,0,26,9,17,
1172,0,25,7,18,
1173,0,24,6,18,
1174,0,25,8,17,
1175,0,22,6,16,
1176,0,21,6,15,
1177,0,23,7,16,
1178,0,22,7,15,
1179,0,24,7,17,
1180,0,24,6,18,
1181,0,24,7,17,
1182,0,23,6,17,
1183,0,23,7,16,
1184,0,23,6,17,
1185,0,22,6,16,
1186,0,24,7,17,
1187,0,24,7,17,
1188,0,26,7,19,
1189,0,23,6,17,
1190,0,22,6,16,
1191,0,24,7,17,
1192,0,24,6,18,
1193,0,24,7,17,
1194,0,24,6,18,
1195,0,24,7,17,
1196,0,24,6,18,
1197,0,22,6,16,
1198,0,25,7,18,
1199,0,24,6,18,
1200,0,23,6,17,
1201,0,24,7,16,1
1202,0,25,7,18,
1203,0,23,6,17,
1204,0,24,8,16,
1205,0,24,7,17,
1206,0,22,6,16,
1207,0,26,7,19,
1208,0,24,6,18,
1209,0,23,6,17,
1210,0,23,7,16,
1211,0,22,7,15,
1212,0,22,6,16,
1213,0,22,7,15,
1214,0,24,7,17,
1215,0,24,6,18,
1216,0,25,7,18,
1217,0,25,7,18,
1218,0,22,6,16,
1219,0,24,7,17,
1220,0,23,6,17,
1221,0,22,7,15,
1222,0,23,6,17,
1223,0,22,6,16,
1224,0,24,7,17,
1225,0,23,6,17,
1226,0,22,6,16,
1227,0,24,7,17,
1228,0,23,6,17,
1229,0,23,7,16,
1230,0,24,6,18,
1231,0,24,6,17,1
1232,0,24,7,17,
1233,0,24,7,17,
1234,0,24,8,16,
1235,0,23,7,16,
1236,0,22,6,16,
1237,0,22,7,15,
1238,0,22,6,16,
1239,0,24,8,16,
1240,0,21,6,15,
1241,0,24,6,18,
1242,0,21,6,15,
1243,0,23,7,16,
1244,0,22,6,16,
1245,0,22,6,16,
1246,0,21,6,15,
1247,0,23,7,16,
1248,0,24,7,17,
1249,0,24,6,18,
1250,0,22,6,16,
1251,0,24,7,17,
1252,0,23,6,17,
1253,0,25,6,19,
1254,0,23,6,17,
1255,0,24,7,17,
1256,0,22,6,16,
1257,0,23,7,16,
1258,0,21,6,15,
1259,0,22,7,15,
1260,0,22,7,15,
1261,0,23,6,16,1
1262,0,24,7,17,
1263,0,21,6,15,
1264,0,25,7,18,
1265,0,28,11,17,
1266,0,28,12,16,
1267,0,28,12,16,
1268,0,30,13,17,
1269,0,29,13,16,
1270,0,26,11,15,
1271,0,29,13,16,
1272,0,28,12,16,
1273,0,28,12,16,
1274,0,28,12,16,
1275,0,29,13,16,
1276,0,27,12,15,
1277,0,27,11,16,
1278,0,29,13,16,
1279,0,27,12,15,
1280,0,29,13,16,
1281,0,28,12,16,
1282,0,29,13,16,
1283,0,28,12,16,
1284,0,28,12,16,
1285,0,30,13,17,
1286,0,29,12,17,
1287,0,30,13,17,
1288,0,29,11,18,
1289,0,29,12,17,
1290,0,30,12,18,
1291,0,30,13,17,
1292,0,30,12,17,1
1293,0,30,13,17,
1294,0,31,13,18,
1295,0,28,12,16,
1296,0,28,11,17,
1297,0,30,12,18,
1298,0,31,13,18,
1299,0,27,11,16,
1300,0,30,12,18,
1301,0,28,11,17,
1302,0,30,13,17,
1303,0,28,11,17,
1304,0,27,10,17,
1305,0,30,13,17,
1306,0,30,13,17,
1307,0,28,12,16,
1308,0,30,13,17,
1309,0,29,11,18,
1310,0,28,12,16,
1311,0,29,12,17,
1312,0,30,13,17,
1313,0,28,12,16,
1314,0,28,12,16,
1315,0,29,13,16,
1316,0,31,14,17,
1317,0,29,13,16,
1318,0,29,13,16,
1319,0,28,10,18,
1320,0,30,13,17,
1321,0,28,11,17,
1322,0,29,12,16,1
1323,0,28,12,16,
1324,0,30,13,17,
1325,0,29,13,16,
1326,0,29,13,16,
1327,0,28,12,16,
1328,0,30,13,17,
1329,0,29,13,16,
1330,0,30,13,17,
1331,0,29,12,17,
1332,0,28,11,17,
1333,0,30,13,17,
1334,0,27,11,16,
1335,0,28,12,16,
1336,0,28,12,16,
1337,0,30,13,17,
1338,0,28,12,16,
1339,0,29,13,16,
1340,0,28,10,18,
1341,0,30,13,17,
1342,0,27,11,16,
1343,0,28,11,17,
1344,0,30,13,17,
1345,0,29,13,16,
1346,0,27,11,16,
1347,0,29,13,16,
1348,0,29,12,17,
1349,0,27,11,16,
1350,0,28,12,16,
1351,0,29,13,16,
1352,0,30,12,17,1
1353,0,29,12,17,
1354,0,29,12,17,
1355,0,28,12,16,
1356,0,29,13,16,
1357,0,30,13,17,
1358,0,29,13,16,
1359,0,30,13,17,
1360,0,27,11,16,
1361,0,30,13,17,
1362,0,27,11,16,
1363,0,31,13,18,
1364,0,29,12,17,
1365,0,28,12,16,
1366,0,30,12,18,
1367,0,27,12,15,
1368,0,28,12,16,
1369,0,29,12,17,
1370,0,31,13,18,
1371,0,27,10,17,
1372,0,28,12,16,
1373,0,28,11,17,
1374,0,30,13,17,
1375,0,28,13,15,
1376,0,26,11,15,
1377,0,29,13,16,
1378,0,26,11,15,
1379,0,23,7,16,
1380,0,24,7,17,
1381,0,22,6,16,
1382,0,23,7,16,
1383,0,26,6,19,1
1384,0,23,7,16,
1385,0,25,7,18,
1386,0,23,6,17,
1387,0,21,6,15,
1388,0,22,7,15,
1389,0,22,6,16,
1390,0,22,7,15,
1391,0,24,7,17,
1392,0,23,6,17,
1393,0,24,7,17,
1394,0,22,6,16,
1395,0,23,7,16,
1396,0,24,7,17,
1397,0,25,6,19,
1398,0,24,6,18,
1399,0,25,7,18,
1400,0,23,6,17,
1401,0,23,6,17,
1402,0,22,7,15,
1403,0,22,6,16,
1404,0,21,6,15,
1405,0,24,7,17,
1406,0,22,6,16,
1407,0,23,7,16,
1408,0,23,6,17,
1409,0,22,6,16,
1410,0,24,7,17,
1411,0,23,7,16,
1412,0,23,6,17,
1413,0,25,6,18,1
1414,0,23,6,17,
1415,0,24,7,17,
1416,0,22,6,16,
1417,0,22,7,15,
1418,0,22,6,16,
1419,0,22,6,16,
1420,0,22,7,15,
1421,0,23,6,17,
1422,0,22,6,16,
1423,0,23,7,16,
1424,0,24,7,17,
1425,0,23,7,16,
1426,0,23,6,17,
1427,0,25,6,19,
1428,0,24,6,18,
1429,0,24,7,17,
1430,0,23,7,16,
1431,0,21,6,15,
1432,0,24,7,17,
1433,0,22,6,16,
1434,0,22,7,15,
1435,0,23,6,17,
1436,0,22,6,16,
1437,0,25,7,18,
1438,0,23,6,17,
1439,0,22,6,16,
1440,0,23,7,16,
1441,0,23,7,16,
1442,0,23,6,17,
1443,0,25,6,18,1
1444,0,23,6,17,
1445,0,23,7,16,
1446,0,22,7,15,
1447,0,26,7,19,
1448,0,23,6,17,
1449,0,23,7,16,
1450,0,24,7,17,
1451,0,22,6,16,
1452,0,25,7,18,
1453,0,23,6,17,
1454,0,23,7,16,
1455,0,24,6,18,
1456,0,24,6,18,
1457,0,24,7,17,
1458,0,22,6,16,
1459,0,24,7,17,
1460,0,23,6,17,
1461,0,22,6,16,
1462,0,22,7,15,
1463,0,23,6,17,
1464,0,22,6,16,
1465,0,25,7,18,
1466,0,23,6,17,
1467,0,22,6,16,
1468,0,24,7,17,
1469,0,25,7,18,
1470,0,23,6,17,
1471,0,25,6,19,
1472,0,24,7,17,
1473,0,23,7,16,
1474,0,23,6,16,1
1475,0,22,7,15,
1476,0,23,7,16,
1477,0,21,6,15,
1478,0,26,8,18,
1479,0,23,6,17,
1480,0,23,6,17,
1481,0,22,6,16,
1482,0,24,7,17,
1483,0,23,6,17,
1484,0,23,7,16,
1485,0,25,7,18,
1486,0,23,6,17,
1487,0,23,7,16,
1488,0,22,7,15,
1489,0,22,6,16,
1490,0,23,7,16,
1491,0,21,6,15,
1492,0,25,7,18,
1493,0,23,6,17,
1494,0,22,6,16,
1495,0,23,7,16,
1496,0,23,6,17,
1497,0,23,7,16,
1498,0,23,6,17,
1499,0,25,7,18,
1500,0,25,7,18,
1501,0,24,6,18,
1502,0,23,6,17,
1503,0,21,6,15,
1504,0,23,7,15,1
1505,0,22,6,16,
1506,0,22,7,15,
1507,0,23,7,16,
1508,0,24,7,17,
1509,0,23,6,17,
1510,0,24,6,18,
1511,0,22,6,16,
1512,0,24,7,17,
1513,0,23,6,17,
1514,0,23,7,16,
1515,0,24,7,17,
1516,0,23,6,17,
1517,0,22,6,16,
1518,0,22,7,15,
1519,0,22,6,16,
1520,0,24,7,17,
1521,0,22,6,16,
1522,0,23,7,16,
1523,0,23,6,17,
1524,0,23,6,17,
1525,0,23,6,17,
1526,0,24,7,17,
1527,0,22,6,16,
1528,0,23,7,16,
1529,0,23,6,17,
1530,0,24,7,17,
1531,0,22,6,16,
1532,0,22,7,15,
1533,0,23,7,16,
1534,0,22,6,15,1
1535,0,24,7,17,
1536,0,24,7,17,
1537,0,24,7,17,
1538,0,22,6,16,
1539,0,25,7,18,
1540,0,24,7,17,
1541,0,22,6,16,
1542,0,23,7,16,
1543,0,24,7,17,
1544,0,23,6,17,
1545,0,25,7,18,
1546,0,23,7,16,
1547,0,24,6,18,
1548,0,25,6,19,
1549,0,24,7,17,
1550,0,25,7,18,
1551,0,23,6,17,
1552,0,21,6,15,
1553,0,24,6,18,
1554,0,24,6,18,
1555,0,28,7,21,
1556,0,27,6,21,
1557,0,26,6,20,
1558,0,30,7,23,
1559,0,32,6,26,
1560,0,33,7,26,
1561,0,34,6,28,
1562,0,33,6,27,
1563,0,36,7,29,
1564,0,36,6,30,
1565,0,37,7,29,1
1566,0,36,6,30,
1567,0,40,7,33,
1568,0,39,6,33,
1569,0,40,7,33,
1570,0,41,7,34,
1571,0,41,6,35,
1572,0,42,7,35,
1573,0,41,6,35,
1574,0,43,7,36,
1575,0,43,6,37,
1576,0,45,7,38,
1577,0,44,6,38,
1578,0,44,7,37,
1579,0,45,6,39,
1580,0,46,7,39,
1581,0,45,6,39,
1582,0,46,7,39,
1583,0,46,6,40,
1584,0,46,6,40,
1585,0,47,7,40,
1586,0,48,6,42,
1587,0,47,6,41,
1588,0,50,7,43,
1589,0,48,6,42,
1590,0,50,7,43,
1591,0,50,7,43,
1592,0,50,6,44,
1593,0,51,6,45,
1594,0,51,7,44,
1595,0,52,7,44,1
1596,0,52,6,46,
1597,0,51,6,45,
1598,0,54,7,47,
1599,0,53,6,47,
1600,0,53,7,46,
1601,0,54,6,48,
1602,0,54,6,48,
1603,0,54,7,47,
1604,0,55,6,49,
1605,0,54,6,48,
1606,0,56,7,49,
1607,0,56,6,50,
1608,0,56,7,49,
1609,0,56,6,50,
1610,0,56,6,50,
1611,0,58,7,51,
1612,0,57,7,50,
1613,0,59,7,52,
1614,0,57,6,51,
1615,0,59,7,52,
1616,0,59,6,53,
1617,0,59,7,52,
1618,0,59,6,53,
1619,0,59,6,53,
1620,0,62,7,55,
1621,0,60,6,54,
1622,0,60,6,54,
1623,0,62,7,55,
1624,0,61,6,55,
1625,0,62,7,54,1
1626,0,62,7,55,
1627,0,63,7,56,
1628,0,64,8,56,
1629,0,63,6,57,
1630,0,62,6,56,
1631,0,64,7,57,
1632,0,63,6,57,
1633,0,64,7,57,
1634,0,64,6,58,
1635,0,63,6,57,
1636,0,66,7,59,
1637,0,65,6,59,
1638,0,65,7,58,
1639,0,65,6,59,
1640,0,66,6,60,
1641,0,67,8,59,
1642,0,66,6,60,
1643,0,65,6,59,
1644,0,67,7,60,
1645,0,68,7,61,
1646,0,67,6,61,
1647,0,67,7,60,
1648,0,68,6,62,
1649,0,69,6,63,
1650,0,69,7,62,
1651,0,69,7,62,
1652,0,69,6,63,
1653,0,68,6,62,
1654,0,70,7,63,
1655,0,68,6,62,
1656,0,73,7,65,1
1657,0,70,6,64,
1658,0,70,7,63,
1659,0,70,6,64,
1660,0,72,7,65,
1661,0,71,7,64,
1662,0,71,6,65,
1663,0,70,6,64,
1664,0,73,7,66,
1665,0,72,6,66,
1666,0,72,7,65,
1667,0,72,6,66,
1668,0,73,6,67,
1669,0,73,7,66,
1670,0,73,6,67,
1671,0,72,6,66,
1672,0,75,7,68,
1673,0,74,7,67,
1674,0,74,7,67,
1675,0,74,6,68,
1676,0,73,6,67,
1677,0,77,7,70,
1678,0,75,6,69,
1679,0,74,6,68,
1680,0,76,7,69,
1681,0,76,6,70,
1682,0,76,7,69,
1683,0,76,6,70,
1684,0,75,6,69,
1685,0,76,7,69,
1686,0,79,7,71,1
1687,0,76,6,70,
1688,0,78,7,71,
1689,0,77,6,71,
1690,0,79,7,72,
1691,0,78,7,71,
1692,0,79,7,72,
1693,0,79,7,72,
1694,0,77,6,71,
1695,0,79,7,72,
1696,0,80,7,73,
1697,0,78,6,72,
1698,0,79,7,72,
1699,0,79,6,73,
1700,0,79,6,73,
1701,0,81,7,74,
1702,0,81,7,74,
1703,0,80,6,74,
1704,0,80,7,73,
1705,0,81,7,74,
1706,0,83,7,76,
1707,0,81,6,75,
1708,0,81,7,74,
1709,0,82,7,75,
1710,0,81,6,75,
1711,0,82,7,75,
1712,0,83,7,76,
1713,0,82,7,75,
1714,0,82,6,76,
1715,0,82,6,76,
1716,0,83,7,75,1
1717,0,81,6,75,
1718,0,83,7,76,
1719,0,81,6,75,
1720,0,79,7,72,
1721,0,65,6,59,
1722,0,54,7,47,
1723,0,52,6,46,
1724,0,50,7,43,
1725,0,40,6,34,
1726,0,32,7,25,
1727,0,26,7,19,
1728,0,23,6,17,
1729,0,33,7,26,
1730,0,39,6,33,
1731,0,40,7,33,
1732,0,40,6,34,
1733,0,40,6,34,
1734,0,44,7,37,
1735,0,42,6,36,
1736,0,42,6,36,
1737,0,44,7,37,
1738,0,44,6,38,
1739,0,44,7,37,
1740,0,45,6,39,
1741,0,44,6,38,
1742,0,47,7,40,
1743,0,46,6,40,
1744,0,45,6,39,
1745,0,49,7,42,
1746,0,47,7,40,
1747,0,49,6,42,1
1748,0,47,6,41,
1749,0,49,7,42,
1750,0,50,8,42,
1751,0,51,8,43,
1752,0,50,6,44,
1753,0,49,6,43,
1754,0,53,7,46,
1755,0,52,7,45,
1756,0,50,6,44,
1757,0,52,7,45,
1758,0,53,7,46,
1759,0,53,6,47,
1760,0,53,7,46,
1761,0,53,6,47,
1762,0,54,7,47,
1763,0,56,7,49,
1764,0,54,6,48,
1765,0,54,6,48,
1766,0,56,7,49,
1767,0,55,6,49,
1768,0,56,7,49,
1769,0,56,6,50,
1770,0,55,6,49,
1771,0,58,7,51,
1772,0,58,7,51,
1773,0,56,6,50,
1774,0,59,7,52,
1775,0,57,6,51,
1776,0,59,7,52,
1777,0,61,7,53,1
1778,0,59,7,52,
1779,0,60,7,53,
1780,0,59,6,53,
1781,0,62,7,55,
1782,0,60,6,54,
1783,0,64,8,56,
1784,0,61,7,54,
1785,0,61,7,54,
1786,0,62,7,55,
1787,0,62,6,56,
1788,0,62,7,55,
1789,0,63,7,56,
1790,0,62,6,56,
1791,0,65,7,58,
1792,0,63,6,57,
1793,0,62,6,56,
1794,0,65,7,58,
1795,0,66,7,59,
1796,0,64,6,58,
1797,0,66,7,59,
1798,0,64,6,58,
1799,0,66,7,59,
1800,0,65,6,59,
1801,0,65,6,59,
1802,0,67,7,60,
1803,0,66,6,60,
1804,0,66,7,59,
1805,0,67,6,61,
1806,0,66,6,60,
1807,0,67,7,60,
1808,0,71,8,62,1
1809,0,68,6,62,
1810,0,71,9,62,
1811,0,68,6,62,
1812,0,69,7,62,
1813,0,69,7,62,
1814,0,68,6,62,
1815,0,70,7,63,
1816,0,71,8,63,
1817,0,70,7,63,
1818,0,70,7,63,
1819,0,70,6,64,
1820,0,70,6,64,
1821,0,73,9,64,
1822,0,71,6,65,
1823,0,71,7,64,
1824,0,72,7,65,
1825,0,72,6,66,
1826,0,72,7,65,
1827,0,72,6,66,
1828,0,73,7,66,
1829,0,73,6,67,
1830,0,73,7,66,
1831,0,74,7,67,
1832,0,72,6,66,
1833,0,75,7,68,
1834,0,74,6,68,
1835,0,74,7,67,
1836,0,74,6,68,
1837,0,73,6,67,
1838,0,77,7,70,
1839,0,75,6,69,
1840,0,74,6,68,
1841,0,77,7,70,
1842,0,75,6,69,
1843,0,78,8,70,
1844,0,76,6,70,
1845,0,79,9,70,
1846,0,76,6,70,
1847,0,76,6,70,
1848,0,79,7,72,
1849,0,77,6,71,
1850,0,76,6,70,
1851,0,79,7,72,
1852,0,77,6,71,
1853,0,78,7,71,
1854,0,78,6,72,
1855,0,77,6,71,
1856,0,80,7,73,
1857,0,79,6,73,
1858,0,78,6,72,
1859,0,80,7,73,
1860,0,78,6,72,
1861,0,80,7,73,
1862,0,80,6,74,
1863,0,81,7,74,
1864,0,79,6,73,
1865,0,81,7,74,
1866,0,81,6,75,
1867,0,80,6,74,
1868,0,82,7,75,
1869,0,81,6,75,
1870,0,81,7,74,
1871,0,82,6,76,
1872,0,82,7,75,
1873,0,82,7,75,
1874,0,82,6,76,
1875,0,81,6,75,
1876,0,85,8,77,
1877,0,82,6,76,
1878,0,83,7,76,
1879,0,82,7,75,
1880,0,83,7,76,
1881,0,77,7,70,
1882,0,65,6,59,
1883,0,54,7,47,
1884,0,53,6,47,
1885,0,48,6,42,
1886,0,40,6,34,
1887,0,31,6,25,
1888,0,25,7,18,
1889,0,23,6,17,
1890,0,30,6,24,
1891,0,40,7,33,
1892,0,39,6,33,
1893,0,41,7,34,
1894,0,41,7,34,
1895,0,41,6,35,
1896,0,42,6,36,
1897,0,43,7,36,
1898,0,43,6,37,
1899,0,43,6,37,
1900,0,45,7,38,
1901,0,46,7,39,
1902,0,45,6,39,
1903,0,46,7,39,
1904,0,47,7,40,
1905,0,46,6,40,
1906,0,47,7,40,
1907,0,48,7,41,
1908,0,49,7,42,
1909,0,48,6,42,
1910,0,49,7,42,
1911,0,49,6,43,
1912,0,48,6,42,
1913,0,51,7,44,
1914,0,50,6,44,
1915,0,50,6,44,
1916,0,52,7,45,
1917,0,50,6,44,
1918,0,52,7,45,
1919,0,52,6,46,
1920,0,52,6,46,
1921,0,54,7,47,
1922,0,52,6,46,
1923,0,55,7,48,
1924,0,53,6,47,
1925,0,55,7,48,
1926,0,55,6,49,
1927,0,55,7,48,
1928,0,55,6,49,
1929,0,55,6,49,
1930,0,57,7,50,
1931,0,56,6,50,
1932,0,58,7,51,
1933,0,56,6,50,
1934,0,59,7,52,
1935,0,58,6,52,
1936,0,57,6,51,
1937,0,59,7,52,
1938,0,60,7,53,
1939,0,60,7,53,
1940,0,59,6,53,
1941,0,60,7,53,
1942,0,61,6,55,
1943,0,60,6,54,
1944,0,61,7,54,
1945,0,63,7,56,
1946,0,61,6,55,
1947,0,61,7,54,
1948,0,62,7,55,
1949,0,62,6,56,
1950,0,61,6,55,
1951,0,64,7,57,
1952,0,63,6,57,
1953,0,64,7,57,
1954,0,63,7,56,
1955,0,65,7,58,
1956,0,64,6,58,
1957,0,64,7,57,
1958,0,65,6,59,
1959,0,64,6,58,
1960,0,66,7,59,
1961,0,65,6,59,
1962,0,65,6,59,
1963,0,67,7,60,
1964,0,66,6,60,
1965,0,67,7,60,
1966,0,68,8,60,
1967,0,68,7,61,
1968,0,66,6,60,
1969,0,68,8,60,
1970,0,68,7,61,
1971,0,68,6,62,
1972,0,68,6,62,
1973,0,68,7,61,
1974,0,69,6,63,
1975,0,68,6,62,
1976,0,70,7,63,
1977,0,68,6,62,
1978,0,70,7,63,
1979,0,70,6,64,
1980,0,71,7,64,
1981,0,71,6,65,
1982,0,70,6,64,
1983,0,71,7,64,
1984,0,71,7,64,
1985,0,71,6,65,
1986,0,71,6,65,
1987,0,73,7,66,
1988,0,72,6,66,
1989,0,72,7,65,
1990,0,73,6,67,
1991,0,73,6,67,
1992,0,77,9,68,
1993,0,78,12,66,
1994,0,81,13,68,
1995,0,79,12,67,
1996,0,79,12,67,
1997,0,80,13,67,
1998,0,81,13,68,
1999,0,81,13,68,
2000,0,80,12,68,
2001,0,81,12,69,
2002,0,82,13,69,
2003,0,81,12,69,
2004,0,76,7,69,
2005,0,76,7,69,
2006,0,76,7,69,
2007,0,76,6,70,
2008,0,76,6,70,
2009,0,78,7,71,
2010,0,77,6,71,
2011,0,78,7,71,
2012,0,77,6,71,
2013,0,78,7,71,
2014,0,78,6,72,
2015,0,79,7,72,
2016,0,77,6,71,
2017,0,80,7,73,
2018,0,79,6,73,
2019,0,79,7,72,
2020,0,79,6,73,
2021,0,79,6,73,
2022,0,83,7,76,
2023,0,81,7,74,
2024,0,80,6,74,
2025,0,80,7,73,
2026,0,80,6,74,
2027,0,80,6,74,
2028,0,82,7,75,
2029,0,81,6,75,
2030,0,82,7,75,
2031,0,80,6,74,
2032,0,84,7,77,
2033,0,82,6,76,
2034,0,82,7,75,
2035,0,81,6,75,
2036,0,83,7,76,
2037,0,81,6,75,
2038,0,82,7,75,
2039,0,82,6,76,
2040,0,81,6,75,
2041,0,84,8,76,
2042,0,76,7,69,
2043,0,63,6,57,
2044,0,51,6,45,
2045,0,53,7,46,
2046,0,47,7,40,
2047,0,36,6,30,
2048,0,30,6,24,
2049,0,26,7,19,
2050,0,24,6,18,
2051,0,31,6,25,
2052,0,39,7,32,
2053,0,41,7,34,
2054,0,39,6,33,
2055,0,42,7,35,
2056,0,42,6,36,
2057,0,43,7,36,
2058,0,42,6,36,
2059,0,45,7,38,
2060,0,44,6,38,
2061,0,43,6,37,
2062,0,46,7,39,
2063,0,44,6,38,
2064,0,48,7,41,
2065,0,47,8,39,
2066,0,51,11,40,
2067,0,53,13,40,
2068,0,52,11,41,
2069,0,55,13,42,
2070,0,54,13,41,
2071,0,55,12,43,
2072,0,56,13,43,
2073,0,56,13,43,
2074,0,55,12,43,
2075,0,56,13,43,
2076,0,58,13,45,
2077,0,57,13,44,
2078,0,57,13,44,
2079,0,59,13,46,
2080,0,59,13,46,
2081,0,57,11,46,
2082,0,58,12,46,
2083,0,56,9,47,
2084,0,54,7,47,
2085,0,54,6,48,
2086,0,53,6,47,
2087,0,56,7,49,
2088,0,55,6,49,
2089,0,54,6,48,
2090,0,57,7,50,
2091,0,56,7,49,
2092,0,56,7,49,
2093,0,59,8,51,
2094,0,56,6,50,
2095,0,58,7,51,
2096,0,58,6,52,
2097,0,58,7,51,
2098,0,58,6,52,
2099,0,61,7,54,
2100,0,59,6,53,
2101,0,58,6,52,
2102,0,60,7,53,
2103,0,61,7,54,
2104,0,60,6,54,
2105,0,61,7,54,
2106,0,61,6,55,
2107,0,60,6,54,
2108,0,63,7,56,
2109,0,62,6,56,
2110,0,61,6,55,
2111,0,63,7,56,
2112,0,63,6,57,
2113,0,64,7,57,
2114,0,64,7,57,
2115,0,62,6,56,
2116,0,65,7,58,
2117,0,64,6,58,
2118,0,63,6,57,
2119,0,66,7,59,
2120,0,65,6,59,
2121,0,65,7,58,
2122,0,65,6,59,
2123,0,65,6,59,
2124,0,67,7,60,
2125,0,68,7,61,
2126,0,68,7,61,
2127,0,66,6,60,
2128,0,70,8,62,
2129,0,67,6,61,
2130,0,67,7,60,
2131,0,68,6,62,
2132,0,67,6,61,
2133,0,70,8,62,
2134,0,69,6,63,
2135,0,69,7,62,
2136,0,69,6,63,
2137,0,69,6,63,
2138,0,69,7,62,
2139,0,70,6,64,
2140,0,69,6,63,
2141,0,71,7,64,
2142,0,70,6,64,
2143,0,71,7,64,
2144,0,71,6,65,
2145,0,70,6,64,
2146,0,73,7,66,
2147,0,72,6,66,
2148,0,74,8,66,
2149,0,71,6,65,
2150,0,72,7,65,
2151,0,73,7,66,
2152,0,73,6,67,
2153,0,72,6,66,
2154,0,74,7,67,
2155,0,74,6,68,
2156,0,73,6,67,
2157,0,75,7,68,
2158,0,73,6,67,
2159,0,74,7,67,
2160,0,75,6,69,
2161,0,74,6,68,
2162,0,76,7,69,
2163,0,74,6,68,
2164,0,77,8,69,
2165,0,76,6,70,
2166,0,75,6,69,
2167,0,76,7,69,
2168,0,76,6,70,
2169,0,76,6,70,
2170,0,77,7,70,
2171,0,78,7,71,
2172,0,77,6,71,
2173,0,78,7,71,
2174,0,82,11,71,
2175,0,81,10,71,
2176,0,85,13,72,
2177,0,84,12,72,
2178,0,83,11,72,
2179,0,86,13,73,
2180,0,84,12,72,
2181,0,85,13,72,
2182,0,84,12,72,
2183,0,85,12,73,
2184,0,87,13,74,
2185,0,85,12,73,
2186,0,86,12,74,
2187,0,87,13,74,
2188,0,88,13,75,
2189,0,86,12,74,
2190,0,88,13,75,
2191,0,87,13,74,
2192,0,87,13,74,
2193,0,87,12,75,
2194,0,87,12,75,
2195,0,87,11,76,
2196,0,87,12,75,
2197,0,88,12,76,
2198,0,89,12,77,
2199,0,89,12,77,
2200,0,86,10,76,
2201,0,90,13,77,
2202,0,90,13,77,
2203,0,89,13,76,
2204,0,87,11,76,
2205,0,89,13,76,
2206,0,90,13,77,
2207,0,89,13,76,
2208,0,88,12,76,
2209,0,75,11,64,
2210,0,58,6,52,
2211,0,54,7,47,
2212,0,51,6,45,
2213,0,44,7,37,
2214,0,33,6,27,
2215,0,23,5,18,
2216,0,24,8,16,
2217,0,34,7,27,
2218,0,39,6,33,
2219,0,39,6,33,
2220,0,41,7,34,
2221,0,42,7,35,
2222,0,41,7,34,
2223,0,42,6,36,
2224,0,43,7,36,
2225,0,42,6,36,
2226,0,46,7,39,
2227,0,45,7,38,
2228,0,44,6,38,
2229,0,46,7,39,
2230,0,46,6,40,
2231,0,46,7,39,
2232,0,46,6,40,
2233,0,46,6,40,
2234,0,48,7,41,
2235,0,48,6,42,
2236,0,47,6,41,
2237,0,50,7,43,
2238,0,48,6,42,
2239,0,49,7,42,
2240,0,50,6,44,
2241,0,50,7,43,
2242,0,52,7,45,
2243,0,50,6,44,
2244,0,53,7,46,
2245,0,52,6,46,
2246,0,51,6,45,
2247,0,54,7,47,
2248,0,53,6,47,
2249,0,53,7,46,
2250,0,54,6,48,
2251,0,53,6,47,
2252,0,55,8,47,
2253,0,55,6,49,
2254,0,57,7,50,
2255,0,55,6,49,
2256,0,56,7,49,
2257,0,56,7,49,
2258,0,57,7,50,
2259,0,56,6,50,
2260,0,57,7,50,
2261,0,57,6,51,
2262,0,57,6,51,
2263,0,60,7,53,
2264,0,58,6,52,
2265,0,62,9,53,
2266,0,58,6,52,
2267,0,60,7,53,
2268,0,59,6,53,
2269,0,60,7,53,
2270,0,60,6,54,
2271,0,60,6,54,
2272,0,62,7,55,
2273,0,61,7,54,
2274,0,61,7,54,
2275,0,63,7,56,
2276,0,61,6,55,
2277,0,64,8,56,
2278,0,63,6,57,
2279,0,63,7,56,
2280,0,63,6,57,
2281,0,63,6,57,
2282,0,64,7,57,
2283,0,64,6,58,
2284,0,63,6,57,
2285,0,66,7,59,
2286,0,65,7,58,
2287,0,65,6,59,
2288,0,65,7,58,
2289,0,67,7,60,
2290,0,66,6,60,
2291,0,66,7,59,
2292,0,66,6,60,
2293,0,66,6,60,
2294,0,68,7,61,
2295,0,67,6,61,
2296,0,68,7,61,
2297,0,68,7,61,
2298,0,69,7,62,
2299,0,68,6,62,
2300,0,67,6,61,
2301,0,70,7,63,
2302,0,68,6,62,
2303,0,71,7,64,
2304,0,69,6,63,
2305,0,70,7,63,
2306,0,70,6,64,
2307,0,69,6,63,
2308,0,72,7,65,
2309,0,71,6,65,
2310,0,73,8,65,
2311,0,75,11,64,
2312,0,78,13,65,
2313,0,78,13,65,
2314,0,75,9,66,
2315,0,71,6,65,
2316,0,74,8,66,
2317,0,73,6,67,
2318,0,72,6,66,
2319,0,73,7,66,
2320,0,74,7,67,
2321,0,74,7,67,
2322,0,74,6,68,
2323,0,73,6,67,
2324,0,75,7,68,
2325,0,74,6,68,
2326,0,76,7,69,
2327,0,74,6,68,
2328,0,77,7,70,
2329,0,75,7,68,
2330,0,76,6,70,
2331,0,76,7,69,
2332,0,77,7,70,
2333,0,77,7,70,
2334,0,76,6,70,
2335,0,77,7,70,
2336,0,77,6,71,
2337,0,77,6,71,
2338,0,77,7,70,
2339,0,78,6,72,
2340,0,77,6,71,
2341,0,79,7,72,
2342,0,77,6,71,
2343,0,78,7,71,
2344,0,79,6,73,
2345,0,78,6,72,
2346,0,80,7,73,
2347,0,81,8,73,
2348,0,79,6,73,
2349,0,79,6,73,
2350,0,81,7,74,
2351,0,79,6,73,
2352,0,80,7,73,
2353,0,80,6,74,
2354,0,80,6,74,
2355,0,83,7,76,
2356,0,82,8,74,
2357,0,81,7,74,
2358,0,83,7,76,
2359,0,85,9,76,
2360,0,85,7,78,
2361,0,82,6,76,
2362,0,81,6,75,
2363,0,83,7,76,
2364,0,82,6,76,
2365,0,83,7,76,
2366,0,81,6,75,
2367,0,83,7,76,
2368,0,83,7,76,
2369,0,74,6,68,
2370,0,62,6,56,
2371,0,55,7,48,
2372,0,53,6,47,
2373,0,48,7,41,
2374,0,36,5,31,
2375,0,31,7,24,
2376,0,25,7,18,
2377,0,25,7,18,
2378,0,33,7,26,
2379,0,40,7,33,
2380,0,40,6,34,
2381,0,40,7,33,
2382,0,41,6,35,
2383,0,41,6,35,
2384,0,43,7,36,
2385,0,42,6,36,
2386,0,44,7,37,
2387,0,45,7,38,
2388,0,45,7,38,
2389,0,45,6,39,
2390,0,45,7,38,
2391,0,46,6,40,
2392,0,45,6,39,
2393,0,49,8,41,
2394,0,46,6,40,
2395,0,47,7,40,
2396,0,48,6,42,
2397,0,47,6,41,
2398,0,51,7,44,
2399,0,49,6,43,
2400,0,49,6,43,
2401,0,51,7,44,
2402,0,49,6,43,
2403,0,53,7,46,
2404,0,51,6,45,
2405,0,51,7,44,
2406,0,52,6,46,
2407,0,52,6,46,
2408,0,54,7,47,
2409,0,54,7,47,
2410,0,52,6,46,
2411,0,55,7,48,
2412,0,54,6,48,
2413,0,54,7,47,
2414,0,55,6,49,
2415,0,54,6,48,
2416,0,56,7,49,
2417,0,56,7,49,
2418,0,56,6,50,
2419,0,55,6,49,
2420,0,58,7,51,
2421,0,57,7,50,
2422,0,57,6,51,
2423,0,59,7,52,
2424,0,57,6,51,
2425,0,59,7,52,
2426,0,59,7,52,
2427,0,60,7,53,
2428,0,58,6,52,
2429,0,60,7,53,
2430,0,61,7,54,
2431,0,60,6,54,
2432,0,60,6,54,
2433,0,61,7,54,
2434,0,63,7,56,
2435,0,60,6,54,
2436,0,63,7,56,
2437,0,61,6,55,
2438,0,66,10,56,
2439,0,69,13,56,
2440,0,69,13,56,
2441,0,68,12,56,
2442,0,69,13,56,
2443,0,70,12,58,
2444,0,69,12,57,
2445,0,71,13,58,
2446,0,72,13,59,
2447,0,72,13,59,
2448,0,69,11,58,
2449,0,71,13,58,
2450,0,73,13,60,
2451,0,72,13,59,
2452,0,72,13,59,
2453,0,71,12,59,
2454,0,73,12,61,
2455,0,72,12,60,
2456,0,74,13,61,
2457,0,73,12,61,
2458,0,74,12,62,
2459,0,73,12,61,
2460,0,73,12,61,
2461,0,75,12,63,
2462,0,75,13,62,
2463,0,75,13,62,
2464,0,75,13,62,
2465,0,77,13,64,
2466,0,74,11,63,
2467,0,77,13,64,
2468,0,77,13,64,
2469,0,77,13,64,
2470,0,74,11,63,
2471,0,77,13,64,
2472,0,77,12,65,
2473,0,77,13,64,
2474,0,78,13,65,
2475,0,78,13,65,
2476,0,79,13,66,
2477,0,78,13,65,
2478,0,80,13,67,
2479,0,80,13,67,
2480,0,80,13,67,
2481,0,78,12,66,
2482,0,81,13,68,
2483,0,81,13,68,
2484,0,80,13,67,
2485,0,79,12,67,
2486,0,79,12,67,
2487,0,82,13,69,
2488,0,81,13,68,
2489,0,82,13,69,
2490,0,82,13,69,
2491,0,83,13,70,
2492,0,81,12,69,
2493,0,83,13,70,
2494,0,83,13,70,
2495,0,82,13,69,
2496,0,82,12,70,
2497,0,82,12,70,
2498,0,83,12,71,
2499,0,83,13,70,
2500,0,84,13,71,
2501,0,85,13,72,
2502,0,84,12,72,
2503,0,81,11,70,
2504,0,85,13,72,
2505,0,84,12,72,
2506,0,84,12,72,
2507,0,83,11,72,
2508,0,84,12,72,
2509,0,86,13,73,
2510,0,86,13,73,
2511,0,87,13,74,
2512,0,85,12,73,
2513,0,86,12,74,
2514,0,85,12,73,
2515,0,88,13,75,
2516,0,86,12,74,
2517,0,87,13,74,
2518,0,85,11,74,
2519,0,87,12,75,
2520,0,89,13,76,
2521,0,86,11,75,
2522,0,88,12,76,
2523,0,89,13,76,
2524,0,89,13,76,
2525,0,88,12,76,
2526,0,90,13,77,
2527,0,89,13,76,
2528,0,88,12,76,
2529,0,87,12,75,
2530,0,90,13,77,
2531,0,89,13,76,
2532,0,86,11,75,
2533,0,88,12,76,
2534,0,87,11,76,
2535,0,81,13,68,
2536,0,68,12,56,
2537,0,63,13,50,
2538,0,62,13,49,
2539,0,56,13,43,
2540,0,48,10,38,
2541,0,47,13,34,
2542,0,48,13,35,
2543,0,55,13,42,
2544,0,61,12,49,
2545,0,61,12,49,
2546,0,62,13,49,
2547,0,62,13,49,
2548,0,63,13,50,
2549,0,63,13,50,
2550,0,63,13,50,
2551,0,62,12,50,
2552,0,65,13,52,
2553,0,65,13,52,
2554,0,63,12,51,
2555,0,65,12,53,
2556,0,65,12,53,
2557,0,64,12,52,
2558,0,63,11,52,
2559,0,66,12,54,
2560,0,66,13,53,
2561,0,65,12,53,
2562,0,64,10,54,
2563,0,63,7,56,
2564,0,62,7,55,
2565,0,61,6,55,
2566,0,63,7,56,
2567,0,62,6,56,
2568,0,63,7,56,
2569,0,63,7,56,
2570,0,64,7,57,
2571,0,62,6,56,
2572,0,66,7,59,
2573,0,64,6,58,
2574,0,64,7,57,
2575,0,66,8,58,
2576,0,65,6,59,
2577,0,65,7,58,
2578,0,65,6,59,
2579,0,64,6,58,
2580,0,67,7,60,
2581,0,66,6,60,
2582,0,65,6,59,
2583,0,68,7,61,
2584,0,66,6,60,
2585,0,67,7,60,
2586,0,67,6,61,
2587,0,67,6,61,
2588,0,69,7,62,
2589,0,67,6,61,
2590,0,69,7,62,
2591,0,68,6,62,
2592,0,70,7,63,
2593,0,69,6,63,
2594,0,69,7,62,
2595,0,70,6,64,
2596,0,70,7,63,
2597,0,71,7,64,
2598,0,69,6,63,
2599,0,71,7,64,
2600,0,71,6,65,
2601,0,70,6,64,
2602,0,71,7,64,
2603,0,72,6,66,
2604,0,72,7,65,
2605,0,72,6,66,
2606,0,71,6,65,
2607,0,73,7,66,
2608,0,73,6,67,
2609,0,74,7,67,
2610,0,74,7,67,
2611,0,73,7,66,
2612,0,74,7,67,
2613,0,74,6,68,
2614,0,73,6,67,
2615,0,75,7,68,
2616,0,74,6,68,
2617,0,75,7,68,
2618,0,75,6,69,
2619,0,74,6,68,
2620,0,76,7,69,
2621,0,77,7,70,
2622,0,75,6,69,
2623,0,77,7,70,
2624,0,77,7,70,
2625,0,76,6,70,
2626,0,78,7,71,
2627,0,77,6,71,
2628,0,77,7,70,
2629,0,78,7,71,
2630,0,78,6,72,
2631,0,78,7,71,
2632,0,78,6,72,
2633,0,77,6,71,
2634,0,79,7,72,
2635,0,79,6,73,
2636,0,80,8,72,
2637,0,79,6,73,
2638,0,79,6,73,
2639,0,80,7,73,
2640,0,80,6,74,
2641,0,79,6,73,
2642,0,80,7,73,
2643,0,82,7,75,
2644,0,81,6,75,
2645,0,81,7,74,
2646,0,81,6,75,
2647,0,81,6,75,
2648,0,81,7,74,
2649,0,82,6,76,
2650,0,81,6,75,
2651,0,84,8,76,
2652,0,82,6,76,
2653,0,82,7,75,
2654,0,82,6,76,
2655,0,81,6,75,
2656,0,84,7,77,
2657,0,82,6,76,
2658,0,83,7,76,
2659,0,81,6,75,
2660,0,73,7,66,
2661,0,60,6,54,
2662,0,54,7,47,
2663,0,50,6,44,
2664,0,47,7,40,
2665,0,36,6,30,
2666,0,27,6,21,
2667,0,23,6,17,
2668,0,26,7,19,
2669,0,39,6,33,
2670,0,38,6,32,
2671,0,40,7,33,
2672,0,42,7,35,
2673,0,41,6,35,
2674,0,42,7,35,
2675,0,42,6,36,
2676,0,43,6,37,
2677,0,43,7,36,
2678,0,44,6,38,
2679,0,43,6,37,
2680,0,46,7,39,
2681,0,45,7,38,
2682,0,46,6,40,
2683,0,45,6,39,
2684,0,48,7,41,
2685,0,47,6,41,
2686,0,49,7,42,
2687,0,47,6,41,
2688,0,49,7,42,
2689,0,50,7,43,
2690,0,49,6,43,
2691,0,50,7,43,
2692,0,51,7,44,
2693,0,49,6,43,
2694,0,53,7,46,
2695,0,51,6,45,
2696,0,53,7,46,
2697,0,52,6,46,
2698,0,54,8,46,
2699,0,53,7,46,
2700,0,53,6,47,
2701,0,52,6,46,
2702,0,55,7,48,
2703,0,54,6,48,
2704,0,56,7,49,
2705,0,54,6,48,
2706,0,55,7,48,
2707,0,56,6,50,
2708,0,55,6,49,
2709,0,57,7,50,
2710,0,56,6,50,
2711,0,58,7,51,
2712,0,57,7,50,
2713,0,59,7,52,
2714,0,58,6,52,
2715,0,58,7,51,
2716,0,60,7,53,
2717,0,58,6,52,
2718,0,60,7,53,
2719,0,59,7,52,
2720,0,60,6,54,
2721,0,61,7,54,
2722,0,59,6,53,
2723,0,63,7,56,
2724,0,60,6,54,
2725,0,61,7,54,
2726,0,63,7,56,
2727,0,62,6,56,
2728,0,62,7,55,
2729,0,62,7,55,
2730,0,64,7,57,
2731,0,62,6,56,
2732,0,65,7,58,
2733,0,64,6,58,
2734,0,63,6,57,
2735,0,66,7,59,
2736,0,64,6,58,
2737,0,64,6,58,
2738,0,66,7,59,
2739,0,64,6,58,
2740,0,66,7,59,
2741,0,67,7,60,
2742,0,65,6,59,
2743,0,68,7,61,
2744,0,67,6,61,
2745,0,66,6,60,
2746,0,68,7,61,
2747,0,66,6,60,
2748,0,69,7,62,
2749,0,69,7,62,
2750,0,58,6,52,
2751,0,47,7,40,
2752,0,47,6,41,
2753,0,47,6,41,
2754,0,50,8,42,
2755,0,55,7,48,
2756,0,63,6,57,
2757,0,72,8,64,
2758,0,69,6,63,
2759,0,72,8,64,
2760,0,72,7,65,
2761,0,70,6,64,
2762,0,71,7,64,
2763,0,72,7,65,
2764,0,72,6,66,
2765,0,72,7,65,
2766,0,72,6,66,
2767,0,71,6,65,
2768,0,73,7,66,
2769,0,73,6,67,
2770,0,72,6,66,
2771,0,74,7,67,
2772,0,75,7,68,
2773,0,74,6,68,
2774,0,74,7,67,
2775,0,74,6,68,
2776,0,73,6,67,
2777,0,76,7,69,
2778,0,75,6,69,
2779,0,74,6,68,
2780,0,76,7,69,
2781,0,74,6,68,
2782,0,76,7,69,
2783,0,76,6,70,
2784,0,76,7,69,
2785,0,76,6,70,
2786,0,76,6,70,
2787,0,79,7,72,
2788,0,77,6,71,
2789,0,76,6,70,
2790,0,78,7,71,
2791,0,78,7,71,
2792,0,78,6,72,
2793,0,79,7,72,
2794,0,77,6,71,
2795,0,79,7,72,
2796,0,79,6,73,
2797,0,78,6,72,
2798,0,80,7,73,
2799,0,78,6,72,
2800,0,79,7,72,
2801,0,80,6,74,
2802,0,79,6,73,
2803,0,81,7,74,
2804,0,79,6,73,
2805,0,83,7,76,
2806,0,81,6,75,
2807,0,80,6,74,
2808,0,82,7,75,
2809,0,81,6,75,
2810,0,83,8,75,
2811,0,83,8,75,
2812,0,83,7,76,
2813,0,81,6,75,
2814,0,84,7,77,
2815,0,82,6,76,
2816,0,81,6,75,
2817,0,82,7,75,
2818,0,82,7,75,
2819,0,82,7,75,
2820,0,82,6,76,
2821,0,70,6,64,
2822,0,59,7,52,
2823,0,53,7,46,
2824,0,51,6,45,
2825,0,45,6,39,
2826,0,35,6,29,
2827,0,28,7,21,
2828,0,22,5,17,
2829,0,26,7,19,
2830,0,38,6,32,
2831,0,41,7,34,
2832,0,42,7,35,
2833,0,41,6,35,
2834,0,40,6,34,
2835,0,44,7,37,
2836,0,42,7,35,
2837,0,43,6,37,
2838,0,42,6,36,
2839,0,45,7,38,
2840,0,45,6,39,
2841,0,45,6,39,
2842,0,44,6,38,
2843,0,47,7,40,
2844,0,45,6,39,
2845,0,47,7,40,
2846,0,47,6,41,
2847,0,48,7,41,
2848,0,48,6,42,
2849,0,48,6,42,
2850,0,51,7,44,
2851,0,49,7,42,
2852,0,51,7,44,
2853,0,51,7,44,
2854,0,50,6,44,
2855,0,52,7,45,
2856,0,51,6,45,
2857,0,52,7,45,
2858,0,52,6,46,
2859,0,52,6,46,
2860,0,53,7,46,
2861,0,53,6,47,
2862,0,53,6,47,
2863,0,55,7,48,
2864,0,53,6,47,
2865,0,55,7,48,
2866,0,55,6,49,
2867,0,54,6,48,
2868,0,58,7,51,
2869,0,61,9,52,
2870,0,55,6,49,
2871,0,58,7,51,
2872,0,59,7,52,
2873,0,58,7,51,
2874,0,58,6,52,
2875,0,59,7,52,
2876,0,57,6,51,
2877,0,61,7,54,
2878,0,59,7,52,
2879,0,59,6,53,
2880,0,59,6,53,
2881,0,61,7,54,
2882,0,59,6,53,
2883,0,61,8,53,
2884,0,61,6,55,
2885,0,60,6,54,
2886,0,63,7,56,
2887,0,62,6,56,
2888,0,62,7,55,
2889,0,63,7,56,
2890,0,62,6,56,
2891,0,65,7,58,
2892,0,63,6,57,
2893,0,65,7,58,
2894,0,63,6,57,
2895,0,66,7,59,
2896,0,64,6,58,
2897,0,64,6,58,
2898,0,66,7,59,
2899,0,64,6,58,
2900,0,65,7,58,
2901,0,67,7,60,
2902,0,66,7,59,
2903,0,67,7,60,
2904,0,66,6,60,
2905,0,67,7,60,
2906,0,68,7,61,
2907,0,68,7,61,
2908,0,66,6,60,
2909,0,68,7,61,
2910,0,68,6,62,
2911,0,68,7,61,
2912,0,70,7,63,
2913,0,71,7,64,
2914,0,69,6,63,
2915,0,68,6,62,
2916,0,71,7,64,
2917,0,69,6,63,
2918,0,70,7,63,
2919,0,70,6,64,
2920,0,70,7,63,
2921,0,71,6,65,
2922,0,71,6,65,
2923,0,72,7,65,
2924,0,70,6,64,
2925,0,73,7,66,
2926,0,71,6,65,
2927,0,74,7,67,
2928,0,72,6,66,
2929,0,73,7,66,
2930,0,73,6,67,
2931,0,73,6,67,
2932,0,73,7,66,
2933,0,74,7,67,
2934,0,74,6,68,
2935,0,73,6,67,
2936,0,75,7,68,
2937,0,74,6,68,
2938,0,75,7,68,
2939,0,74,6,68,
2940,0,77,7,70,
2941,0,75,6,69,
2942,0,77,7,70,
2943,0,77,7,70,
2944,0,75,6,69,
2945,0,77,7,70,
2946,0,76,6,70,
2947,0,77,7,70,
2948,0,77,6,71,
2949,0,77,6,71,
2950,0,77,7,70,
2951,0,78,6,72,
2952,0,77,6,71,
2953,0,79,7,72,
2954,0,80,7,73,
2955,0,78,6,72,
2956,0,79,7,72,
2957,0,79,6,73,
2958,0,81,7,74,
2959,0,79,6,73,
2960,0,78,6,72,
2961,0,81,7,74,
2962,0,80,7,73,
2963,0,80,7,73,
2964,0,80,6,74,
2965,0,80,7,73,
2966,0,82,7,75,
2967,0,81,6,75,
2968,0,80,6,74,
2969,0,81,7,74,
2970,0,82,7,75,
2971,0,82,6,76,
2972,0,82,7,75,
2973,0,83,7,76,
2974,0,81,6,75,
2975,0,83,7,76,
2976,0,82,6,76,
2977,0,81,6,75,
2978,0,83,7,76,
2979,0,82,6,76,
2980,0,82,7,75,
2981,0,79,6,73,
2982,0,66,6,60,
2983,0,55,7,48,
2984,0,54,7,47,
2985,0,49,6,43,
2986,0,41,6,35,
2987,0,32,6,26,
2988,0,27,7,20,
2989,0,23,6,17,
2990,0,31,7,24,
2991,0,38,6,32,
2992,0,42,8,34,
2993,0,40,7,33,
2994,0,41,6,35,
2995,0,40,6,34,
2996,0,44,7,37,
2997,0,42,6,36,
2998,0,45,7,38,
2999,0,43,7,36,
3000,0,44,6,38,
3001,0,43,6,37,
3002,0,46,7,39,
3003,0,47,8,39,
3004,0,46,6,40,
3005,0,45,6,39,
3006,0,48,7,41,
3007,0,47,6,41,
3008,0,49,7,42,
3009,0,47,6,41,
3010,0,50,7,43,
3011,0,49,6,43,
3012,0,49,7,42,
3013,0,50,6,44,
3014,0,52,7,45,
3015,0,51,6,45,
3016,0,50,6,44,
3017,0,52,7,45,
3018,0,52,6,46,
3019,0,52,7,45,
3020,0,53,6,47,
3021,0,52,6,46,
3022,0,54,7,47,
3023,0,54,6,48,
3024,0,55,7,48,
3025,0,53,6,47,
3026,0,56,7,49,
3027,0,55,6,49,
3028,0,55,7,48,
3029,0,56,6,50,
3030,0,55,6,49,
3031,0,57,7,50,
3032,0,57,7,50,
3033,0,57,6,51,
3034,0,56,6,50,
3035,0,59,8,51,
3036,0,58,6,52,
3037,0,57,6,51,
3038,0,60,7,53,
3039,0,58,6,52,
3040,0,61,7,54,
3041,0,60,6,54,
3042,0,59,6,53,
3043,0,62,7,55,
3044,0,60,6,54,
3045,0,62,7,55,
3046,0,60,6,54,
3047,0,62,7,55,
3048,0,62,6,56,
3049,0,62,7,55,
3050,0,62,6,56,
3051,0,62,6,56,
3052,0,65,7,58,
3053,0,63,6,57,
3054,0,62,6,56,
3055,0,65,7,58,
3056,0,63,6,57,
3057,0,66,8,58,
3058,0,65,7,58,
3059,0,66,7,59,
3060,0,66,7,59,
3061,0,64,6,58,
3062,0,68,7,61,
3063,0,66,6,60,
3064,0,66,7,59,
3065,0,65,6,59,
3066,0,68,7,61,
3067,0,66,6,60,
3068,0,67,7,60,
3069,0,67,6,61,
3070,0,67,6,61,
3071,0,70,7,63,
3072,0,68,6,62,
3073,0,67,6,61,
3074,0,70,7,63,
3075,0,70,7,63,
3076,0,69,6,63,
3077,0,69,7,62,
3078,0,70,6,64,
3079,0,69,6,63,
3080,0,72,7,65,
3081,0,70,6,64,
3082,0,70,6,64,
3083,0,72,7,65,
3084,0,70,6,64,
3085,0,71,7,64,
3086,0,73,7,66,
3087,0,71,6,65,
3088,0,73,7,66,
3089,0,72,6,66,
3090,0,72,6,66,
3091,0,74,7,67,
3092,0,72,6,66,
3093,0,73,7,66,
3094,0,73,6,67,
3095,0,75,7,68,
3096,0,73,6,67,
3097,0,75,7,68,
3098,0,74,6,68,
3099,0,74,6,68,
3100,0,76,7,69,
3101,0,75,6,69,
3102,0,75,7,68,
3103,0,76,6,70,
3104,0,75,6,69,
3105,0,77,7,70,
3106,0,76,6,70,
3107,0,76,7,69,
3108,0,77,6,71,
3109,0,77,6,71,
3110,0,77,7,70,
3111,0,77,6,71,
3112,0,76,6,70,
3113,0,80,8,72,
3114,0,77,6,71,
3115,0,79,7,72,
3116,0,78,7,71,
3117,0,79,6,73,
3118,0,79,6,73,
3119,0,79,7,72,
3120,0,79,6,73,
3121,0,79,7,72,
3122,0,80,6,74,
3123,0,79,6,73,
3124,0,81,7,74,
3125,0,79,6,73,
3126,0,80,7,73,
3127,0,80,6,74,
3128,0,83,7,76,
3129,0,81,6,75,
3130,0,81,7,74,
3131,0,81,6,75,
3132,0,81,6,75,
3133,0,83,7,76,
3134,0,82,6,76,
3135,0,82,7,75,
3136,0,82,6,76,
3137,0,82,6,76,
3138,0,82,7,75,
3139,0,82,6,76,
3140,0,81,6,75,
3141,0,83,7,76,
3142,0,82,6,76,
3143,0,71,7,64,
3144,0,57,6,51,
3145,0,54,7,47,
3146,0,50,6,44,
3147,0,44,6,38,
3148,0,34,6,28,
3149,0,28,7,21,
3150,0,23,6,17,
3151,0,28,7,21,
3152,0,39,6,33,
3153,0,40,6,34,
3154,0,41,7,34,
3155,0,40,6,34,
3156,0,42,7,35,
3157,0,41,6,35,
3158,0,42,7,35,
3159,0,43,6,37,
3160,0,44,7,37,
3161,0,43,6,37,
3162,0,46,7,39,
3163,0,45,6,39,
3164,0,44,6,38,
3165,0,47,7,40,
3166,0,46,7,39,
3167,0,47,6,41,
3168,0,46,6,40,
3169,0,49,7,42,
3170,0,47,6,41,
3171,0,48,7,41,
3172,0,49,6,43,
3173,0,48,6,42,
3174,0,52,8,44,
3175,0,50,7,43,
3176,0,51,6,45,
3177,0,50,6,44,
3178,0,51,7,44,
3179,0,53,7,46,
3180,0,52,7,45,
3181,0,52,6,46,
3182,0,53,6,47,
3183,0,53,7,46,
3184,0,54,6,48,
3185,0,53,6,47,
3186,0,54,7,47,
3187,0,56,7,49,
3188,0,55,7,48,
3189,0,55,6,49,
3190,0,55,6,49,
3191,0,58,7,51,
3192,0,56,6,50,
3193,0,56,6,50,
3194,0,58,7,51,
3195,0,57,6,51,
3196,0,60,7,53,
3197,0,57,6,51,
3198,0,59,7,52,
3199,0,58,6,52,
3200,0,61,7,54,
3201,0,59,6,53,
3202,0,59,7,52,
3203,0,62,7,55,
3204,0,60,7,53,
3205,0,60,6,54,
3206,0,60,6,54,
3207,0,62,7,55,
3208,0,60,6,54,
3209,0,62,7,55,
3210,0,62,6,56,
3211,0,61,6,55,
3212,0,63,7,56,
3213,0,63,7,56,
3214,0,63,6,57,
3215,0,62,6,56,
3216,0,64,7,57,
3217,0,64,7,57,
3218,0,64,6,58,
3219,0,63,6,57,
3220,0,67,7,60,
3221,0,65,6,59,
3222,0,64,6,58,
3223,0,67,7,60,
3224,0,65,6,59,
3225,0,68,7,61,
3226,0,66,6,60,
3227,0,67,7,60,
3228,0,68,7,61,
3229,0,67,6,61,
3230,0,67,7,60,
3231,0,69,7,62,
3232,0,67,6,61,
3233,0,69,7,62,
3234,0,68,7,61,
3235,0,69,6,63,
3236,0,68,6,62,
3237,0,70,7,63,
3238,0,69,6,63,
3239,0,69,6,63,
3240,0,71,7,64,
3241,0,69,6,63,
3242,0,71,7,64,
3243,0,71,7,64,
3244,0,71,6,65,
3245,0,73,8,65,
3246,0,72,7,65,
3247,0,74,7,67,
3248,0,73,7,66,
3249,0,71,6,65,
3250,0,74,7,67,
3251,0,73,6,67,
3252,0,73,7,66,
3253,0,74,7,67,
3254,0,72,6,66,
3255,0,75,7,68,
3256,0,74,6,68,
3257,0,73,6,67,
3258,0,76,7,69,
3259,0,74,6,68,
3260,0,75,7,68,
3261,0,75,6,69,
3262,0,74,6,68,
3263,0,76,7,69,
3264,0,75,6,69,
3265,0,82,12,70,
3266,0,82,13,69,
3267,0,81,11,70,
3268,0,82,12,70,
3269,0,83,13,70,
3270,0,82,12,70,
3271,0,84,13,71,
3272,0,83,13,70,
3273,0,83,13,70,
3274,0,84,13,71,
3275,0,84,12,72,
3276,0,84,13,71,
3277,0,83,12,71,
3278,0,84,12,72,
3279,0,86,13,73,
3280,0,85,13,72,
3281,0,84,12,72,
3282,0,86,13,73,
3283,0,85,12,73,
3284,0,85,12,73,
3285,0,86,13,73,
3286,0,86,12,74,
3287,0,85,12,73,
3288,0,87,13,74,
3289,0,87,12,75,
3290,0,88,13,75,
3291,0,87,13,74,
3292,0,86,11,75,
3293,0,89,13,76,
3294,0,88,13,75,
3295,0,87,12,75,
3296,0,88,13,75,
3297,0,89,13,76,
3298,0,88,12,76,
3299,0,88,12,76,
3300,0,89,12,77,
3301,0,89,12,77,
3302,0,88,13,75,
3303,0,89,12,77,
3304,0,90,13,77,
3305,0,89,13,76,
3306,0,88,12,76,
3307,0,82,9,73,
3308,0,69,7,62,
3309,0,56,6,50,
3310,0,52,6,46,
3311,0,51,7,44,
3312,0,43,6,37,
3313,0,37,6,31,
3314,0,38,7,31,
3315,0,38,6,32,
3316,0,45,7,38,
3317,0,55,6,49,
3318,0,56,7,49,
3319,0,55,6,49,
3320,0,58,7,51,
3321,0,56,6,50,
3322,0,57,7,50,
3323,0,58,7,51,
3324,0,56,6,50,
3325,0,58,7,51,
3326,0,58,7,51,
3327,0,58,6,52,
3328,0,60,7,53,
3329,0,59,6,53,
3330,0,59,7,52,
3331,0,60,6,54,
3332,0,60,7,53,
3333,0,61,7,54,
3334,0,61,6,55,
3335,0,62,7,55,
3336,0,61,7,54,
3337,0,61,6,55,
3338,0,64,7,57,
3339,0,62,6,56,
3340,0,63,7,56,
3341,0,62,6,56,
3342,0,64,7,57,
3343,0,63,6,57,
3344,0,63,7,56,
3345,0,64,6,58,
3346,0,63,6,57,
3347,0,66,7,59,
3348,0,64,7,57,
3349,0,66,7,59,
3350,0,64,6,58,
3351,0,67,7,60,
3352,0,66,6,60,
3353,0,66,7,59,
3354,0,67,7,60,
3355,0,66,7,59,
3356,0,69,7,62,
3357,0,69,7,62,
3358,0,67,6,61,
3359,0,67,7,60,
3360,0,69,7,62,
3361,0,67,6,61,
3362,0,69,7,62,
3363,0,68,6,62,
3364,0,70,7,63,
3365,0,70,7,63,
3366,0,69,6,63,
3367,0,69,7,62,
3368,0,70,7,63,
3369,0,69,6,63,
3370,0,70,7,63,
3371,0,71,7,64,
3372,0,71,6,65,
3373,0,71,7,64,
3374,0,71,6,65,
3375,0,71,6,65,
3376,0,72,7,65,
3377,0,72,6,66,
3378,0,73,7,66,
3379,0,71,6,65,
3380,0,74,7,67,
3381,0,73,6,67,
3382,0,73,7,66,
3383,0,73,6,67,
3384,0,74,6,68,
3385,0,75,7,68,
3386,0,73,6,67,
3387,0,74,7,67,
3388,0,75,7,68,
3389,0,75,6,69,
3390,0,75,7,68,
3391,0,75,6,69,
3392,0,74,6,68,
3393,0,77,7,70,
3394,0,76,7,69,
3395,0,76,6,70,
3396,0,75,6,69,
3397,0,77,7,70,
3398,0,77,6,71,
3399,0,77,7,70,
3400,0,77,6,71,
3401,0,78,7,71,
3402,0,78,6,72,
3403,0,77,6,71,
3404,0,79,7,72,
3405,0,77,6,71,
3406,0,80,7,73,
3407,0,79,6,73,
3408,0,80,7,73,
3409,0,78,6,72,
3410,0,80,7,73,
3411,0,79,6,73,
3412,0,80,7,73,
3413,0,81,7,74,
3414,0,79,6,73,
3415,0,82,7,75,
3416,0,81,7,74,
3417,0,81,7,74,
3418,0,81,6,75,
3419,0,80,6,74,
3420,0,83,7,76,
3421,0,81,6,75,
3422,0,81,6,75,
3423,0,82,7,75,
3424,0,82,7,75,
3425,0,82,6,76,
3426,0,82,7,75,
3427,0,82,7,75,
3428,0,71,3,68,
3429,0,81,7,74,
3430,0,80,6,74,
3431,0,82,7,75,
3432,0,71,6,65,
3433,0,58,6,52,
3434,0,55,7,48,
3435,0,52,6,46,
3436,0,47,7,40,
3437,0,41,5,36,
3438,0,29,7,22,
3439,0,13,4,9,
3444,0,21,6,15,
3445,0,27,6,21,
3446,0,49,7,42,
3447,0,55,7,48,
3448,0,56,6,50,
3449,0,56,7,49,
3450,0,55,6,49,
3451,0,58,7,51,
3452,0,57,6,51,
3453,0,57,7,50,
3454,0,58,6,52,
3455,0,58,6,52,
3456,0,59,7,52,
3457,0,58,7,51,
3458,0,59,6,53,
3459,0,58,6,52,
3460,0,60,7,53,
3461,0,60,6,54,
3462,0,60,7,53,
3463,0,59,6,53,
3464,0,63,7,56,
3465,0,61,6,55,
3466,0,61,7,54,
3467,0,62,6,56,
3468,0,61,6,55,
3469,0,63,7,56,
3470,0,62,6,56,
3471,0,63,7,56,
3472,0,63,6,57,
3473,0,63,6,57,
3474,0,64,7,57,
3475,0,64,6,58,
3476,0,63,6,57,
3477,0,64,7,57,
3478,0,67,8,59,
3479,0,65,6,59,
3480,0,65,7,58,
3481,0,65,6,59,
3482,0,66,6,60,
3483,0,66,7,59,
3484,0,67,7,60,
3485,0,67,6,61,
3486,0,66,6,60,
3487,0,68,7,61,
3488,0,67,6,61,
3489,0,68,7,61,
3490,0,68,6,62,
3491,0,68,6,62,
3492,0,69,7,62,
3493,0,71,8,63,
3494,0,68,6,62,
3495,0,70,7,63,
3496,0,68,6,62,
3497,0,72,7,65,
3498,0,70,6,64,
3499,0,71,7,64,
3500,0,70,6,64,
3501,0,71,7,64,
3502,0,71,6,65,
3503,0,70,6,64,
3504,0,71,7,64,
3505,0,72,7,65,
3506,0,72,7,65,
3507,0,72,7,65,
3508,0,72,6,66,
3509,0,72,6,66,
3510,0,74,7,67,
3511,0,73,6,67,
3512,0,72,6,66,
3513,0,74,7,67,
3514,0,75,7,68,
3515,0,74,6,68,
3516,0,74,7,67,
3517,0,74,6,68,
3518,0,75,6,69,
3519,0,75,7,68,
3520,0,75,7,68,
3521,0,75,6,69,
3522,0,74,6,68,
3523,0,76,7,69,
3524,0,75,6,69,
3525,0,77,7,70,
3526,0,77,6,71,
3527,0,79,7,72,
3528,0,77,6,71,
3529,0,77,7,70,
3530,0,78,7,71,
3531,0,76,6,70,
3532,0,79,7,72,
3533,0,78,6,72,
3534,0,78,7,71,
3535,0,78,6,72,
3536,0,78,6,72,
3537,0,80,8,72,
3538,0,81,8,73,
3539,0,78,6,72,
3540,0,80,7,73,
3541,0,80,6,74,
3542,0,80,7,73,
3543,0,80,6,74,
3544,0,79,6,73,
3545,0,81,7,74,
3546,0,82,7,75,
3547,0,82,7,75,
3548,0,80,6,74,
3549,0,81,7,74,
3550,0,81,6,75,
3551,0,81,6,75,
3552,0,83,7,76,
3553,0,83,7,76,
3554,0,82,6,76,
3555,0,81,6,75,
3556,0,83,7,76,
3557,0,84,7,77,
3558,0,82,6,76,
3559,0,82,7,75,
3560,0,81,6,75,
3561,0,83,7,76,
3562,0,71,6,65,
3563,0,61,7,54,
3564,0,52,6,46,
3565,0,51,6,45,
3566,0,46,7,39,
3567,0,35,5,30,
3568,0,31,9,22,
3569,0,24,7,17,
3570,0,28,7,21,
3571,0,38,6,32,
3572,0,39,7,32,
3573,0,40,6,34,
3574,0,41,6,35,
3575,0,43,8,35,
3576,0,41,6,35,
3577,0,43,7,36,
3578,0,42,6,36,
3579,0,43,7,36,
3580,0,44,6,38,
3581,0,45,7,38,
3582,0,44,6,38,
3583,0,47,7,40,
3584,0,45,6,39,
3585,0,47,7,40,
3586,0,46,6,40,
3587,0,48,7,41,
3588,0,47,6,41,
3589,0,48,7,41,
3590,0,48,6,42,
3591,0,50,7,43,
3592,0,49,6,43,
3593,0,49,6,43,
3594,0,51,7,44,
3595,0,49,6,43,
3596,0,51,7,44,
3597,0,51,7,44,
3598,0,51,6,45,
3599,0,54,8,46,
3600,0,51,6,45,
3601,0,53,7,46,
3602,0,53,6,47,
3603,0,52,6,46,
3604,0,54,7,47,
3605,0,54,7,47,
3606,0,54,6,48,
3607,0,54,6,48,
3608,0,56,7,49,
3609,0,56,6,50,
3610,0,56,7,49,
3611,0,55,6,49,
3612,0,59,7,52,
3613,0,57,6,51,
3614,0,58,7,51,
3615,0,56,6,50,
3616,0,59,7,52,
3617,0,59,8,51,
3618,0,58,7,51,
3619,0,59,6,53,
3620,0,58,6,52,
3621,0,60,7,53,
3622,0,59,6,53,
3623,0,61,7,54,
3624,0,59,6,53,
3625,0,61,7,54,
3626,0,61,6,55,
3627,0,60,6,54,
3628,0,62,8,54,
3629,0,63,7,56,
3630,0,64,7,57,
3631,0,62,6,56,
3632,0,62,6,56,
3633,0,65,7,58,
3634,0,63,6,57,
3635,0,63,7,56,
3636,0,49,1,48,
3637,0,27,,27,
3638,0,3,,3,
