window-id,queue-size-CL,queue-size-LL,10.0.0.13:37190 -> 10.0.1.13:3000,10.0.1.13:3000 -> 10.0.0.13:37190,10.0.0.13:41943 -> 10.0.1.13:1000
0,0,44,12,32,
1,0,36,11,25,
2,0,34,11,23,
3,0,32,11,21,
4,0,31,12,19,
5,0,29,11,18,
6,0,27,9,18,
7,0,25,9,16,
8,0,26,10,16,
9,0,29,12,17,
10,0,26,11,15,
11,0,27,10,17,
12,0,30,13,17,
13,0,27,9,18,
14,0,30,13,17,
15,0,28,11,17,
16,0,26,10,16,
17,0,28,12,16,
18,0,28,11,17,
19,0,30,13,17,
20,0,28,12,16,
21,0,28,11,17,
22,0,27,10,17,
23,0,29,13,16,
24,0,25,9,16,
25,0,30,12,18,
26,0,29,12,17,
27,0,30,13,17,
28,0,30,12,18,
29,0,29,12,17,
30,0,29,11,18,
31,0,30,12,18,
32,0,26,10,16,
33,0,26,11,15,
34,0,33,14,19,
35,0,29,11,18,
36,0,27,12,15,
37,0,27,11,16,
38,0,27,11,16,
39,0,27,10,17,
40,0,29,12,17,
41,0,27,12,15,
42,0,26,11,15,
43,0,27,12,15,
44,0,27,11,16,
45,0,29,14,15,
46,0,27,10,17,
47,0,28,11,17,
48,0,29,12,17,
49,0,29,12,17,
50,0,30,13,17,
51,0,29,12,17,
52,0,29,12,17,
53,0,27,11,16,
54,0,30,13,17,
55,0,27,11,16,
56,0,30,12,18,
57,0,30,12,18,
58,0,30,12,18,
59,0,30,11,19,
60,0,28,11,17,
61,0,28,11,17,
62,0,28,11,17,
63,0,29,11,18,
64,0,27,10,17,
65,0,28,12,16,
66,0,29,11,18,
67,0,29,12,17,
68,0,27,10,17,
69,0,30,13,17,
70,0,29,13,16,
71,0,28,12,16,
72,0,29,13,16,
73,0,30,12,18,
74,0,30,13,17,
75,0,30,12,18,
76,0,30,13,17,
77,0,30,12,18,
78,0,31,13,18,
79,0,29,12,17,
80,0,30,13,17,
81,0,29,11,18,
82,0,30,13,17,
83,0,30,12,18,
84,0,29,12,17,
85,0,31,13,18,
86,0,31,13,18,
87,0,30,12,18,
88,0,30,13,17,
89,0,30,13,17,
90,0,30,13,17,
91,0,30,13,17,
92,0,30,12,18,
93,0,30,12,18,
94,0,30,12,18,
95,0,31,13,18,
96,0,31,13,18,
97,0,31,13,18,
98,0,29,12,17,
99,0,32,13,19,
100,0,30,12,18,
101,0,31,13,18,
102,0,30,13,17,
103,0,30,13,17,
104,0,30,13,17,
105,0,29,12,17,
106,0,30,13,17,
107,0,31,14,17,
108,0,28,11,17,
109,0,30,13,17,
110,0,30,12,18,
111,0,30,13,17,
112,0,29,12,17,
113,0,29,13,16,
114,0,28,12,16,
115,0,30,12,18,
116,0,27,12,15,
117,0,28,12,16,
118,0,29,13,16,
119,0,29,13,16,
120,0,28,12,16,
121,0,27,12,15,
122,0,26,11,15,
123,0,27,12,15,
124,0,29,13,16,
125,0,23,8,15,
126,0,22,6,16,
127,0,22,6,16,
128,0,22,7,15,
129,0,25,6,19,
130,0,23,6,17,
131,0,25,7,18,
132,0,23,6,17,
133,0,24,7,17,
134,0,22,6,16,
135,0,21,6,15,
136,0,24,7,17,
137,0,22,6,16,
138,0,21,6,15,
139,0,25,7,18,
140,0,24,7,17,
141,0,24,7,17,
142,0,23,6,17,
143,0,23,7,16,
144,0,24,7,17,
145,0,23,6,17,
146,0,23,6,17,
147,0,25,7,18,
148,0,25,7,18,
149,0,25,8,17,
150,0,25,8,17,
151,0,24,8,16,
152,0,22,7,15,
153,0,26,8,18,
154,0,25,9,16,
155,0,24,8,16,
156,0,24,7,17,
157,0,25,7,18,
158,0,25,7,18,
159,0,23,6,17,
160,0,25,7,18,
161,0,24,6,18,
162,0,23,7,16,
163,0,23,6,17,
164,0,24,6,18,
165,0,24,7,17,
166,0,22,6,16,
167,0,21,6,15,
168,0,24,8,16,
169,0,21,6,15,
170,0,25,7,18,
171,0,23,6,17,
172,0,24,6,18,
173,0,25,7,18,
174,0,24,7,17,
175,0,23,7,16,
176,0,22,6,16,
177,0,21,6,15,
178,0,25,7,18,
179,0,23,6,17,
180,0,25,7,18,
181,0,24,7,17,
182,0,21,6,15,
183,0,24,7,17,
184,0,22,7,15,
185,0,22,6,16,
186,0,22,6,16,
187,0,23,6,17,
188,0,23,7,16,
189,0,23,7,16,
190,0,24,6,18,
191,0,23,6,17,
192,0,22,6,16,
193,0,25,7,18,
194,0,24,7,17,
195,0,23,6,17,
196,0,24,7,17,
197,0,24,6,18,
198,0,25,7,18,
199,0,25,7,18,
200,0,24,6,18,
201,0,25,7,18,
202,0,23,7,16,
203,0,25,7,18,
204,0,21,6,15,
205,0,23,7,16,
206,0,22,6,16,
207,0,22,7,15,
208,0,23,6,17,
209,0,23,7,16,
210,0,25,7,18,
211,0,23,6,17,
212,0,23,7,16,
213,0,23,7,16,
214,0,23,6,17,
215,0,22,6,16,
216,0,24,7,17,
217,0,21,6,15,
218,0,27,7,20,
219,0,23,6,17,
220,0,25,7,18,
221,0,22,6,16,
222,0,23,7,16,
223,0,24,6,18,
224,0,24,7,17,
225,0,23,7,16,
226,0,21,6,15,
227,0,23,7,16,
228,0,22,6,16,
229,0,22,7,15,
230,0,23,6,17,
231,0,22,6,16,
232,0,26,7,19,
233,0,24,6,18,
234,0,25,7,18,
235,0,23,7,16,
236,0,24,6,18,
237,0,25,7,18,
238,0,24,6,18,
239,0,23,7,16,
240,0,25,8,17,
241,0,24,8,16,
242,0,22,6,16,
243,0,22,7,15,
244,0,23,7,16,
245,0,23,6,17,
246,0,26,6,20,
247,0,24,6,18,
248,0,25,7,18,
249,0,24,6,18,
250,0,24,7,17,
251,0,23,7,16,
252,0,22,6,16,
253,0,22,7,15,
254,0,22,6,16,
255,0,22,6,16,
256,0,24,7,17,
257,0,24,6,18,
258,0,23,6,17,
259,0,25,8,17,
260,0,22,6,16,
261,0,22,7,15,
262,0,24,6,18,
263,0,23,6,17,
264,0,22,6,16,
265,0,24,7,17,
266,0,23,6,17,
267,0,23,7,16,
268,0,23,6,17,
269,0,22,7,15,
270,0,24,8,16,
271,0,23,6,17,
272,0,26,7,19,
273,0,24,6,18,
274,0,22,6,16,
275,0,25,7,18,
276,0,24,6,18,
277,0,24,7,17,
278,0,23,6,17,
279,0,22,6,16,
280,0,23,7,16,
281,0,25,7,18,
282,0,24,6,18,
283,0,23,6,17,
284,0,22,6,16,
285,0,23,7,16,
286,0,21,6,15,
287,0,24,7,17,
288,0,23,6,17,
289,0,22,6,16,
290,0,23,7,16,
291,0,22,6,16,
292,0,22,7,15,
293,0,23,6,17,
294,0,22,6,16,
295,0,23,7,16,
296,0,23,7,16,
297,0,23,7,16,
298,0,24,7,17,
299,0,23,6,17,
300,0,22,6,16,
301,0,22,7,15,
302,0,24,6,18,
303,0,23,6,17,
304,0,23,7,16,
305,0,26,8,18,
306,0,23,6,17,
307,0,25,8,17,
308,0,22,6,16,
309,0,24,6,18,
310,0,24,7,17,
311,0,27,7,20,
312,0,23,6,17,
313,0,24,6,18,
314,0,23,6,17,
315,0,23,7,16,
316,0,22,7,15,
317,0,25,9,16,
318,0,21,6,15,
319,0,23,7,16,
320,0,21,6,15,
321,0,22,7,15,
322,0,23,6,17,
323,0,22,6,16,
324,0,24,7,17,
325,0,22,6,16,
326,0,26,9,17,
327,0,25,8,17,
328,0,24,7,17,
329,0,24,7,17,
330,0,23,6,17,
331,0,22,7,15,
332,0,22,6,16,
333,0,26,7,19,
334,0,23,6,17,
335,0,25,7,18,
336,0,22,6,16,
337,0,25,7,18,
338,0,24,6,18,
339,0,24,7,17,
340,0,22,6,16,
341,0,21,6,15,
342,0,23,7,16,
343,0,21,6,15,
344,0,22,7,15,
345,0,23,6,17,
346,0,22,6,16,
347,0,23,7,16,
348,0,23,6,17,
349,0,22,6,16,
350,0,23,7,16,
351,0,23,7,16,
352,0,23,6,17,
353,0,22,6,16,
354,0,26,7,19,
355,0,25,6,19,
356,0,24,6,18,
357,0,24,7,17,
358,0,24,7,17,
359,0,23,7,16,
360,0,22,6,16,
361,0,23,7,16,
362,0,24,7,17,
363,0,22,6,16,
364,0,22,6,16,
365,0,23,7,16,
366,0,22,7,15,
367,0,23,6,17,
368,0,23,7,16,
369,0,24,7,17,
370,0,22,6,16,
371,0,25,7,18,
372,0,23,6,17,
373,0,26,8,18,
374,0,25,7,18,
375,0,23,6,17,
376,0,22,6,16,
377,0,22,7,15,
378,0,22,6,16,
379,0,22,6,16,
380,0,22,7,15,
381,0,25,6,19,
382,0,23,6,17,
383,0,26,7,19,
384,0,24,6,18,
385,0,23,6,17,
386,0,23,7,16,
387,0,21,6,15,
388,0,27,10,17,
389,0,28,9,19,
390,0,31,12,19,
391,0,30,12,18,
392,0,30,12,18,
393,0,29,11,18,
394,0,32,12,20,
395,0,30,11,19,
396,0,28,11,17,
397,0,28,12,16,
398,0,32,11,21,
399,0,29,11,18,
400,0,31,10,21,
401,0,30,10,20,
402,0,30,12,18,
403,0,29,11,18,
404,0,31,11,20,
405,0,29,12,17,
406,0,29,12,17,
407,0,30,11,19,
408,0,30,11,19,
409,0,29,12,17,
410,0,32,12,20,
411,0,31,12,19,
412,0,29,12,17,
413,0,31,13,18,
414,0,32,10,22,
415,0,31,12,19,
416,0,32,13,19,
417,0,30,10,20,
418,0,31,12,19,
419,0,31,12,19,
420,0,29,12,17,
421,0,30,11,19,
422,0,30,11,19,
423,0,31,11,20,
424,0,31,10,21,
425,0,30,11,19,
426,0,28,11,17,
427,0,32,11,21,
428,0,31,12,19,
429,0,29,11,18,
430,0,29,10,19,
431,0,31,11,20,
432,0,30,11,19,
433,0,30,13,17,
434,0,30,11,19,
435,0,30,11,19,
436,0,29,11,18,
437,0,32,13,19,
438,0,30,10,20,
439,0,30,12,18,
440,0,30,11,19,
441,0,31,11,20,
442,0,31,11,20,
443,0,31,11,20,
444,0,29,11,18,
445,0,30,12,18,
446,0,32,11,21,
447,0,30,9,21,
448,0,30,11,19,
449,0,31,12,19,
450,0,30,12,18,
451,0,30,13,17,
452,0,29,11,18,
453,0,30,13,17,
454,0,31,11,20,
455,0,29,11,18,
456,0,31,12,19,
457,0,28,11,17,
458,0,29,11,18,
459,0,29,12,17,
460,0,31,12,19,
461,0,30,12,18,
462,0,30,12,18,
463,0,32,13,19,
464,0,30,12,18,
465,0,30,12,18,
466,0,28,12,16,
467,0,29,13,16,
468,0,28,11,17,
469,0,28,12,16,
470,0,31,12,19,
471,0,29,10,19,
472,0,30,11,19,
473,0,29,12,17,
474,0,28,10,18,
475,0,30,11,19,
476,0,31,12,19,
477,0,29,12,17,
478,0,30,11,19,
479,0,29,12,17,
480,0,31,12,19,
481,0,31,12,19,
482,0,30,12,18,
483,0,29,12,17,
484,0,28,10,18,
485,0,32,12,20,
486,0,30,11,19,
487,0,30,12,18,
488,0,32,13,19,
489,0,30,11,19,
490,0,31,12,19,
491,0,29,11,18,
492,0,30,12,18,
493,0,32,11,21,
494,0,30,10,20,
495,0,30,12,18,
496,0,29,11,18,
497,0,31,11,20,
498,0,29,12,17,
499,0,28,12,16,
500,0,31,11,20,
501,0,31,11,20,
502,0,29,11,18,
503,0,30,11,19,
504,0,31,12,19,
505,0,29,11,18,
506,0,29,12,17,
507,0,31,12,19,
508,0,29,11,18,
509,0,32,13,19,
510,0,30,11,19,
511,0,26,8,18,
512,0,25,7,18,
513,0,25,7,18,
514,0,23,6,17,
515,0,23,7,16,
516,0,21,6,15,
517,0,23,7,16,
518,0,22,6,16,
519,0,21,6,15,
520,0,22,7,15,
521,0,23,6,17,
522,0,22,6,16,
523,0,24,7,17,
524,0,24,7,17,
525,0,23,6,17,
526,0,23,7,16,
527,0,24,6,18,
528,0,23,6,17,
529,0,22,6,16,
530,0,25,7,18,
531,0,23,6,17,
532,0,26,8,18,
533,0,23,6,17,
534,0,25,7,18,
535,0,24,6,18,
536,0,23,6,17,
537,0,24,7,17,
538,0,22,6,16,
539,0,21,6,15,
540,0,24,8,16,
541,0,22,6,16,
542,0,22,6,16,
543,0,24,7,17,
544,0,23,6,17,
545,0,23,7,16,
546,0,23,6,17,
547,0,23,6,17,
548,0,23,6,17,
549,0,25,7,18,
550,0,23,6,17,
551,0,23,7,16,
552,0,22,6,16,
553,0,24,6,18,
554,0,24,7,17,
555,0,23,8,15,
556,0,24,7,17,
557,0,22,6,16,
558,0,21,6,15,
559,0,25,8,17,
560,0,25,7,18,
561,0,24,6,18,
562,0,25,8,17,
563,0,22,6,16,
564,0,21,6,15,
565,0,26,7,19,
566,0,23,6,17,
567,0,25,7,18,
568,0,22,6,16,
569,0,24,7,17,
570,0,25,8,17,
571,0,24,6,18,
572,0,23,6,17,
573,0,24,8,16,
574,0,22,6,16,
575,0,23,7,16,
576,0,23,7,16,
577,0,25,7,18,
578,0,21,6,15,
579,0,26,8,18,
580,0,24,6,18,
581,0,23,6,17,
582,0,24,7,17,
583,0,23,6,17,
584,0,22,6,16,
585,0,23,7,16,
586,0,25,7,18,
587,0,23,6,17,
588,0,25,7,18,
589,0,23,6,17,
590,0,21,6,15,
591,0,23,7,16,
592,0,23,7,16,
593,0,24,6,18,
594,0,25,7,18,
595,0,22,6,16,
596,0,25,7,18,
597,0,23,6,17,
598,0,21,6,15,
599,0,24,7,17,
600,0,23,6,17,
601,0,23,7,16,
602,0,23,6,17,
603,0,23,7,16,
604,0,22,7,15,
605,0,23,7,16,
606,0,21,6,15,
607,0,24,7,17,
608,0,25,8,17,
609,0,23,7,16,
610,0,24,6,18,
611,0,23,6,17,
612,0,22,6,16,
613,0,25,7,18,
614,0,24,6,18,
615,0,22,6,16,
616,0,25,7,18,
617,0,23,6,17,
618,0,22,7,15,
619,0,24,7,17,
620,0,23,7,16,
621,0,26,9,17,
622,0,23,6,17,
623,0,24,7,17,
624,0,22,6,16,
625,0,24,7,17,
626,0,22,6,16,
627,0,26,8,18,
628,0,23,6,17,
629,0,23,7,16,
630,0,22,6,16,
631,0,22,7,15,
632,0,23,7,16,
633,0,22,6,16,
634,0,23,7,16,
635,0,21,6,15,
636,0,24,7,17,
637,0,22,6,16,
638,0,25,7,18,
639,0,23,6,17,
640,0,22,6,16,
641,0,25,7,18,
642,0,23,6,17,
643,0,23,7,16,
644,0,24,6,18,
645,0,23,6,17,
646,0,23,7,16,
647,0,22,6,16,
648,0,25,8,17,
649,0,22,6,16,
650,0,22,6,16,
651,0,22,7,15,
652,0,24,8,16,
653,0,25,8,17,
654,0,23,6,17,
655,0,24,7,17,
656,0,23,6,17,
657,0,23,7,16,
658,0,24,6,18,
659,0,23,6,17,
660,0,22,6,16,
661,0,25,7,18,
662,0,27,8,19,
663,0,22,6,16,
664,0,24,7,17,
665,0,22,7,15,
666,0,23,6,17,
667,0,23,7,16,
668,0,24,7,17,
669,0,23,7,16,
670,0,24,7,17,
671,0,23,6,17,
672,0,24,7,17,
673,0,23,6,17,
674,0,22,6,16,
675,0,22,7,15,
676,0,22,6,16,
677,0,26,7,19,
678,0,24,6,18,
679,0,22,6,16,
680,0,23,7,16,
681,0,24,6,18,
682,0,22,6,16,
683,0,25,7,18,
684,0,24,7,17,
685,0,22,6,16,
686,0,21,6,15,
687,0,22,7,15,
688,0,22,6,16,
689,0,21,6,15,
690,0,26,7,19,
691,0,23,6,17,
692,0,26,7,19,
693,0,25,7,18,
694,0,25,7,18,
695,0,22,6,16,
696,0,22,6,16,
697,0,22,7,15,
698,0,23,6,17,
699,0,22,6,16,
700,0,23,7,16,
701,0,23,6,17,
702,0,22,6,16,
703,0,25,7,18,
704,0,24,6,18,
705,0,23,6,17,
706,0,23,7,16,
707,0,23,6,17,
708,0,21,6,15,
709,0,24,7,17,
710,0,24,6,18,
711,0,24,7,17,
712,0,24,6,18,
713,0,24,6,18,
714,0,23,6,17,
715,0,23,7,16,
716,0,22,6,16,
717,0,22,6,16,
718,0,25,7,18,
719,0,23,6,17,
720,0,23,7,16,
721,0,23,6,17,
722,0,24,7,17,
723,0,24,7,17,
724,0,25,6,19,
725,0,25,7,18,
726,0,25,7,18,
727,0,22,6,16,
728,0,25,7,18,
729,0,26,7,19,
730,0,24,6,18,
731,0,23,6,17,
732,0,23,7,16,
733,0,22,6,16,
734,0,22,7,15,
735,0,22,6,16,
736,0,21,6,15,
737,0,24,7,17,
738,0,24,7,17,
739,0,24,7,17,
740,0,22,6,16,
741,0,24,7,17,
742,0,25,7,18,
743,0,24,6,18,
744,0,24,7,17,
745,0,24,8,16,
746,0,28,12,16,
747,0,31,12,19,
748,0,30,11,19,
749,0,30,10,20,
750,0,29,11,18,
751,0,27,10,17,
752,0,32,12,20,
753,0,31,12,19,
754,0,30,13,17,
755,0,32,11,21,
756,0,30,11,19,
757,0,30,11,19,
758,0,30,10,20,
759,0,29,12,17,
760,0,30,11,19,
761,0,29,11,18,
762,0,33,11,22,
763,0,31,10,21,
764,0,30,10,20,
765,0,30,12,18,
766,0,28,11,17,
767,0,33,12,21,
768,0,32,11,21,
769,0,31,11,20,
770,0,31,12,19,
771,0,30,12,18,
772,0,30,11,19,
773,0,31,12,19,
774,0,28,11,17,
775,0,27,10,17,
776,0,29,11,18,
777,0,29,11,18,
778,0,31,13,18,
779,0,30,11,19,
780,0,31,12,19,
781,0,33,14,19,
782,0,26,10,16,
783,0,23,6,17,
784,0,25,7,18,
785,0,24,7,17,
786,0,23,7,16,
787,0,24,7,17,
788,0,23,7,16,
789,0,25,6,19,
790,0,24,6,18,
791,0,24,7,17,
792,0,24,6,18,
793,0,24,6,18,
794,0,23,7,16,
795,0,24,6,18,
796,0,23,6,17,
797,0,23,7,16,
798,0,23,6,17,
799,0,23,6,17,
800,0,23,7,16,
801,0,23,6,17,
802,0,25,7,18,
803,0,22,6,16,
804,0,21,6,15,
805,0,24,7,17,
806,0,22,6,16,
807,0,25,8,17,
808,0,23,7,16,
809,0,24,6,18,
810,0,23,6,17,
811,0,22,6,16,
812,0,23,7,16,
813,0,24,7,17,
814,0,24,7,17,
815,0,22,6,16,
816,0,23,7,16,
817,0,24,6,18,
818,0,24,6,18,
819,0,24,7,17,
820,0,24,6,18,
821,0,23,6,17,
822,0,26,7,19,
823,0,24,7,17,
824,0,24,6,18,
825,0,23,6,17,
826,0,25,7,18,
827,0,24,6,18,
828,0,23,7,16,
829,0,23,6,17,
830,0,23,6,17,
831,0,23,7,16,
832,0,23,6,17,
833,0,22,6,16,
834,0,25,7,18,
835,0,23,6,17,
836,0,24,7,17,
837,0,22,6,16,
838,0,21,6,15,
839,0,24,7,17,
840,0,22,6,16,
841,0,21,6,15,
842,0,24,8,16,
843,0,29,11,18,
844,0,29,12,17,
845,0,30,12,18,
846,0,31,12,19,
847,0,30,11,19,
848,0,30,12,18,
849,0,30,12,18,
850,0,30,12,18,
851,0,29,11,18,
852,0,30,11,19,
853,0,31,12,19,
854,0,29,11,18,
855,0,30,12,18,
856,0,30,11,19,
857,0,30,12,18,
858,0,30,10,20,
859,0,29,10,19,
860,0,31,12,19,
861,0,29,12,17,
862,0,29,10,19,
863,0,31,12,19,
864,0,28,10,18,
865,0,32,12,20,
866,0,30,11,19,
867,0,30,11,19,
868,0,30,11,19,
869,0,30,10,20,
870,0,24,6,18,
871,0,22,6,16,
872,0,25,7,18,
873,0,25,7,18,
874,0,24,6,18,
875,0,25,7,18,
876,0,25,8,17,
877,0,24,7,17,
878,0,22,6,16,
879,0,25,7,18,
880,0,22,6,16,
881,0,21,6,15,
882,0,24,7,17,
883,0,22,6,16,
884,0,22,7,15,
885,0,23,6,17,
886,0,22,6,16,
887,0,24,7,17,
888,0,27,10,17,
889,0,25,8,17,
890,0,25,9,16,
891,0,29,11,18,
892,0,30,12,18,
893,0,26,9,17,
894,0,24,6,18,
895,0,25,8,17,
896,0,29,10,19,
897,0,25,8,17,
898,0,24,7,17,
899,0,24,7,17,
900,0,23,7,16,
901,0,29,13,16,
902,0,27,9,18,
903,0,29,12,17,
904,0,27,11,16,
905,0,24,8,16,
906,0,27,11,16,
907,0,29,11,18,
908,0,30,13,17,
909,0,28,11,17,
910,0,23,7,16,
911,0,30,12,17,1
912,0,25,7,18,
913,0,22,6,16,
914,0,25,7,18,
915,0,23,6,17,
916,0,22,6,16,
917,0,24,7,17,
918,0,23,6,17,
919,0,24,7,16,1
920,0,23,7,16,
921,0,24,7,17,
922,0,23,7,16,
923,0,24,6,18,
924,0,24,6,18,
925,0,24,6,18,
926,0,24,7,16,1
927,0,22,6,16,
928,0,23,7,16,
929,0,23,6,17,
930,0,22,6,16,
931,0,24,7,17,
932,0,26,8,18,
933,0,27,9,18,
934,0,25,8,17,
935,0,23,7,16,
936,0,22,6,16,
937,0,23,8,15,
938,0,22,6,16,
939,0,21,6,15,
940,0,24,7,17,
941,0,26,7,18,1
942,0,23,6,17,
943,0,23,7,16,
944,0,24,7,17,
945,0,22,6,16,
946,0,23,6,17,
947,0,25,7,18,
948,0,22,6,16,
949,0,24,7,17,
950,0,23,6,17,
951,0,24,6,18,
952,0,25,7,18,
953,0,24,7,17,
954,0,23,6,17,
955,0,22,6,16,
956,0,26,8,18,
957,0,26,8,17,1
958,0,24,6,18,
959,0,23,6,17,
960,0,23,7,16,
961,0,24,6,18,
962,0,23,6,17,
963,0,23,7,16,
964,0,23,7,16,
965,0,23,8,15,
966,0,22,6,16,
967,0,24,7,17,
968,0,25,7,18,
969,0,21,6,15,
970,0,24,7,17,
971,0,26,7,19,
972,0,23,6,17,
973,0,23,7,16,
974,0,23,6,17,
975,0,24,7,17,
976,0,23,6,17,
977,0,22,6,16,
978,0,25,7,18,
979,0,22,6,16,
980,0,22,7,15,
981,0,24,6,18,
982,0,23,6,17,
983,0,25,7,18,
984,0,23,6,17,
985,0,25,7,18,
986,0,23,6,17,
987,0,23,7,15,1
988,0,26,7,19,
989,0,23,6,17,
990,0,25,7,18,
991,0,24,6,18,
992,0,23,7,16,
993,0,22,6,16,
994,0,25,8,17,
995,0,22,7,15,
996,0,24,6,18,
997,0,24,7,17,
998,0,25,7,18,
999,0,24,6,18,
1000,0,24,7,17,
1001,0,25,7,18,
1002,0,24,6,18,
1003,0,22,6,16,
1004,0,24,7,17,
1005,0,23,6,17,
1006,0,26,7,19,
1007,0,24,6,18,
1008,0,23,7,16,
1009,0,24,6,18,
1010,0,23,6,17,
1011,0,22,6,16,
1012,0,24,7,17,
1013,0,24,6,18,
1014,0,22,6,16,
1015,0,24,7,17,
1016,0,23,6,17,
1017,0,25,7,17,1
1018,0,25,7,18,
1019,0,24,6,18,
1020,0,24,6,18,
1021,0,24,7,17,
1022,0,24,6,18,
1023,0,22,6,16,
1024,0,23,7,16,
1025,0,23,7,16,
1026,0,25,7,18,
1027,0,23,6,17,
1028,0,25,7,18,
1029,0,24,6,18,
1030,0,24,7,17,
1031,0,22,6,16,
1032,0,23,7,16,
1033,0,22,7,15,
1034,0,23,7,16,
1035,0,21,6,15,
1036,0,24,7,17,
1037,0,23,6,17,
1038,0,22,6,16,
1039,0,24,7,17,
1040,0,23,6,17,
1041,0,23,7,16,
1042,0,23,6,17,
1043,0,22,6,16,
1044,0,25,7,18,
1045,0,23,6,17,
1046,0,25,8,17,
1047,0,22,6,16,
1048,0,24,7,16,1
1049,0,21,6,15,
1050,0,23,7,16,
1051,0,21,6,15,
1052,0,22,7,15,
1053,0,23,6,17,
1054,0,24,7,17,
1055,0,28,9,19,
1056,0,26,6,20,
1057,0,26,7,19,
1058,0,27,7,20,
1059,0,28,7,21,
1060,0,28,6,22,
1061,0,35,8,27,
1062,0,31,6,25,
1063,0,34,7,27,
1064,0,34,6,28,
1065,0,34,6,28,
1066,0,36,7,29,
1067,0,35,6,29,
1068,0,37,7,30,
1069,0,37,6,31,
1070,0,38,7,31,
1071,0,39,7,32,
1072,0,40,7,33,
1073,0,42,7,35,
1074,0,40,6,34,
1075,0,39,6,33,
1076,0,42,7,35,
1077,0,41,6,35,
1078,0,44,7,36,1
1079,0,42,7,35,
1080,0,43,6,37,
1081,0,42,6,36,
1082,0,46,7,39,
1083,0,44,6,38,
1084,0,43,6,37,
1085,0,45,7,38,
1086,0,46,7,39,
1087,0,46,6,40,
1088,0,47,7,40,
1089,0,46,7,39,
1090,0,46,6,40,
1091,0,49,7,42,
1092,0,48,6,42,
1093,0,49,7,42,
1094,0,47,6,41,
1095,0,50,7,43,
1096,0,48,6,42,
1097,0,49,7,42,
1098,0,50,6,44,
1099,0,49,6,43,
1100,0,53,7,46,
1101,0,51,6,45,
1102,0,51,7,44,
1103,0,52,6,46,
1104,0,51,6,45,
1105,0,52,7,45,
1106,0,52,7,45,
1107,0,53,6,47,
1108,0,56,8,47,1
1109,0,53,6,47,
1110,0,56,7,49,
1111,0,54,7,47,
1112,0,54,6,48,
1113,0,54,6,48,
1114,0,56,7,49,
1115,0,56,7,49,
1116,0,57,7,50,
1117,0,58,8,50,
1118,0,57,8,49,
1119,0,56,7,49,
1120,0,57,6,51,
1121,0,57,7,50,
1122,0,58,7,51,
1123,0,60,8,52,
1124,0,57,6,51,
1125,0,58,7,51,
1126,0,58,6,52,
1127,0,58,6,52,
1128,0,61,7,54,
1129,0,59,6,53,
1130,0,59,7,52,
1131,0,60,6,54,
1132,0,59,6,53,
1133,0,61,7,54,
1134,0,61,6,55,
1135,0,60,6,54,
1136,0,62,7,55,
1137,0,60,6,54,
1138,0,64,7,57,
1139,0,63,6,56,1
1140,0,62,7,55,
1141,0,62,6,56,
1142,0,62,6,56,
1143,0,65,7,58,
1144,0,63,6,57,
1145,0,64,7,57,
1146,0,65,7,58,
1147,0,64,7,57,
1148,0,64,6,58,
1149,0,65,8,57,
1150,0,65,6,59,
1151,0,64,6,58,
1152,0,67,7,60,
1153,0,65,6,59,
1154,0,65,7,58,
1155,0,66,6,60,
1156,0,68,7,61,
1157,0,65,6,59,
1158,0,68,7,61,
1159,0,67,6,61,
1160,0,66,6,60,
1161,0,68,7,61,
1162,0,67,6,61,
1163,0,67,7,60,
1164,0,68,6,62,
1165,0,68,7,61,
1166,0,69,7,62,
1167,0,67,6,61,
1168,0,71,7,64,
1169,0,70,6,63,1
1170,0,68,6,62,
1171,0,70,7,63,
1172,0,69,6,63,
1173,0,70,7,63,
1174,0,70,6,64,
1175,0,69,6,63,
1176,0,70,7,63,
1177,0,72,7,65,
1178,0,71,6,65,
1179,0,70,6,64,
1180,0,77,12,65,
1181,0,77,10,67,
1182,0,79,11,68,
1183,0,78,12,66,
1184,0,78,12,66,
1185,0,79,12,67,
1186,0,80,11,69,
1187,0,79,12,67,
1188,0,79,12,67,
1189,0,80,13,67,
1190,0,81,12,69,
1191,0,80,11,69,
1192,0,81,12,69,
1193,0,80,11,69,
1194,0,81,12,69,
1195,0,81,12,69,
1196,0,81,12,69,
1197,0,81,12,69,
1198,0,82,13,69,
1199,0,83,12,70,1
1200,0,81,12,69,
1201,0,83,11,72,
1202,0,83,12,71,
1203,0,83,12,71,
1204,0,83,13,70,
1205,0,84,12,72,
1206,0,83,10,73,
1207,0,84,12,72,
1208,0,84,13,71,
1209,0,83,11,72,
1210,0,84,11,73,
1211,0,85,12,73,
1212,0,86,11,75,
1213,0,84,11,73,
1214,0,85,12,73,
1215,0,85,11,74,
1216,0,86,12,74,
1217,0,86,13,73,
1218,0,84,10,74,
1219,0,86,12,74,
1220,0,87,12,75,
1221,0,86,11,75,
1222,0,87,11,76,
1223,0,87,13,74,
1224,0,86,11,75,
1225,0,86,12,74,
1226,0,88,13,75,
1227,0,88,12,76,
1228,0,88,11,77,
1229,0,87,12,75,
1230,0,88,12,75,1
1231,0,89,13,76,
1232,0,90,12,78,
1233,0,88,12,76,
1234,0,89,11,78,
1235,0,88,11,77,
1236,0,89,12,77,
1237,0,89,12,77,
1238,0,87,10,77,
1239,0,89,12,77,
1240,0,91,12,79,
1241,0,85,11,74,
1242,0,69,9,60,
1243,0,56,7,49,
1244,0,55,7,48,
1245,0,51,6,45,
1246,0,45,6,39,
1247,0,41,6,35,
1248,0,40,7,33,
1249,0,40,6,34,
1250,0,48,7,41,
1251,0,53,6,47,
1252,0,54,6,48,
1253,0,56,7,49,
1254,0,55,6,49,
1255,0,56,7,49,
1256,0,56,6,50,
1257,0,56,6,50,
1258,0,58,7,51,
1259,0,59,7,52,
1260,0,59,6,52,1
1261,0,57,6,51,
1262,0,59,7,52,
1263,0,58,6,52,
1264,0,61,7,54,
1265,0,59,6,53,
1266,0,60,7,53,
1267,0,63,9,54,
1268,0,67,11,56,
1269,0,67,12,55,
1270,0,68,11,57,
1271,0,68,13,55,
1272,0,69,12,57,
1273,0,68,11,57,
1274,0,69,11,58,
1275,0,70,11,59,
1276,0,70,10,60,
1277,0,69,11,58,
1278,0,71,12,59,
1279,0,71,13,58,
1280,0,71,11,60,
1281,0,70,11,59,
1282,0,71,12,59,
1283,0,72,12,60,
1284,0,72,12,60,
1285,0,72,11,61,
1286,0,72,11,61,
1287,0,74,12,62,
1288,0,74,13,61,
1289,0,74,12,62,
1290,0,75,13,61,1
1291,0,73,11,62,
1292,0,74,11,63,
1293,0,75,13,62,
1294,0,74,11,63,
1295,0,74,12,62,
1296,0,76,13,63,
1297,0,74,11,63,
1298,0,71,7,64,
1299,0,69,6,63,
1300,0,74,9,65,
1301,0,71,7,64,
1302,0,69,6,63,
1303,0,72,8,64,
1304,0,72,7,65,
1305,0,71,7,64,
1306,0,71,6,65,
1307,0,73,7,66,
1308,0,72,6,66,
1309,0,72,7,65,
1310,0,73,8,65,
1311,0,73,7,66,
1312,0,73,6,67,
1313,0,73,7,66,
1314,0,73,6,67,
1315,0,72,6,66,
1316,0,76,7,69,
1317,0,74,6,68,
1318,0,75,7,68,
1319,0,76,8,68,
1320,0,73,6,67,
1321,0,77,7,69,1
1322,0,75,7,68,
1323,0,75,6,69,
1324,0,74,6,68,
1325,0,78,7,71,
1326,0,76,6,70,
1327,0,75,6,69,
1328,0,77,7,70,
1329,0,77,7,70,
1330,0,77,6,71,
1331,0,80,8,72,
1332,0,76,6,70,
1333,0,78,7,71,
1334,0,78,6,72,
1335,0,79,8,71,
1336,0,78,7,71,
1337,0,78,6,72,
1338,0,77,6,71,
1339,0,80,7,73,
1340,0,78,6,72,
1341,0,81,7,74,
1342,0,79,6,73,
1343,0,78,6,72,
1344,0,82,7,75,
1345,0,80,6,74,
1346,0,80,7,73,
1347,0,80,6,74,
1348,0,79,6,73,
1349,0,82,7,75,
1350,0,81,6,75,
1351,0,83,7,75,1
1352,0,80,6,74,
1353,0,83,7,76,
1354,0,82,6,76,
1355,0,82,7,75,
1356,0,82,6,76,
1357,0,81,6,75,
1358,0,82,7,75,
1359,0,84,7,77,
1360,0,82,6,76,
1361,0,82,7,75,
1362,0,84,7,77,
1363,0,82,6,76,
1364,0,78,7,71,
1365,0,65,6,59,
1366,0,55,8,47,
1367,0,52,6,46,
1368,0,49,7,42,
1369,0,40,6,34,
1370,0,31,6,25,
1371,0,25,6,19,
1372,0,23,7,16,
1373,0,31,6,25,
1374,0,38,6,32,
1375,0,41,7,34,
1376,0,40,6,34,
1377,0,41,7,34,
1378,0,42,6,36,
1379,0,43,7,36,
1380,0,44,7,37,
1381,0,46,8,37,1
1382,0,44,7,37,
1383,0,44,6,38,
1384,0,44,6,38,
1385,0,46,7,39,
1386,0,45,6,39,
1387,0,46,7,39,
1388,0,46,7,39,
1389,0,48,7,41,
1390,0,47,6,41,
1391,0,50,8,42,
1392,0,48,7,41,
1393,0,49,6,43,
1394,0,50,7,43,
1395,0,48,6,42,
1396,0,52,7,45,
1397,0,50,6,44,
1398,0,52,7,45,
1399,0,51,7,44,
1400,0,51,6,45,
1401,0,51,6,45,
1402,0,53,7,46,
1403,0,54,7,47,
1404,0,53,7,46,
1405,0,53,6,47,
1406,0,54,6,48,
1407,0,54,7,47,
1408,0,54,6,48,
1409,0,54,6,48,
1410,0,57,8,49,
1411,0,54,6,48,
1412,0,60,8,51,1
1413,0,56,6,50,
1414,0,55,6,49,
1415,0,58,7,51,
1416,0,57,6,51,
1417,0,57,7,50,
1418,0,58,6,52,
1419,0,59,7,52,
1420,0,58,7,51,
1421,0,59,7,52,
1422,0,62,8,54,
1423,0,59,6,53,
1424,0,59,6,53,
1425,0,60,7,53,
1426,0,60,7,53,
1427,0,61,6,55,
1428,0,61,7,54,
1429,0,62,7,55,
1430,0,60,6,54,
1431,0,64,7,57,
1432,0,62,6,56,
1433,0,61,6,55,
1434,0,65,8,57,
1435,0,63,6,57,
1436,0,63,7,56,
1437,0,63,6,57,
1438,0,63,6,57,
1439,0,65,7,58,
1440,0,64,6,58,
1441,0,65,7,58,
1442,0,67,7,59,1
1443,0,64,6,58,
1444,0,66,7,59,
1445,0,66,6,60,
1446,0,66,7,59,
1447,0,66,6,60,
1448,0,65,6,59,
1449,0,69,7,62,
1450,0,67,6,61,
1451,0,68,7,61,
1452,0,66,6,60,
1453,0,69,7,62,
1454,0,68,6,62,
1455,0,68,7,61,
1456,0,70,7,63,
1457,0,70,7,63,
1458,0,69,6,63,
1459,0,68,6,62,
1460,0,71,7,64,
1461,0,69,6,63,
1462,0,70,7,63,
1463,0,70,6,64,
1464,0,70,7,63,
1465,0,72,7,65,
1466,0,70,6,64,
1467,0,73,7,66,
1468,0,71,6,65,
1469,0,71,6,65,
1470,0,74,7,67,
1471,0,72,6,66,
1472,0,73,7,65,1
1473,0,74,7,67,
1474,0,74,7,67,
1475,0,72,6,66,
1476,0,75,7,68,
1477,0,74,6,68,
1478,0,73,6,67,
1479,0,75,8,67,
1480,0,74,6,68,
1481,0,74,7,67,
1482,0,75,7,68,
1483,0,76,7,69,
1484,0,74,6,68,
1485,0,76,7,69,
1486,0,77,7,70,
1487,0,75,6,69,
1488,0,76,7,69,
1489,0,78,7,71,
1490,0,76,7,69,
1491,0,78,6,72,
1492,0,76,6,70,
1493,0,78,7,71,
1494,0,77,6,71,
1495,0,79,7,72,
1496,0,79,7,72,
1497,0,77,6,71,
1498,0,78,7,71,
1499,0,78,6,72,
1500,0,79,7,72,
1501,0,80,7,73,
1502,0,78,6,72,
1503,0,82,7,74,1
1504,0,79,6,73,
1505,0,79,6,73,
1506,0,82,7,75,
1507,0,80,6,74,
1508,0,80,7,73,
1509,0,82,8,74,
1510,0,80,6,74,
1511,0,82,7,75,
1512,0,82,7,75,
1513,0,81,6,75,
1514,0,80,6,74,
1515,0,82,7,75,
1516,0,82,6,76,
1517,0,81,6,75,
1518,0,83,7,76,
1519,0,81,6,75,
1520,0,84,7,77,
1521,0,82,6,76,
1522,0,81,6,75,
1523,0,84,7,77,
1524,0,82,6,76,
1525,0,78,7,71,
1526,0,66,7,59,
1527,0,53,6,47,
1528,0,53,7,46,
1529,0,49,6,43,
1530,0,40,6,34,
1531,0,32,7,25,
1532,0,27,7,20,
1533,0,24,6,17,1
1534,0,31,7,24,
1535,0,39,6,33,
1536,0,40,7,33,
1537,0,41,7,34,
1538,0,40,6,34,
1539,0,41,7,34,
1540,0,42,7,35,
1541,0,43,6,37,
1542,0,42,6,36,
1543,0,45,8,37,
1544,0,44,6,38,
1545,0,44,6,38,
1546,0,46,7,39,
1547,0,47,7,40,
1548,0,46,6,40,
1549,0,46,7,39,
1550,0,47,6,41,
1551,0,47,6,41,
1552,0,50,9,41,
1553,0,48,6,42,
1554,0,48,6,42,
1555,0,50,7,43,
1556,0,49,6,43,
1557,0,50,7,43,
1558,0,50,7,43,
1559,0,52,7,45,
1560,0,51,6,45,
1561,0,51,7,44,
1562,0,52,7,45,
1563,0,53,7,46,
1564,0,54,7,46,1
1565,0,53,6,47,
1566,0,52,6,46,
1567,0,55,7,48,
1568,0,55,7,48,
1569,0,53,6,47,
1570,0,57,8,49,
1571,0,54,6,48,
1572,0,56,7,49,
1573,0,57,7,50,
1574,0,57,8,49,
1575,0,55,6,49,
1576,0,59,7,52,
1577,0,57,7,50,
1578,0,58,7,51,
1579,0,59,7,52,
1580,0,58,6,52,
1581,0,58,7,51,
1582,0,59,6,53,
1583,0,58,6,52,
1584,0,60,7,53,
1585,0,60,6,54,
1586,0,59,6,53,
1587,0,61,7,54,
1588,0,60,6,54,
1589,0,61,7,54,
1590,0,61,6,55,
1591,0,60,6,54,
1592,0,63,7,56,
1593,0,61,6,55,
1594,0,65,7,57,1
1595,0,63,6,57,
1596,0,62,6,56,
1597,0,65,7,58,
1598,0,63,6,57,
1599,0,64,7,57,
1600,0,65,7,58,
1601,0,65,7,58,
1602,0,64,6,58,
1603,0,66,7,59,
1604,0,64,6,58,
1605,0,66,7,59,
1606,0,66,6,60,
1607,0,66,7,59,
1608,0,66,7,59,
1609,0,67,7,60,
1610,0,66,6,60,
1611,0,69,7,62,
1612,0,67,6,61,
1613,0,66,6,60,
1614,0,69,7,62,
1615,0,69,7,62,
1616,0,67,6,61,
1617,0,70,7,63,
1618,0,69,6,63,
1619,0,68,6,62,
1620,0,70,7,63,
1621,0,68,6,62,
1622,0,72,7,65,
1623,0,70,6,64,
1624,0,73,8,64,1
1625,0,70,6,64,
1626,0,71,7,64,
1627,0,71,6,65,
1628,0,70,6,64,
1629,0,72,7,65,
1630,0,72,6,66,
1631,0,72,7,65,
1632,0,72,6,66,
1633,0,72,6,66,
1634,0,73,7,66,
1635,0,73,6,67,
1636,0,72,6,66,
1637,0,74,7,67,
1638,0,73,6,67,
1639,0,75,8,67,
1640,0,74,6,68,
1641,0,73,6,67,
1642,0,76,7,69,
1643,0,75,6,69,
1644,0,74,6,68,
1645,0,78,8,70,
1646,0,74,6,68,
1647,0,78,7,71,
1648,0,76,6,70,
1649,0,76,7,69,
1650,0,77,7,70,
1651,0,76,6,70,
1652,0,77,7,70,
1653,0,80,9,71,
1654,0,77,7,70,
1655,0,79,7,71,1
1656,0,78,6,72,
1657,0,78,7,71,
1658,0,78,6,72,
1659,0,77,6,71,
1660,0,80,7,73,
1661,0,80,7,73,
1662,0,79,7,72,
1663,0,82,10,72,
1664,0,86,12,74,
1665,0,86,12,74,
1666,0,86,12,74,
1667,0,87,11,76,
1668,0,88,11,77,
1669,0,86,10,76,
1670,0,88,11,77,
1671,0,87,10,77,
1672,0,88,13,75,
1673,0,87,12,75,
1674,0,90,12,78,
1675,0,89,11,78,
1676,0,86,10,76,
1677,0,82,7,75,
1678,0,83,7,76,
1679,0,81,6,75,
1680,0,83,7,76,
1681,0,82,6,76,
1682,0,82,7,75,
1683,0,82,6,76,
1684,0,83,7,76,
1685,0,73,7,65,1
1686,0,59,6,53,
1687,0,52,6,46,
1688,0,52,7,45,
1689,0,45,6,39,
1690,0,39,6,33,
1691,0,38,7,31,
1692,0,40,7,33,
1693,0,44,6,38,
1694,0,52,6,46,
1695,0,57,7,50,
1696,0,57,9,48,
1697,0,56,6,50,
1698,0,56,7,49,
1699,0,56,7,49,
1700,0,58,7,51,
1701,0,56,6,50,
1702,0,58,7,51,
1703,0,58,6,52,
1704,0,57,6,51,
1705,0,59,7,52,
1706,0,59,6,53,
1707,0,59,7,52,
1708,0,59,6,53,
1709,0,58,6,52,
1710,0,61,7,54,
1711,0,60,6,54,
1712,0,60,7,53,
1713,0,61,6,55,
1714,0,63,7,56,
1715,0,63,7,55,1
1716,0,63,7,56,
1717,0,61,6,55,
1718,0,63,7,56,
1719,0,62,6,56,
1720,0,63,7,56,
1721,0,63,6,57,
1722,0,63,7,56,
1723,0,64,6,58,
1724,0,65,7,58,
1725,0,63,6,57,
1726,0,65,7,58,
1727,0,64,6,58,
1728,0,65,7,58,
1729,0,65,6,59,
1730,0,65,6,59,
1731,0,67,7,60,
1732,0,66,6,60,
1733,0,65,6,59,
1734,0,68,7,61,
1735,0,66,6,60,
1736,0,67,7,60,
1737,0,67,6,61,
1738,0,69,7,62,
1739,0,67,6,61,
1740,0,69,7,62,
1741,0,68,6,62,
1742,0,68,6,62,
1743,0,70,7,63,
1744,0,72,8,64,
1745,0,69,6,63,
1746,0,71,7,63,1
1747,0,71,7,64,
1748,0,69,6,63,
1749,0,71,7,64,
1750,0,71,6,65,
1751,0,70,6,64,
1752,0,74,9,65,
1753,0,71,7,64,
1754,0,72,6,66,
1755,0,72,7,65,
1756,0,73,7,66,
1757,0,71,6,65,
1758,0,72,7,65,
1759,0,73,6,67,
1760,0,75,7,68,
1761,0,73,6,67,
1762,0,73,7,66,
1763,0,73,6,67,
1764,0,75,7,68,
1765,0,73,6,67,
1766,0,76,7,69,
1767,0,75,6,69,
1768,0,75,7,68,
1769,0,76,7,69,
1770,0,75,6,69,
1771,0,75,7,68,
1772,0,77,7,70,
1773,0,75,6,69,
1774,0,78,7,71,
1775,0,76,6,70,
1776,0,78,7,70,1
1777,0,77,6,71,
1778,0,76,6,70,
1779,0,79,7,72,
1780,0,77,6,71,
1781,0,77,6,71,
1782,0,78,7,71,
1783,0,78,7,71,
1784,0,78,7,71,
1785,0,78,7,71,
1786,0,80,7,73,
1787,0,78,6,72,
1788,0,81,7,74,
1789,0,79,6,73,
1790,0,79,6,73,
1791,0,82,7,75,
1792,0,81,7,74,
1793,0,80,7,73,
1794,0,81,7,74,
1795,0,80,6,74,
1796,0,82,7,75,
1797,0,81,6,75,
1798,0,80,6,74,
1799,0,82,7,75,
1800,0,82,7,75,
1801,0,82,6,76,
1802,0,81,6,75,
1803,0,83,7,76,
1804,0,81,6,75,
1805,0,83,7,76,
1806,0,84,7,76,1
1807,0,81,6,75,
1808,0,84,7,77,
1809,0,82,6,76,
1810,0,82,7,75,
1811,0,69,6,63,
1812,0,58,7,51,
1813,0,53,6,47,
1814,0,50,7,43,
1815,0,44,6,38,
1816,0,34,6,28,
1817,0,28,7,21,
1818,0,24,7,17,
1819,0,27,6,21,
1820,0,40,8,32,
1821,0,39,6,33,
1822,0,39,6,33,
1823,0,42,7,35,
1824,0,40,6,34,
1825,0,42,7,35,
1826,0,42,6,36,
1827,0,42,6,36,
1828,0,43,7,36,
1829,0,44,6,38,
1830,0,43,6,37,
1831,0,46,7,39,
1832,0,44,6,38,
1833,0,48,7,41,
1834,0,46,6,40,
1835,0,46,6,40,
1836,0,49,7,42,
1837,0,48,6,42,
1838,0,47,6,41,
1839,0,49,7,42,
1840,0,48,6,42,
1841,0,50,7,43,
1842,0,50,6,44,
1843,0,52,8,44,
1844,0,49,6,43,
1845,0,53,7,46,
1846,0,51,7,44,
1847,0,52,6,46,
1848,0,51,6,45,
1849,0,53,7,46,
1850,0,52,6,46,
1851,0,53,7,46,
1852,0,53,6,47,
1853,0,55,7,48,
1854,0,54,6,48,
1855,0,58,7,51,
1856,0,54,6,48,
1857,0,57,7,50,
1858,0,56,6,50,
1859,0,55,6,49,
1860,0,57,7,50,
1861,0,56,6,50,
1862,0,60,9,51,
1863,0,59,8,51,
1864,0,60,8,52,
1865,0,58,7,51,
1866,0,59,7,52,
1867,0,58,6,52,
1868,0,60,7,53,
1869,0,59,7,52,
1870,0,60,6,54,
1871,0,59,6,53,
1872,0,62,7,55,
1873,0,60,6,54,
1874,0,60,6,54,
1875,0,63,9,54,
1876,0,61,7,54,
1877,0,62,6,56,
1878,0,61,6,55,
1879,0,63,7,56,
1880,0,63,8,55,
1881,0,63,6,57,
1882,0,63,6,57,
1883,0,64,7,57,
1884,0,63,6,57,
1885,0,65,7,58,
1886,0,63,6,57,
1887,0,65,7,58,
1888,0,65,6,59,
1889,0,65,7,58,
1890,0,66,7,59,
1891,0,66,6,60,
1892,0,65,6,59,
1893,0,67,7,60,
1894,0,65,6,59,
1895,0,68,7,61,
1896,0,70,8,62,
1897,0,66,6,60,
1898,0,67,7,60,
1899,0,69,7,62,
1900,0,67,6,61,
1901,0,70,7,63,
1902,0,68,6,62,
1903,0,68,6,62,
1904,0,70,7,63,
1905,0,68,6,62,
1906,0,71,7,64,
1907,0,72,7,65,
1908,0,69,6,63,
1909,0,71,7,64,
1910,0,70,6,64,
1911,0,70,6,64,
1912,0,73,7,66,
1913,0,71,6,65,
1914,0,72,7,65,
1915,0,71,6,65,
1916,0,73,7,66,
1917,0,71,6,65,
1918,0,72,7,65,
1919,0,73,6,67,
1920,0,73,6,67,
1921,0,73,7,66,
1922,0,73,6,67,
1923,0,72,6,66,
1924,0,75,8,67,
1925,0,74,6,68,
1926,0,73,6,67,
1927,0,75,7,68,
1928,0,75,6,69,
1929,0,77,8,69,
1930,0,74,6,68,
1931,0,77,7,70,
1932,0,76,6,70,
1933,0,76,7,69,
1934,0,77,7,70,
1935,0,77,7,70,
1936,0,76,7,69,
1937,0,78,7,71,
1938,0,76,6,70,
1939,0,78,7,71,
1940,0,76,6,70,
1941,0,77,7,70,
1942,0,78,6,72,
1943,0,78,7,71,
1944,0,79,7,72,
1945,0,78,7,71,
1946,0,81,7,74,
1947,0,79,6,73,
1948,0,78,6,72,
1949,0,81,7,74,
1950,0,79,6,73,
1951,0,80,7,73,
1952,0,81,7,74,
1953,0,79,6,73,
1954,0,81,7,74,
1955,0,80,6,74,
1956,0,82,7,75,
1957,0,80,6,74,
1958,0,81,7,74,
1959,0,81,6,75,
1960,0,80,6,74,
1961,0,83,7,76,
1962,0,81,6,75,
1963,0,84,7,77,
1964,0,82,7,75,
1965,0,82,7,75,
1966,0,84,7,77,
1967,0,83,7,76,
1968,0,82,7,75,
1969,0,82,6,76,
1970,0,81,6,75,
1971,0,81,7,74,
1972,0,69,6,63,
1973,0,58,7,51,
1974,0,53,6,47,
1975,0,52,7,45,
1976,0,43,6,37,
1977,0,39,6,33,
1978,0,37,7,30,
1979,0,39,6,33,
1980,0,44,6,38,
1981,0,56,7,49,
1982,0,54,6,48,
1983,0,55,7,48,
1984,0,56,6,50,
1985,0,55,6,49,
1986,0,56,7,49,
1987,0,59,7,52,
1988,0,60,7,53,
1989,0,57,7,50,
1990,0,58,6,52,
1991,0,59,7,52,
1992,0,57,6,51,
1993,0,61,7,54,
1994,0,58,6,52,
1995,0,60,7,53,
1996,0,59,6,53,
1997,0,62,7,55,
1998,0,60,6,54,
1999,0,60,6,54,
2000,0,61,7,54,
2001,0,62,7,55,
2002,0,64,8,56,
2003,0,62,6,56,
2004,0,61,6,55,
2005,0,64,7,57,
2006,0,63,7,56,
2007,0,63,6,57,
2008,0,62,6,56,
2009,0,64,7,57,
2010,0,64,6,58,
2011,0,64,7,57,
2012,0,64,6,58,
2013,0,65,6,59,
2014,0,65,7,58,
2015,0,65,6,59,
2016,0,64,6,58,
2017,0,66,7,59,
2018,0,67,8,59,
2019,0,67,7,60,
2020,0,66,6,60,
2021,0,68,7,61,
2022,0,69,6,63,
2023,0,67,6,61,
2024,0,68,7,61,
2025,0,69,7,62,
2026,0,67,6,61,
2027,0,70,7,63,
2028,0,68,7,61,
2029,0,69,6,63,
2030,0,69,7,62,
2031,0,71,7,64,
2032,0,70,6,64,
2033,0,69,6,63,
2034,0,71,7,64,
2035,0,70,6,64,
2036,0,71,7,64,
2037,0,71,7,64,
2038,0,71,6,65,
2039,0,70,6,64,
2040,0,73,7,66,
2041,0,72,6,66,
2042,0,72,7,65,
2043,0,72,6,66,
2044,0,71,6,65,
2045,0,74,7,67,
2046,0,72,6,66,
2047,0,74,7,67,
2048,0,74,7,67,
2049,0,73,6,67,
2050,0,75,7,68,
2051,0,73,6,67,
2052,0,75,7,68,
2053,0,74,6,68,
2054,0,77,7,70,
2055,0,76,7,69,
2056,0,74,6,68,
2057,0,76,7,69,
2058,0,76,6,70,
2059,0,76,7,69,
2060,0,76,6,70,
2061,0,76,7,69,
2062,0,78,7,71,
2063,0,77,6,71,
2064,0,77,7,70,
2065,0,78,7,71,
2066,0,76,6,70,
2067,0,78,7,71,
2068,0,78,6,72,
2069,0,78,7,71,
2070,0,78,6,72,
2071,0,78,6,72,
2072,0,81,7,74,
2073,0,79,6,73,
2074,0,79,7,72,
2075,0,79,6,73,
2076,0,79,7,72,
2077,0,81,7,74,
2078,0,80,6,74,
2079,0,80,7,73,
2080,0,80,6,74,
2081,0,80,7,73,
2082,0,81,6,75,
2083,0,80,6,74,
2084,0,82,7,75,
2085,0,81,6,75,
2086,0,83,7,76,
2087,0,82,6,76,
2088,0,83,7,76,
2089,0,82,7,75,
2090,0,83,7,76,
2091,0,81,6,75,
2092,0,84,7,77,
2093,0,82,6,76,
2094,0,81,6,75,
2095,0,84,7,77,
2096,0,82,6,76,
2097,0,75,7,68,
2098,0,63,7,56,
2099,0,52,6,46,
2100,0,53,7,46,
2101,0,47,6,41,
2102,0,38,6,32,
2103,0,29,6,23,
2104,0,24,6,18,
2105,0,27,7,20,
2106,0,35,6,29,
2107,0,39,7,32,
2108,0,41,7,34,
2109,0,41,6,35,
2110,0,41,7,34,
2111,0,42,7,35,
2112,0,42,6,36,
2113,0,43,6,37,
2114,0,43,7,36,
2115,0,46,8,38,
2116,0,45,7,38,
2117,0,44,6,38,
2118,0,45,7,38,
2119,0,47,7,40,
2120,0,46,6,40,
2121,0,46,6,40,
2122,0,48,7,41,
2123,0,47,7,40,
2124,0,48,7,41,
2125,0,48,7,41,
2126,0,49,6,43,
2127,0,48,6,42,
2128,0,51,7,44,
2129,0,50,6,44,
2130,0,49,6,43,
2131,0,52,7,45,
2132,0,50,6,44,
2133,0,53,7,46,
2134,0,52,6,46,
2135,0,52,7,45,
2136,0,53,6,47,
2137,0,52,6,46,
2138,0,54,7,47,
2139,0,54,7,47,
2140,0,55,7,48,
2141,0,53,6,47,
2142,0,57,7,50,
2143,0,55,6,49,
2144,0,56,7,49,
2145,0,55,6,49,
2146,0,57,7,50,
2147,0,59,7,52,
2148,0,57,6,51,
2149,0,57,7,50,
2150,0,58,6,52,
2151,0,57,6,51,
2152,0,59,7,52,
2153,0,57,6,51,
2154,0,59,7,52,
2155,0,59,6,53,
2156,0,58,6,52,
2157,0,62,7,55,
2158,0,60,6,54,
2159,0,59,6,53,
2160,0,62,7,55,
2161,0,60,6,54,
2162,0,61,7,54,
2163,0,62,6,56,
2164,0,61,6,55,
2165,0,63,7,56,
2166,0,62,6,56,
2167,0,62,6,56,
2168,0,64,7,57,
2169,0,64,7,57,
2170,0,64,6,58,
2171,0,64,7,57,
2172,0,64,6,58,
2173,0,65,7,58,
2174,0,64,6,58,
2175,0,67,7,60,
2176,0,64,6,58,
2177,0,66,7,59,
2178,0,66,6,60,
2179,0,67,7,60,
2180,0,65,6,59,
2181,0,66,7,59,
2182,0,67,6,61,
2183,0,67,7,60,
2184,0,67,7,60,
2185,0,70,7,63,
2186,0,68,6,62,
2187,0,67,6,61,
2188,0,69,7,62,
2189,0,69,6,63,
2190,0,69,7,62,
2191,0,69,6,63,
2192,0,68,6,62,
2193,0,71,7,64,
2194,0,70,6,64,
2195,0,69,6,63,
2196,0,71,7,64,
2197,0,70,6,64,
2198,0,72,7,65,
2199,0,71,7,64,
2200,0,71,6,65,
2201,0,70,6,64,
2202,0,73,7,66,
2203,0,72,6,66,
2204,0,71,6,65,
2205,0,73,7,66,
2206,0,76,8,68,
2207,0,73,6,67,
2208,0,73,7,66,
2209,0,73,7,66,
2210,0,75,7,68,
2211,0,73,6,67,
2212,0,76,7,69,
2213,0,74,6,68,
2214,0,76,7,69,
2215,0,74,6,68,
2216,0,76,7,69,
2217,0,75,7,68,
2218,0,75,6,69,
2219,0,75,6,69,
2220,0,77,7,70,
2221,0,76,6,70,
2222,0,75,6,69,
2223,0,78,7,71,
2224,0,76,6,70,
2225,0,79,7,72,
2226,0,77,6,71,
2227,0,77,7,70,
2228,0,78,6,72,
2229,0,79,7,72,
2230,0,78,6,72,
2231,0,78,7,71,
2232,0,79,7,72,
2233,0,78,6,72,
2234,0,81,7,74,
2235,0,79,7,72,
2236,0,79,6,73,
2237,0,78,6,72,
2238,0,81,7,74,
2239,0,80,6,74,
2240,0,81,7,74,
2241,0,80,7,73,
2242,0,81,6,75,
2243,0,81,7,74,
2244,0,82,7,75,
2245,0,80,6,74,
2246,0,83,7,76,
2247,0,82,6,76,
2248,0,81,6,75,
2249,0,83,7,76,
2250,0,82,6,76,
2251,0,82,7,75,
2252,0,82,6,76,
2253,0,81,6,75,
2254,0,83,7,76,
2255,0,81,6,75,
2256,0,82,7,75,
2257,0,82,6,76,
2258,0,72,6,66,
2259,0,62,7,55,
2260,0,53,7,46,
2261,0,52,6,46,
2262,0,45,6,39,
2263,0,36,7,29,
2264,0,29,7,22,
2265,0,23,6,17,
2266,0,24,6,18,
2267,0,39,7,32,
2268,0,39,7,32,
2269,0,40,6,34,
2270,0,40,6,34,
2271,0,42,7,35,
2272,0,42,6,36,
2273,0,42,7,35,
2274,0,43,6,37,
2275,0,42,6,36,
2276,0,46,7,39,
2277,0,44,6,38,
2278,0,44,6,38,
2279,0,46,7,39,
2280,0,45,6,39,
2281,0,46,7,39,
2282,0,47,6,41,
2283,0,46,6,40,
2284,0,49,7,42,
2285,0,48,6,42,
2286,0,47,6,41,
2287,0,50,7,43,
2288,0,48,6,42,
2289,0,51,7,44,
2290,0,50,6,44,
2291,0,50,7,43,
2292,0,52,7,45,
2293,0,50,6,44,
2294,0,54,7,47,
2295,0,52,6,46,
2296,0,53,7,46,
2297,0,54,7,47,
2298,0,54,7,47,
2299,0,53,7,46,
2300,0,54,6,48,
2301,0,55,7,48,
2302,0,54,6,48,
2303,0,56,7,49,
2304,0,54,6,48,
2305,0,57,8,49,
2306,0,57,7,50,
2307,0,56,7,49,
2308,0,57,6,51,
2309,0,57,7,50,
2310,0,58,7,51,
2311,0,59,7,52,
2312,0,57,6,51,
2313,0,60,7,53,
2314,0,59,6,53,
2315,0,58,6,52,
2316,0,60,7,53,
2317,0,58,6,52,
2318,0,61,7,54,
2319,0,60,6,54,
2320,0,60,7,53,
2321,0,62,7,55,
2322,0,61,6,55,
2323,0,61,7,54,
2324,0,63,7,56,
2325,0,61,6,55,
2326,0,63,7,56,
2327,0,62,7,55,
2328,0,65,9,56,
2329,0,64,6,58,
2330,0,64,8,56,
2331,0,64,6,58,
2332,0,64,6,58,
2333,0,64,7,57,
2334,0,64,6,58,
2335,0,64,6,58,
2336,0,66,7,59,
2337,0,64,6,58,
2338,0,65,7,58,
2339,0,66,6,60,
2340,0,65,6,59,
2341,0,67,7,60,
2342,0,67,7,60,
2343,0,67,6,61,
2344,0,66,6,60,
2345,0,68,7,61,
2346,0,68,6,62,
2347,0,69,7,62,
2348,0,68,6,62,
2349,0,67,6,61,
2350,0,69,7,62,
2351,0,70,7,63,
2352,0,69,6,63,
2353,0,69,7,62,
2354,0,70,6,64,
2355,0,69,6,63,
2356,0,71,7,64,
2357,0,70,6,64,
2358,0,72,7,65,
2359,0,72,7,65,
2360,0,70,6,64,
2361,0,71,7,64,
2362,0,73,7,66,
2363,0,72,6,66,
2364,0,72,7,65,
2365,0,73,7,66,
2366,0,72,6,66,
2367,0,75,7,68,
2368,0,73,6,67,
2369,0,74,7,67,
2370,0,72,6,66,
2371,0,75,7,68,
2372,0,74,7,67,
2373,0,74,6,68,
2374,0,73,6,67,
2375,0,76,7,69,
2376,0,75,6,69,
2377,0,74,6,68,
2378,0,76,7,69,
2379,0,74,6,68,
2380,0,76,7,69,
2381,0,76,6,70,
2382,0,75,6,69,
2383,0,77,7,70,
2384,0,76,6,70,
2385,0,79,7,72,
2386,0,77,6,71,
2387,0,76,6,70,
2388,0,80,8,72,
2389,0,77,6,71,
2390,0,79,7,72,
2391,0,79,8,71,
2392,0,78,6,72,
2393,0,77,6,71,
2394,0,80,7,73,
2395,0,79,6,73,
2396,0,79,7,72,
2397,0,80,7,73,
2398,0,79,6,73,
2399,0,82,7,75,
2400,0,80,6,74,
2401,0,80,7,73,
2402,0,80,6,74,
2403,0,80,6,74,
2404,0,83,7,76,
2405,0,81,6,75,
2406,0,80,6,74,
2407,0,82,7,75,
2408,0,82,6,76,
2409,0,82,7,75,
2410,0,82,6,76,
2411,0,83,7,76,
2412,0,81,6,75,
2413,0,84,7,77,
2414,0,82,6,76,
2415,0,81,6,75,
2416,0,84,7,77,
2417,0,82,6,76,
2418,0,83,7,76,
2419,0,71,7,64,
2420,0,58,6,52,
2421,0,55,7,48,
2422,0,50,6,44,
2423,0,45,7,38,
2424,0,35,6,29,
2425,0,27,7,20,
2426,0,23,6,17,
2427,0,26,6,20,
2428,0,40,7,33,
2429,0,38,6,32,
2430,0,42,7,35,
2431,0,41,6,35,
2432,0,40,6,34,
2433,0,44,8,36,
2434,0,42,7,35,
2435,0,43,6,37,
2436,0,42,6,36,
2437,0,45,7,38,
2438,0,43,6,37,
2439,0,45,7,38,
2440,0,45,6,39,
2441,0,47,7,40,
2442,0,46,6,40,
2443,0,47,7,40,
2444,0,47,6,41,
2445,0,47,6,41,
2446,0,49,7,42,
2447,0,48,6,42,
2448,0,49,7,42,
2449,0,49,6,43,
2450,0,49,6,43,
2451,0,52,7,45,
2452,0,51,8,43,
2453,0,51,6,45,
2454,0,50,6,44,
2455,0,53,7,46,
2456,0,52,6,46,
2457,0,52,7,45,
2458,0,53,6,47,
2459,0,52,6,46,
2460,0,55,7,48,
2461,0,54,6,48,
2462,0,53,6,47,
2463,0,55,7,48,
2464,0,56,7,49,
2465,0,55,7,48,
2466,0,56,6,50,
2467,0,55,6,49,
2468,0,57,7,50,
2469,0,57,6,51,
2470,0,56,6,50,
2471,0,59,8,51,
2472,0,57,6,51,
2473,0,58,7,51,
2474,0,58,6,52,
2475,0,58,6,52,
2476,0,60,7,53,
2477,0,58,6,52,
2478,0,59,7,52,
2479,0,64,9,55,
2480,0,60,6,54,
2481,0,61,7,54,
2482,0,61,7,54,
2483,0,61,7,54,
2484,0,61,7,54,
2485,0,62,6,56,
2486,0,63,7,56,
2487,0,61,6,55,
2488,0,65,8,57,
2489,0,63,6,57,
2490,0,62,6,56,
2491,0,64,7,57,
2492,0,63,6,57,
2493,0,64,7,57,
2494,0,65,7,58,
2495,0,63,6,57,
2496,0,66,7,59,
2497,0,65,6,59,
2498,0,64,6,58,
2499,0,66,7,59,
2500,0,65,6,59,
2501,0,67,7,60,
2502,0,66,7,59,
2503,0,67,6,61,
2504,0,66,6,60,
2505,0,68,7,61,
2506,0,67,6,61,
2507,0,67,6,61,
2508,0,69,7,62,
2509,0,69,7,62,
2510,0,69,7,62,
2511,0,69,7,62,
2512,0,69,7,62,
2513,0,70,7,63,
2514,0,68,6,62,
2515,0,72,7,65,
2516,0,70,6,64,
2517,0,69,6,63,
2518,0,70,7,63,
2519,0,71,6,65,
2520,0,71,7,64,
2521,0,72,7,65,
2522,0,70,6,64,
2523,0,74,7,67,
2524,0,72,6,66,
2525,0,73,8,65,
2526,0,73,7,66,
2527,0,72,6,66,
2528,0,73,7,66,
2529,0,73,6,67,
2530,0,72,6,66,
2531,0,74,7,67,
2532,0,76,7,69,
2533,0,74,6,68,
2534,0,73,6,67,
2535,0,76,7,69,
2536,0,75,6,69,
2537,0,75,7,68,
2538,0,76,7,69,
2539,0,74,6,68,
2540,0,75,7,68,
2541,0,76,7,69,
2542,0,76,6,70,
2543,0,77,7,70,
2544,0,76,6,70,
2545,0,77,7,70,
2546,0,77,6,71,
2547,0,78,8,70,
2548,0,77,6,71,
2549,0,76,6,70,
2550,0,79,7,72,
2551,0,78,7,71,
2552,0,78,6,72,
2553,0,78,6,72,
2554,0,78,7,71,
2555,0,78,6,72,
2556,0,80,7,73,
2557,0,78,6,72,
2558,0,79,7,72,
2559,0,80,6,74,
2560,0,80,7,73,
2561,0,81,7,74,
2562,0,82,7,75,
2563,0,80,6,74,
2564,0,81,7,74,
2565,0,81,6,75,
2566,0,80,6,74,
2567,0,82,7,75,
2568,0,80,6,74,
2569,0,84,7,77,
2570,0,84,9,75,
2571,0,81,6,75,
2572,0,84,7,77,
2573,0,84,8,76,
2574,0,82,7,75,
2575,0,82,6,76,
2576,0,81,6,75,
2577,0,83,7,76,
2578,0,82,6,76,
2579,0,83,7,76,
2580,0,70,6,64,
2581,0,59,7,52,
2582,0,53,6,47,
2583,0,50,6,44,
2584,0,46,7,39,
2585,0,35,6,29,
2586,0,28,6,22,
2587,0,24,7,17,
2588,0,27,6,21,
2589,0,37,6,31,
2590,0,42,7,35,
2591,0,40,6,34,
2592,0,40,6,34,
2593,0,41,7,34,
2594,0,43,7,36,
2595,0,42,6,36,
2596,0,43,7,36,
2597,0,43,6,37,
2598,0,43,6,37,
2599,0,46,7,39,
2600,0,45,7,38,
2601,0,47,8,39,
2602,0,46,7,39,
2603,0,47,7,40,
2604,0,46,6,40,
2605,0,47,7,40,
2606,0,49,7,42,
2607,0,50,7,43,
2608,0,49,7,42,
2609,0,49,7,42,
2610,0,49,6,43,
2611,0,49,6,43,
2612,0,51,7,44,
2613,0,50,6,44,
2614,0,51,7,44,
2615,0,51,6,45,
2616,0,53,7,46,
2617,0,52,6,46,
2618,0,52,7,45,
2619,0,54,7,47,
2620,0,52,6,46,
2621,0,55,7,48,
2622,0,54,6,48,
2623,0,54,7,47,
2624,0,55,6,49,
2625,0,54,6,48,
2626,0,57,7,50,
2627,0,56,6,50,
2628,0,55,6,49,
2629,0,57,7,50,
2630,0,57,6,51,
2631,0,57,7,50,
2632,0,57,7,50,
2633,0,58,7,51,
2634,0,59,7,52,
2635,0,58,6,52,
2636,0,58,6,52,
2637,0,60,7,53,
2638,0,58,6,52,
2639,0,59,7,52,
2640,0,61,6,55,
2641,0,62,7,55,
2642,0,60,6,54,
2643,0,61,7,54,
2644,0,62,7,55,
2645,0,61,6,55,
2646,0,62,7,55,
2647,0,63,7,56,
2648,0,61,6,55,
2649,0,63,7,56,
2650,0,63,6,57,
2651,0,63,7,56,
2652,0,63,6,57,
2653,0,63,6,57,
2654,0,66,7,59,
2655,0,64,6,58,
2656,0,63,6,57,
2657,0,66,7,59,
2658,0,65,6,59,
2659,0,65,7,58,
2660,0,66,6,60,
2661,0,66,7,59,
2662,0,67,8,59,
2663,0,66,6,60,
2664,0,69,8,61,
2665,0,66,6,60,
2666,0,68,7,61,
2667,0,67,6,61,
2668,0,69,7,62,
2669,0,70,7,63,
2670,0,68,7,61,
2671,0,68,6,62,
2672,0,68,6,62,
2673,0,71,7,64,
2674,0,69,6,63,
2675,0,70,8,62,
2676,0,71,7,64,
2677,0,69,6,63,
2678,0,71,7,64,
2679,0,70,6,64,
2680,0,71,7,64,
2681,0,71,6,65,
2682,0,71,6,65,
2683,0,71,7,64,
2684,0,72,6,66,
2685,0,71,6,65,
2686,0,73,7,66,
2687,0,72,6,66,
2688,0,73,7,66,
2689,0,73,6,67,
2690,0,72,6,66,
2691,0,74,7,67,
2692,0,73,7,66,
2693,0,75,7,68,
2694,0,75,7,68,
2695,0,73,6,67,
2696,0,74,7,67,
2697,0,75,6,69,
2698,0,74,6,68,
2699,0,76,7,69,
2700,0,77,7,70,
2701,0,75,6,69,
2702,0,76,7,69,
2703,0,76,6,70,
2704,0,75,6,69,
2705,0,77,7,70,
2706,0,76,6,70,
2707,0,79,7,72,
2708,0,77,6,71,
2709,0,76,6,70,
2710,0,79,7,72,
2711,0,78,6,72,
2712,0,78,7,71,
2713,0,78,6,72,
2714,0,77,6,71,
2715,0,80,7,73,
2716,0,78,6,72,
2717,0,79,7,72,
2718,0,79,6,73,
2719,0,78,6,72,
2720,0,80,7,73,
2721,0,80,7,73,
2722,0,80,6,74,
2723,0,79,6,73,
2724,0,81,7,74,
2725,0,80,6,74,
2726,0,83,7,76,
2727,0,81,6,75,
2728,0,80,6,74,
2729,0,82,7,75,
2730,0,82,6,76,
2731,0,84,8,76,
2732,0,82,7,75,
2733,0,83,7,76,
2734,0,81,6,75,
2735,0,84,7,77,
2736,0,82,6,76,
2737,0,83,7,76,
2738,0,83,7,76,
2739,0,81,6,75,
2740,0,82,7,75,
2741,0,69,6,63,
2742,0,57,6,51,
2743,0,54,7,47,
2744,0,51,6,45,
2745,0,45,6,39,
2746,0,36,7,29,
2747,0,26,6,20,
2748,0,24,7,17,
2749,0,28,6,22,
2750,0,41,7,34,
2751,0,40,6,34,
2752,0,41,8,33,
2753,0,42,7,35,
2754,0,41,6,35,
2755,0,44,8,36,
2756,0,42,7,35,
2757,0,43,6,37,
2758,0,42,6,36,
2759,0,45,7,38,
2760,0,44,6,38,
2761,0,44,6,38,
2762,0,45,7,38,
2763,0,47,7,40,
2764,0,46,6,40,
2765,0,47,7,40,
2766,0,47,6,41,
2767,0,47,6,41,
2768,0,49,7,42,
2769,0,49,6,43,
2770,0,49,7,42,
2771,0,49,6,43,
2772,0,49,6,43,
2773,0,51,7,44,
2774,0,50,6,44,
2775,0,52,7,45,
2776,0,52,7,45,
2777,0,52,6,46,
2778,0,51,6,45,
2779,0,54,7,47,
2780,0,52,6,46,
2781,0,53,7,46,
2782,0,54,6,48,
2783,0,55,7,48,
2784,0,55,7,48,
2785,0,64,12,52,
2786,0,61,11,50,
2787,0,63,11,52,
2788,0,62,12,50,
2789,0,62,11,51,
2790,0,63,12,51,
2791,0,63,12,51,
2792,0,70,15,55,
2793,0,64,10,54,
2794,0,60,9,51,
2795,0,59,7,52,
2796,0,60,8,52,
2797,0,58,6,52,
2798,0,60,7,53,
2799,0,59,6,53,
2800,0,63,8,55,
2801,0,60,6,54,
2802,0,60,6,54,
2803,0,62,7,55,
2804,0,61,6,55,
2805,0,62,7,55,
2806,0,62,7,55,
2807,0,63,7,56,
2808,0,61,6,55,
2809,0,65,7,58,
2810,0,63,6,57,
2811,0,62,6,56,
2812,0,64,7,57,
2813,0,64,6,58,
2814,0,64,7,57,
2815,0,64,7,57,
2816,0,65,6,59,
2817,0,64,6,58,
2818,0,67,7,60,
2819,0,65,6,59,
2820,0,65,6,59,
2821,0,67,7,60,
2822,0,66,6,60,
2823,0,66,7,59,
2824,0,68,7,61,
2825,0,66,6,60,
2826,0,68,7,61,
2827,0,67,6,61,
2828,0,67,6,61,
2829,0,69,7,62,
2830,0,69,7,62,
2831,0,69,6,63,
2832,0,69,7,62,
2833,0,69,6,63,
2834,0,68,6,62,
2835,0,70,7,63,
2836,0,72,7,65,
2837,0,70,6,64,
2838,0,69,6,63,
2839,0,72,7,65,
2840,0,71,6,65,
2841,0,71,7,64,
2842,0,71,7,64,
2843,0,70,6,64,
2844,0,73,7,66,
2845,0,72,6,66,
2846,0,73,7,66,
2847,0,71,6,65,
2848,0,74,7,67,
2849,0,74,7,67,
2850,0,73,7,66,
2851,0,74,7,67,
2852,0,73,6,67,
2853,0,75,7,68,
2854,0,74,6,68,
2855,0,75,7,68,
2856,0,73,6,67,
2857,0,75,7,68,
2858,0,75,6,69,
2859,0,74,6,68,
2860,0,75,7,68,
2861,0,78,8,70,
2862,0,75,6,69,
2863,0,76,7,69,
2864,0,76,6,70,
2865,0,78,7,71,
2866,0,77,6,71,
2867,0,77,7,70,
2868,0,77,6,71,
2869,0,76,6,70,
2870,0,79,7,72,
2871,0,78,6,72,
2872,0,78,7,71,
2873,0,78,6,72,
2874,0,78,6,72,
2875,0,79,7,72,
2876,0,80,7,73,
2877,0,79,7,72,
2878,0,79,6,73,
2879,0,78,6,72,
2880,0,81,7,74,
2881,0,79,6,73,
2882,0,82,7,75,
2883,0,80,6,74,
2884,0,79,6,73,
2885,0,83,7,76,
2886,0,81,6,75,
2887,0,81,7,74,
2888,0,82,7,75,
2889,0,80,6,74,
2890,0,84,7,77,
2891,0,82,6,76,
2892,0,83,7,76,
2893,0,82,6,76,
2894,0,82,7,75,
2895,0,82,7,75,
2896,0,83,7,76,
2897,0,81,6,75,
2898,0,83,7,76,
2899,0,82,6,76,
2900,0,76,7,69,
2901,0,63,6,57,
2902,0,53,6,47,
2903,0,53,7,46,
2904,0,47,6,41,
2905,0,38,6,32,
2906,0,31,7,24,
2907,0,25,7,18,
2908,0,24,7,17,
2909,0,33,6,27,
2910,0,38,6,32,
2911,0,42,7,35,
2912,0,40,6,34,
2913,0,40,6,34,
2914,0,43,7,36,
2915,0,41,6,35,
2916,0,43,7,36,
2917,0,43,6,37,
2918,0,45,7,38,
2919,0,44,7,37,
2920,0,45,6,39,
2921,0,45,6,39,
2922,0,46,7,39,
2923,0,47,7,40,
2924,0,48,7,41,
2925,0,46,6,40,
2926,0,47,7,40,
2927,0,48,7,41,
2928,0,48,6,42,
2929,0,48,6,42,
2930,0,51,7,44,
2931,0,50,6,44,
2932,0,49,6,43,
2933,0,50,7,43,
2934,0,52,7,45,
2935,0,51,6,45,
2936,0,52,7,45,
2937,0,53,8,45,
2938,0,52,6,46,
2939,0,53,6,47,
2940,0,53,7,46,
2941,0,53,6,47,
2942,0,53,6,47,
2943,0,55,7,48,
2944,0,54,6,48,
2945,0,54,6,48,
2946,0,55,7,48,
2947,0,57,7,50,
2948,0,56,6,50,
2949,0,55,6,49,
2950,0,58,7,51,
2951,0,58,6,52,
2952,0,59,7,52,
2953,0,58,6,52,
2954,0,58,7,51,
2955,0,58,6,52,
2956,0,60,7,53,
2957,0,61,7,54,
2958,0,59,6,53,
2959,0,58,6,52,
2960,0,61,7,54,
2961,0,60,6,54,
2962,0,60,7,53,
2963,0,61,6,55,
2964,0,62,7,55,
2965,0,61,7,54,
2966,0,62,6,56,
2967,0,63,7,56,
2968,0,62,7,55,
2969,0,62,6,56,
2970,0,62,6,56,
2971,0,64,7,57,
2972,0,62,6,56,
2973,0,65,7,58,
2974,0,64,6,58,
2975,0,63,6,57,
2976,0,65,7,58,
2977,0,64,6,58,
2978,0,66,7,59,
2979,0,66,7,59,
2980,0,65,6,59,
2981,0,68,7,61,
2982,0,66,6,60,
2983,0,65,6,59,
2984,0,68,7,61,
2985,0,67,6,61,
2986,0,68,7,61,
2987,0,67,7,60,
2988,0,68,6,62,
2989,0,67,6,61,
2990,0,70,7,63,
2991,0,68,6,62,
2992,0,69,7,62,
2993,0,69,6,63,
2994,0,69,7,62,
2995,0,69,6,63,
2996,0,69,6,63,
2997,0,72,8,64,
2998,0,71,7,64,
2999,0,70,7,63,
3000,0,71,6,65,
3001,0,70,6,64,
3002,0,71,7,64,
3003,0,72,7,65,
3004,0,72,6,66,
3005,0,72,7,65,
3006,0,72,6,66,
3007,0,71,6,65,
3008,0,74,7,67,
3009,0,72,6,66,
3010,0,74,7,67,
3011,0,73,6,67,
3012,0,72,6,66,
3013,0,75,7,68,
3014,0,73,6,67,
3015,0,75,7,68,
3016,0,74,6,68,
3017,0,75,7,68,
3018,0,75,6,69,
3019,0,74,6,68,
3020,0,76,7,69,
3021,0,75,6,69,
3022,0,78,7,71,
3023,0,76,6,70,
3024,0,78,8,70,
3025,0,83,13,70,
3026,0,84,11,73,
3027,0,83,10,73,
3028,0,84,12,72,
3029,0,83,12,71,
3030,0,85,11,74,
3031,0,86,11,75,
3032,0,85,10,75,
3033,0,86,11,75,
3034,0,86,11,75,
3035,0,85,11,74,
3036,0,87,12,75,
3037,0,87,11,76,
3038,0,86,11,75,
3039,0,87,12,75,
3040,0,87,12,75,
3041,0,86,10,76,
3042,0,90,12,78,
3043,0,89,11,78,
3044,0,88,10,78,
3045,0,88,11,77,
3046,0,88,11,77,
3047,0,89,12,77,
3048,0,88,10,78,
3049,0,90,12,78,
3050,0,90,11,79,
3051,0,89,11,78,
3052,0,89,12,77,
3053,0,90,12,78,
3054,0,88,11,77,
3055,0,88,11,77,
3056,0,80,11,69,
3057,0,67,11,56,
3058,0,62,12,50,
3059,0,60,13,47,
3060,0,48,9,39,
3061,0,40,12,28,
3062,0,34,11,23,
3063,0,33,11,22,
3064,0,47,12,35,
3065,0,45,11,34,
3066,0,46,11,35,
3067,0,47,11,36,
3068,0,48,11,37,
3069,0,49,12,37,
3070,0,49,10,39,
3071,0,51,12,39,
3072,0,52,11,41,
3073,0,51,11,40,
3074,0,52,11,41,
3075,0,55,12,43,
3076,0,52,10,42,
3077,0,55,12,43,
3078,0,53,12,41,
3079,0,58,12,46,
3080,0,55,11,44,
3081,0,55,11,44,
3082,0,55,11,44,
3083,0,56,11,45,
3084,0,58,11,47,
3085,0,58,10,48,
3086,0,61,12,49,
3087,0,58,10,48,
3088,0,57,11,46,
3089,0,52,7,45,
3090,0,53,6,47,
3091,0,53,7,46,
3092,0,53,6,47,
3093,0,54,6,48,
3094,0,54,7,47,
3095,0,54,6,48,
3096,0,55,7,48,
3097,0,56,7,49,
3098,0,54,6,48,
3099,0,57,7,50,
3100,0,56,6,50,
3101,0,56,7,49,
3102,0,58,7,51,
3103,0,57,7,50,
3104,0,60,8,52,
3105,0,59,7,52,
3106,0,58,6,52,
3107,0,60,7,53,
3108,0,60,7,53,
3109,0,59,7,52,
3110,0,59,6,53,
3111,0,60,7,53,
3112,0,61,7,54,
3113,0,59,6,53,
3114,0,62,7,55,
3115,0,64,7,57,
3116,0,61,6,55,
3117,0,61,6,55,
3118,0,63,8,55,
3119,0,63,7,56,
3120,0,61,6,55,
3121,0,63,7,56,
3122,0,65,7,58,
3123,0,63,6,57,
3124,0,63,6,57,
3125,0,65,7,58,
3126,0,63,6,57,
3127,0,66,7,59,
3128,0,65,6,59,
3129,0,66,7,59,
3130,0,64,6,58,
3131,0,68,7,61,
3132,0,66,6,60,
3133,0,66,7,59,
3134,0,66,6,60,
3135,0,66,6,60,
3136,0,69,7,62,
3137,0,67,6,61,
3138,0,67,7,60,
3139,0,68,6,62,
3140,0,68,7,61,
3141,0,69,7,62,
3142,0,67,6,61,
3143,0,71,7,64,
3144,0,69,6,63,
3145,0,68,6,62,
3146,0,71,8,63,
3147,0,69,6,63,
3148,0,71,7,64,
3149,0,71,7,64,
3150,0,71,7,64,
3151,0,70,6,64,
3152,0,72,7,65,
3153,0,72,8,64,
3154,0,72,7,65,
3155,0,72,6,66,
3156,0,72,7,65,
3157,0,72,6,66,
3158,0,71,6,65,
3159,0,74,7,67,
3160,0,73,6,67,
3161,0,75,7,68,
3162,0,73,6,67,
3163,0,73,7,66,
3164,0,74,6,68,
3165,0,73,6,67,
3166,0,76,7,69,
3167,0,76,7,69,
3168,0,74,6,68,
3169,0,76,7,69,
3170,0,74,6,68,
3171,0,76,7,69,
3172,0,78,7,71,
3173,0,76,6,70,
3174,0,75,6,69,
3175,0,77,7,70,
3176,0,80,8,72,
3177,0,77,6,71,
3178,0,77,7,70,
3179,0,78,8,70,
3180,0,77,6,71,
3181,0,76,6,70,
3182,0,80,7,73,
3183,0,79,7,72,
3184,0,78,7,71,
3185,0,79,7,72,
3186,0,79,6,73,
3187,0,78,6,72,
3188,0,81,7,74,
3189,0,79,6,73,
3190,0,79,7,72,
3191,0,80,6,74,
3192,0,80,7,73,
3193,0,81,7,74,
3194,0,79,6,73,
3195,0,82,7,75,
3196,0,81,6,75,
3197,0,81,7,74,
3198,0,81,6,75,
3199,0,80,6,74,
3200,0,82,7,75,
3201,0,81,6,75,
3202,0,84,7,77,
3203,0,82,6,76,
3204,0,81,6,75,
3205,0,83,7,76,
3206,0,85,10,75,
3207,0,88,11,77,
3208,0,89,11,78,
3209,0,90,11,79,
3210,0,86,10,76,
3211,0,73,11,62,
3212,0,60,11,49,
3213,0,61,11,50,
3214,0,53,11,42,
3215,0,40,9,31,
3216,0,32,11,21,
3217,0,37,12,25,
3218,0,46,10,36,
3219,0,45,11,34,
3220,0,47,11,36,
3221,0,47,11,36,
3222,0,47,12,35,
3223,0,48,10,38,
3224,0,50,11,39,
3225,0,50,12,38,
3226,0,50,11,39,
3227,0,51,11,40,
3228,0,51,11,40,
3229,0,53,10,43,
3230,0,53,11,42,
3231,0,54,11,43,
3232,0,54,12,42,
3233,0,54,12,42,
3234,0,54,11,43,
3235,0,57,14,43,
3236,0,55,11,44,
3237,0,57,13,44,
3238,0,57,11,46,
3239,0,58,12,46,
3240,0,57,11,46,
3241,0,58,12,46,
3242,0,59,11,48,
3243,0,58,12,46,
3244,0,58,11,47,
3245,0,60,11,49,
3246,0,60,12,48,
3247,0,60,10,50,
3248,0,61,12,49,
3249,0,61,11,50,
3250,0,61,11,50,
3251,0,61,11,50,
3252,0,62,11,51,
3253,0,63,11,52,
3254,0,63,10,53,
3255,0,65,12,53,
3256,0,64,12,52,
3257,0,65,13,52,
3258,0,66,12,54,
3259,0,64,11,53,
3260,0,66,11,55,
3261,0,66,11,55,
3262,0,65,10,55,
3263,0,67,11,56,
3264,0,67,11,56,
3265,0,67,11,56,
3266,0,67,11,56,
3267,0,67,11,56,
3268,0,69,11,58,
3269,0,70,11,59,
3270,0,69,12,57,
3271,0,69,10,59,
3272,0,70,11,59,
3273,0,65,8,57,
3274,0,64,7,57,
3275,0,64,6,58,
3276,0,63,6,57,
3277,0,66,7,59,
3278,0,65,6,59,
3279,0,65,7,58,
3280,0,65,6,59,
3281,0,64,6,58,
3282,0,67,7,60,
3283,0,66,6,60,
3284,0,66,7,59,
3285,0,66,6,60,
3286,0,67,6,61,
3287,0,67,7,60,
3288,0,67,6,61,
3289,0,66,6,60,
3290,0,76,12,64,
3291,0,75,13,62,
3292,0,74,12,62,
3293,0,76,11,65,
3294,0,75,11,64,
3295,0,76,11,65,
3296,0,75,12,63,
3297,0,77,12,65,
3298,0,76,12,64,
3299,0,76,11,65,
3300,0,80,12,68,
3301,0,79,12,67,
3302,0,78,12,66,
3303,0,77,13,64,
3304,0,78,12,66,
3305,0,78,12,66,
3306,0,79,11,68,
3307,0,80,11,69,
3308,0,80,11,69,
3309,0,80,11,69,
3310,0,79,11,68,
3311,0,80,12,68,
3312,0,80,12,68,
3313,0,80,12,68,
3314,0,80,10,70,
3315,0,82,11,71,
3316,0,82,11,71,
3317,0,81,11,70,
3318,0,82,11,71,
3319,0,81,12,69,
3320,0,83,11,72,
3321,0,85,13,72,
3322,0,83,11,72,
3323,0,83,11,72,
3324,0,83,11,72,
3325,0,84,13,71,
3326,0,83,12,71,
3327,0,83,12,71,
3328,0,85,12,73,
3329,0,85,12,73,
3330,0,84,11,73,
3331,0,84,10,74,
3332,0,86,11,75,
3333,0,83,10,73,
3334,0,80,7,73,
3335,0,79,6,73,
3336,0,81,7,74,
3337,0,80,6,74,
3338,0,79,6,73,
3339,0,81,7,74,
3340,0,79,6,73,
3341,0,82,7,75,
3342,0,81,6,75,
3343,0,82,8,74,
3344,0,81,6,75,
3345,0,80,6,74,
3346,0,84,7,77,
3347,0,82,6,76,
3348,0,81,6,75,
3349,0,82,7,75,
3350,0,83,7,76,
3351,0,82,6,76,
3352,0,85,8,77,
3353,0,82,6,76,
3354,0,82,7,75,
3355,0,82,6,76,
3356,0,82,6,76,
3357,0,76,7,69,
3358,0,63,7,56,
3359,0,52,6,46,
3360,0,54,7,47,
3361,0,50,8,42,
3362,0,38,6,32,
3363,0,29,6,23,
3364,0,23,6,17,
3365,0,27,7,20,
3366,0,34,6,28,
3367,0,39,7,32,
3368,0,41,7,34,
3369,0,39,6,33,
3370,0,42,7,35,
3371,0,42,6,36,
3372,0,42,7,35,
3373,0,43,6,37,
3374,0,43,6,37,
3375,0,44,7,37,
3376,0,44,6,38,
3377,0,44,6,38,
3378,0,46,7,39,
3379,0,46,6,40,
3380,0,47,7,40,
3381,0,49,8,41,
3382,0,47,6,41,
3383,0,46,6,40,
3384,0,49,7,42,
3385,0,48,6,42,
3386,0,49,7,42,
3387,0,49,6,43,
3388,0,50,8,42,
3389,0,51,7,44,
3390,0,49,6,43,
3391,0,53,8,45,
3392,0,50,6,44,
3393,0,51,7,44,
3394,0,53,6,47,
3395,0,52,7,45,
3396,0,53,6,47,
3397,0,52,6,46,
3398,0,54,7,47,
3399,0,53,6,47,
3400,0,54,7,47,
3401,0,54,6,48,
3402,0,54,6,48,
3403,0,57,7,50,
3404,0,55,6,49,
3405,0,56,7,49,
3406,0,57,7,50,
3407,0,55,6,49,
3408,0,58,7,51,
3409,0,57,6,51,
3410,0,56,6,50,
3411,0,60,8,52,
3412,0,58,6,52,
3413,0,58,7,51,
3414,0,59,6,53,
3415,0,58,6,52,
3416,0,60,7,53,
3417,0,59,6,53,
3418,0,61,7,54,
3419,0,59,6,53,
3420,0,62,8,54,
3421,0,62,7,55,
3422,0,64,8,56,
3423,0,60,6,54,
3424,0,62,7,55,
3425,0,62,6,56,
3426,0,62,7,55,
3427,0,64,7,57,
3428,0,63,6,57,
3429,0,62,6,56,
3430,0,65,7,58,
3431,0,63,6,57,
3432,0,66,7,59,
3433,0,64,6,58,
3434,0,65,7,58,
3435,0,65,6,59,
3436,0,64,6,58,
3437,0,67,7,60,
3438,0,66,6,60,
3439,0,65,6,59,
3440,0,66,7,59,
3441,0,67,7,60,
3442,0,67,7,60,
3443,0,67,6,61,
3444,0,66,6,60,
3445,0,69,7,62,
3446,0,68,6,62,
3447,0,68,7,61,
3448,0,69,7,62,
3449,0,70,7,63,
3450,0,69,7,62,
3451,0,69,6,63,
3452,0,68,6,62,
3453,0,71,7,64,
3454,0,70,6,64,
3455,0,69,6,63,
3456,0,71,7,64,
3457,0,71,7,64,
3458,0,72,7,65,
3459,0,71,7,64,
3460,0,71,6,65,
3461,0,73,7,66,
3462,0,71,6,65,
3463,0,74,7,67,
3464,0,72,6,66,
3465,0,71,6,65,
3466,0,74,7,67,
3467,0,72,6,66,
3468,0,73,7,66,
3469,0,73,6,67,
3470,0,74,7,67,
3471,0,73,6,67,
3472,0,76,7,69,
3473,0,74,6,68,
3474,0,73,6,67,
3475,0,76,7,69,
3476,0,74,6,68,
3477,0,75,7,68,
3478,0,75,6,69,
3479,0,77,6,71,
3480,0,77,7,70,
3481,0,76,6,70,
3482,0,76,7,69,
3483,0,78,7,71,
3484,0,76,6,70,
3485,0,79,7,72,
3486,0,77,6,71,
3487,0,77,7,70,
3488,0,78,6,72,
3489,0,77,6,71,
3490,0,80,7,73,
3491,0,78,6,72,
3492,0,77,6,71,
3493,0,80,7,73,
3494,0,79,6,73,
3495,0,79,7,72,
3496,0,79,6,73,
3497,0,78,6,72,
3498,0,81,7,74,
3499,0,80,6,74,
3500,0,79,6,73,
3501,0,80,7,73,
3502,0,82,8,74,
3503,0,80,6,74,
3504,0,81,7,74,
3505,0,81,6,75,
3506,0,81,7,74,
3507,0,82,6,76,
3508,0,82,6,76,
3509,0,83,7,76,
3510,0,82,7,75,
3511,0,83,7,76,
3512,0,81,6,75,
3513,0,83,7,76,
3514,0,83,7,76,
3515,0,82,7,75,
3516,0,82,6,76,
3517,0,84,7,77,
3518,0,75,7,68,
3519,0,62,7,55,
3520,0,53,6,47,
3521,0,51,6,45,
3522,0,47,7,40,
3523,0,37,6,31,
3524,0,28,6,22,
3525,0,26,7,19,
3526,0,25,6,19,
3527,0,34,6,28,
3528,0,40,7,33,
3529,0,39,6,33,
3530,0,41,7,34,
3531,0,41,7,34,
3532,0,42,6,36,
3533,0,41,6,35,
3534,0,45,7,38,
3535,0,43,6,37,
3536,0,43,6,37,
3537,0,45,7,38,
3538,0,46,8,38,
3539,0,45,7,38,
3540,0,47,8,39,
3541,0,46,6,40,
3542,0,46,6,40,
3543,0,49,7,42,
3544,0,47,6,41,
3545,0,49,7,42,
3546,0,47,6,41,
3547,0,49,7,42,
3548,0,50,8,42,
3549,0,50,6,44,
3550,0,49,6,43,
3551,0,52,7,45,
3552,0,51,6,45,
3553,0,51,7,44,
3554,0,53,7,46,
3555,0,51,6,45,
3556,0,53,7,46,
3557,0,53,6,47,
3558,0,53,7,46,
3559,0,53,6,47,
3560,0,54,6,48,
3561,0,56,7,49,
3562,0,56,7,49,
3563,0,55,6,49,
3564,0,55,7,48,
3565,0,56,6,50,
3566,0,55,6,49,
3567,0,57,7,50,
3568,0,57,6,51,
3569,0,60,8,52,
3570,0,59,9,50,
3571,0,60,9,51,
3572,0,62,11,51,
3573,0,63,10,53,
3574,0,60,7,53,
3575,0,60,7,53,
3576,0,59,7,52,
3577,0,61,7,54,
3578,0,59,6,53,
3579,0,61,7,54,
3580,0,60,7,53,
3581,0,61,6,55,
3582,0,60,6,54,
3583,0,62,7,55,
3584,0,64,7,57,
3585,0,62,6,56,
3586,0,61,6,55,
3587,0,63,7,56,
3588,0,62,6,56,
3589,0,64,7,57,
3590,0,63,6,57,
3591,0,64,7,57,
3592,0,64,6,58,
3593,0,63,6,57,
3594,0,65,7,58,
3595,0,65,7,58,
3596,0,65,6,59,
3597,0,64,6,58,
3598,0,67,7,60,
3599,0,65,6,59,
3600,0,67,8,59,
3601,0,67,7,60,
3602,0,68,7,61,
3603,0,68,7,61,
3604,0,67,7,60,
3605,0,67,6,61,
3606,0,70,7,63,
3607,0,68,6,62,
3608,0,68,7,61,
3609,0,69,7,62,
3610,0,68,6,62,
3611,0,71,7,64,
3612,0,69,6,63,
3613,0,68,6,62,
3614,0,71,7,64,
3615,0,69,6,63,
3616,0,72,7,65,
3617,0,70,6,64,
3618,0,71,7,64,
3619,0,71,6,65,
3620,0,71,6,65,
3621,0,71,7,64,
3622,0,72,6,66,
3623,0,71,6,65,
3624,0,73,7,66,
3625,0,71,6,65,
3626,0,75,7,68,
3627,0,73,6,67,
3628,0,72,6,66,
3629,0,74,7,67,
3630,0,75,7,68,
3631,0,73,6,67,
3632,0,75,7,68,
3633,0,74,6,68,
3634,0,74,7,67,
3635,0,75,7,68,
3636,0,60,1,59,
3637,0,39,,39,
3638,0,14,,14,
