window-id,queue-size-CL,queue-size-LL,10.0.0.13:58892 -> 10.0.1.13:3000,10.0.1.13:3000 -> 10.0.0.13:58892,10.0.0.13:52523 -> 10.0.1.13:1000
0,0,30,8,22,
1,0,30,7,23,
2,0,29,9,20,
3,0,27,8,19,
4,0,27,8,19,
5,0,25,8,17,
6,0,24,7,17,
7,0,24,8,16,
8,0,24,7,17,
9,0,26,8,18,
10,0,25,8,17,
11,0,25,9,16,
12,0,25,9,16,
13,0,25,8,17,
14,0,27,9,18,
15,0,24,7,17,
16,0,25,9,16,
17,0,24,8,16,
18,0,26,9,17,
19,0,23,7,16,
20,0,24,8,16,
21,0,29,12,17,
22,0,30,13,17,
23,0,31,14,17,
24,0,28,10,18,
25,0,30,13,17,
26,0,28,12,16,
27,0,29,12,17,
28,0,29,12,17,
29,0,30,13,17,
30,0,30,12,18,
31,0,30,12,18,
32,0,30,13,17,
33,0,28,11,17,
34,0,32,14,18,
35,0,28,11,17,
36,0,31,13,18,
37,0,28,11,17,
38,0,31,13,18,
39,0,31,12,19,
40,0,31,13,18,
41,0,29,11,18,
42,0,31,13,18,
43,0,31,12,19,
44,0,30,13,17,
45,0,30,12,18,
46,0,29,12,17,
47,0,30,12,18,
48,0,30,12,18,
49,0,31,13,18,
50,0,30,12,18,
51,0,29,12,17,
52,0,29,12,17,
53,0,24,8,16,
54,0,25,7,18,
55,0,25,9,16,
56,0,24,7,17,
57,0,25,8,17,
58,0,24,7,17,
59,0,23,8,15,
60,0,24,9,15,
61,0,25,7,18,
62,0,27,9,18,
63,0,24,7,17,
64,0,24,7,17,
65,0,23,7,16,
66,0,23,6,17,
67,0,23,6,17,
68,0,24,7,17,
69,0,24,8,16,
70,0,24,7,17,
71,0,22,6,16,
72,0,23,7,16,
73,0,24,7,17,
74,0,25,7,18,
75,0,23,6,17,
76,0,24,7,17,
77,0,23,7,16,
78,0,23,6,17,
79,0,24,6,18,
80,0,23,6,17,
81,0,25,7,18,
82,0,24,7,17,
83,0,24,7,17,
84,0,23,6,17,
85,0,23,7,16,
86,0,24,7,17,
87,0,23,7,16,
88,0,25,7,18,
89,0,24,6,18,
90,0,22,6,16,
91,0,22,7,15,
92,0,25,8,17,
93,0,23,6,17,
94,0,24,7,17,
95,0,24,6,18,
96,0,23,6,17,
97,0,25,7,18,
98,0,23,6,17,
99,0,23,7,16,
100,0,23,6,17,
101,0,24,6,18,
102,0,26,7,19,
103,0,24,6,18,
104,0,25,7,18,
105,0,23,6,17,
106,0,24,7,17,
107,0,24,7,17,
108,0,22,6,16,
109,0,24,7,17,
110,0,23,6,17,
111,0,22,6,16,
112,0,24,7,17,
113,0,22,6,16,
114,0,24,7,17,
115,0,24,6,18,
116,0,24,7,17,
117,0,23,7,16,
118,0,21,6,15,
119,0,24,8,16,
120,0,21,6,15,
121,0,23,7,16,
122,0,21,6,15,
123,0,23,7,16,
124,0,23,6,17,
125,0,22,6,16,
126,0,24,7,17,
127,0,22,6,16,
128,0,25,7,18,
129,0,23,6,17,
130,0,22,6,16,
131,0,24,7,17,
132,0,24,6,18,
133,0,22,6,16,
134,0,22,6,16,
135,0,25,7,18,
136,0,21,6,15,
137,0,24,7,17,
138,0,24,6,18,
139,0,23,6,17,
140,0,25,7,18,
141,0,24,6,18,
142,0,22,6,16,
143,0,21,6,15,
144,0,23,7,16,
145,0,24,7,17,
146,0,22,6,16,
147,0,21,6,15,
148,0,25,7,18,
149,0,24,6,18,
150,0,25,7,18,
151,0,24,6,18,
152,0,23,6,17,
153,0,23,7,16,
154,0,23,6,17,
155,0,23,6,17,
156,0,21,6,15,
157,0,25,7,18,
158,0,23,6,17,
159,0,23,7,16,
160,0,23,7,16,
161,0,26,8,18,
162,0,23,6,17,
163,0,22,7,15,
164,0,24,7,17,
165,0,25,7,18,
166,0,23,6,17,
167,0,23,7,16,
168,0,23,7,16,
169,0,24,7,17,
170,0,22,6,16,
171,0,23,7,16,
172,0,24,6,18,
173,0,24,7,17,
174,0,23,7,16,
175,0,22,6,16,
176,0,21,6,15,
177,0,23,7,16,
178,0,22,6,16,
179,0,24,6,18,
180,0,24,7,17,
181,0,23,7,16,
182,0,23,6,17,
183,0,22,6,16,
184,0,25,7,18,
185,0,23,6,17,
186,0,23,7,16,
187,0,21,6,15,
188,0,22,7,15,
189,0,24,6,18,
190,0,22,6,16,
191,0,22,7,15,
192,0,22,6,16,
193,0,24,7,17,
194,0,22,6,16,
195,0,23,7,16,
196,0,25,7,18,
197,0,23,6,17,
198,0,22,7,15,
199,0,25,7,18,
200,0,23,6,17,
201,0,25,7,18,
202,0,23,6,17,
203,0,23,7,16,
204,0,26,7,19,
205,0,24,7,17,
206,0,22,6,16,
207,0,21,6,15,
208,0,22,7,15,
209,0,25,7,18,
210,0,24,6,18,
211,0,23,7,16,
212,0,23,6,17,
213,0,24,6,18,
214,0,24,7,17,
215,0,23,6,17,
216,0,23,6,17,
217,0,21,6,15,
218,0,23,7,16,
219,0,23,6,17,
220,0,23,7,16,
221,0,23,7,16,
222,0,25,7,18,
223,0,23,7,16,
224,0,24,7,17,
225,0,22,6,16,
226,0,26,7,19,
227,0,24,7,17,
228,0,22,6,16,
229,0,25,7,18,
230,0,23,6,17,
231,0,25,7,18,
232,0,21,5,16,
233,0,24,7,17,
234,0,22,6,16,
235,0,23,7,16,
236,0,24,6,18,
237,0,24,7,17,
238,0,23,7,16,
239,0,21,6,15,
240,0,24,7,17,
241,0,22,6,16,
242,0,23,6,17,
243,0,24,7,17,
244,0,24,6,18,
245,0,25,7,18,
246,0,25,6,19,
247,0,23,6,17,
248,0,23,7,16,
249,0,22,6,16,
250,0,21,6,15,
251,0,24,8,16,
252,0,22,7,15,
253,0,22,6,16,
254,0,26,7,19,
255,0,24,7,17,
256,0,24,6,18,
257,0,25,6,19,
258,0,23,6,17,
259,0,25,7,18,
260,0,22,6,16,
261,0,23,7,16,
262,0,24,7,17,
263,0,25,6,19,
264,0,24,7,17,
265,0,24,6,18,
266,0,23,6,17,
267,0,23,7,16,
268,0,22,6,16,
269,0,21,6,15,
270,0,23,7,16,
271,0,22,6,16,
272,0,23,7,16,
273,0,22,5,17,
274,0,24,7,17,
275,0,22,6,16,
276,0,23,7,16,
277,0,23,6,17,
278,0,22,6,16,
279,0,26,7,19,
280,0,24,6,18,
281,0,23,6,17,
282,0,24,7,17,
283,0,24,7,17,
284,0,24,7,17,
285,0,22,6,16,
286,0,23,7,16,
287,0,23,7,16,
288,0,23,6,17,
289,0,24,6,18,
290,0,22,6,16,
291,0,24,7,17,
292,0,23,6,17,
293,0,23,7,16,
294,0,23,6,17,
295,0,22,6,16,
296,0,25,7,18,
297,0,24,6,18,
298,0,23,6,17,
299,0,23,7,16,
300,0,22,6,16,
301,0,22,7,15,
302,0,24,6,18,
303,0,24,7,17,
304,0,25,7,18,
305,0,23,7,16,
306,0,23,6,17,
307,0,23,6,17,
308,0,22,6,16,
309,0,25,7,18,
310,0,24,6,18,
311,0,24,6,18,
312,0,23,7,16,
313,0,22,6,16,
314,0,23,7,16,
315,0,21,6,15,
316,0,22,7,15,
317,0,25,7,18,
318,0,25,7,18,
319,0,22,6,16,
320,0,24,7,17,
321,0,25,6,19,
322,0,25,6,19,
323,0,23,6,17,
324,0,25,7,18,
325,0,23,6,17,
326,0,22,6,16,
327,0,21,6,15,
328,0,23,7,16,
329,0,24,7,17,
330,0,24,8,16,
331,0,22,6,16,
332,0,24,6,18,
333,0,24,7,17,
334,0,23,6,17,
335,0,22,7,15,
336,0,24,6,18,
337,0,24,7,17,
338,0,22,6,16,
339,0,24,7,17,
340,0,23,6,17,
341,0,23,7,16,
342,0,23,6,17,
343,0,25,7,18,
344,0,23,6,17,
345,0,26,9,17,
346,0,23,6,17,
347,0,22,6,16,
348,0,23,7,16,
349,0,22,7,15,
350,0,21,6,15,
351,0,26,7,19,
352,0,23,6,17,
353,0,25,7,18,
354,0,24,6,18,
355,0,23,6,17,
356,0,24,7,17,
357,0,22,6,16,
358,0,21,6,15,
359,0,23,7,16,
360,0,21,6,15,
361,0,22,7,15,
362,0,23,6,17,
363,0,23,6,17,
364,0,23,7,16,
365,0,25,8,17,
366,0,22,6,16,
367,0,23,7,16,
368,0,23,6,17,
369,0,23,7,16,
370,0,25,7,18,
371,0,23,6,17,
372,0,24,7,17,
373,0,22,6,16,
374,0,21,6,15,
375,0,23,7,16,
376,0,22,6,16,
377,0,22,7,15,
378,0,22,6,16,
379,0,24,7,17,
380,0,22,6,16,
381,0,23,7,16,
382,0,22,6,16,
383,0,23,6,17,
384,0,23,6,17,
385,0,23,7,16,
386,0,24,6,18,
387,0,23,6,17,
388,0,23,7,16,
389,0,21,6,15,
390,0,22,7,15,
391,0,22,6,16,
392,0,25,6,19,
393,0,25,7,18,
394,0,24,7,17,
395,0,24,6,18,
396,0,24,7,17,
397,0,25,7,18,
398,0,24,6,18,
399,0,23,6,17,
400,0,24,7,17,
401,0,23,6,17,
402,0,24,6,18,
403,0,22,6,16,
404,0,23,7,16,
405,0,24,6,18,
406,0,25,8,17,
407,0,23,7,16,
408,0,24,8,16,
409,0,24,8,16,
410,0,24,6,18,
411,0,25,7,18,
412,0,22,6,16,
413,0,25,7,18,
414,0,23,6,17,
415,0,23,7,16,
416,0,23,6,17,
417,0,22,6,16,
418,0,25,7,18,
419,0,24,6,18,
420,0,22,6,16,
421,0,25,7,18,
422,0,25,7,18,
423,0,24,6,18,
424,0,24,7,17,
425,0,23,6,17,
426,0,24,7,17,
427,0,24,7,17,
428,0,23,6,17,
429,0,24,6,18,
430,0,22,6,16,
431,0,25,7,18,
432,0,24,6,18,
433,0,27,9,18,
434,0,23,6,17,
435,0,21,6,15,
436,0,23,8,15,
437,0,23,7,16,
438,0,24,7,17,
439,0,25,7,18,
440,0,24,7,17,
441,0,25,6,19,
442,0,24,7,17,
443,0,24,7,17,
444,0,23,7,16,
445,0,22,6,16,
446,0,23,6,17,
447,0,21,6,15,
448,0,24,7,17,
449,0,23,6,17,
450,0,23,7,16,
451,0,22,6,16,
452,0,23,6,17,
453,0,22,6,16,
454,0,25,7,18,
455,0,26,8,18,
456,0,24,7,17,
457,0,23,7,16,
458,0,22,6,16,
459,0,23,7,16,
460,0,23,6,17,
461,0,22,6,16,
462,0,22,7,15,
463,0,25,7,18,
464,0,24,6,18,
465,0,24,7,17,
466,0,24,6,18,
467,0,24,7,17,
468,0,23,7,16,
469,0,23,7,16,
470,0,26,8,18,
471,0,26,8,18,
472,0,23,6,17,
473,0,23,7,16,
474,0,23,6,17,
475,0,23,6,17,
476,0,23,7,16,
477,0,25,7,18,
478,0,22,6,16,
479,0,24,7,17,
480,0,23,6,17,
481,0,23,7,16,
482,0,23,6,17,
483,0,22,6,16,
484,0,26,8,18,
485,0,24,7,17,
486,0,22,6,16,
487,0,26,9,17,
488,0,23,7,16,
489,0,23,6,17,
490,0,22,6,16,
491,0,24,7,17,
492,0,22,6,16,
493,0,23,6,17,
494,0,25,7,18,
495,0,24,7,17,
496,0,24,6,18,
497,0,25,8,17,
498,0,24,7,17,
499,0,23,7,16,
500,0,22,7,15,
501,0,12,4,8,
502,0,17,4,13,
503,0,24,6,18,
504,0,23,7,16,
505,0,24,6,18,
506,0,22,6,16,
507,0,24,7,17,
508,0,23,6,17,
509,0,23,7,16,
510,0,23,6,17,
511,0,23,6,17,
512,0,23,7,16,
513,0,23,6,17,
514,0,22,6,16,
515,0,24,7,17,
516,0,24,7,17,
517,0,23,7,16,
518,0,26,9,17,
519,0,24,7,17,
520,0,23,6,17,
521,0,22,6,16,
522,0,23,6,17,
523,0,23,7,16,
524,0,24,8,16,
525,0,24,7,17,
526,0,22,6,16,
527,0,23,7,16,
528,0,22,7,15,
529,0,23,6,17,
530,0,26,7,19,
531,0,24,7,17,
532,0,23,6,17,
533,0,24,6,18,
534,0,22,6,16,
535,0,25,7,18,
536,0,24,6,18,
537,0,24,7,17,
538,0,22,6,16,
539,0,22,6,16,
540,0,22,7,15,
541,0,24,8,16,
542,0,21,6,15,
543,0,24,7,17,
544,0,23,6,17,
545,0,23,7,16,
546,0,24,7,17,
547,0,24,6,18,
548,0,23,6,17,
549,0,26,8,18,
550,0,21,6,15,
551,0,23,7,16,
552,0,22,6,16,
553,0,22,7,15,
554,0,23,6,17,
555,0,22,6,16,
556,0,24,7,17,
557,0,23,6,17,
558,0,22,6,16,
559,0,24,7,17,
560,0,23,6,17,
561,0,25,7,18,
562,0,23,6,17,
563,0,23,7,16,
564,0,24,6,18,
565,0,24,7,17,
566,0,22,6,16,
567,0,24,7,17,
568,0,22,6,16,
569,0,21,6,15,
570,0,24,7,17,
571,0,23,6,17,
572,0,23,7,16,
573,0,23,6,17,
574,0,22,6,16,
575,0,24,7,17,
576,0,23,7,16,
577,0,24,6,18,
578,0,22,6,16,
579,0,25,8,17,
580,0,22,6,16,
581,0,23,7,16,
582,0,23,6,17,
583,0,21,6,15,
584,0,24,7,17,
585,0,24,7,17,
586,0,23,6,17,
587,0,23,6,17,
588,0,23,6,17,
589,0,24,7,17,
590,0,23,7,16,
591,0,22,5,17,
592,0,25,7,18,
593,0,23,6,17,
594,0,25,7,18,
595,0,23,6,17,
596,0,21,6,15,
597,0,24,7,17,
598,0,22,6,16,
599,0,21,6,15,
600,0,26,7,19,
601,0,23,6,17,
602,0,24,7,17,
603,0,24,6,18,
604,0,23,6,17,
605,0,23,7,16,
606,0,25,7,18,
607,0,24,7,17,
608,0,7,3,4,
611,0,21,5,16,
612,0,22,6,16,
613,0,22,7,15,
614,0,25,6,19,
615,0,24,7,17,
616,0,25,7,18,
617,0,23,6,17,
618,0,24,7,17,
619,0,22,6,16,
620,0,21,6,15,
621,0,23,7,16,
622,0,23,7,16,
623,0,23,7,16,
624,0,21,6,15,
625,0,24,7,17,
626,0,23,6,17,
627,0,23,7,16,
628,0,23,6,17,
629,0,22,6,16,
630,0,25,7,18,
631,0,23,6,17,
632,0,22,6,16,
633,0,25,7,18,
634,0,24,6,18,
635,0,24,7,17,
636,0,23,7,16,
637,0,21,6,15,
638,0,23,7,16,
639,0,25,7,18,
640,0,25,7,18,
641,0,25,7,18,
642,0,24,6,18,
643,0,23,6,17,
644,0,23,7,16,
645,0,22,6,16,
646,0,22,7,15,
647,0,22,6,16,
648,0,23,8,15,
649,0,23,7,16,
650,0,27,7,20,
651,0,24,6,18,
652,0,24,7,17,
653,0,24,7,17,
654,0,25,7,18,
655,0,23,6,17,
656,0,24,7,17,
657,0,22,6,16,
658,0,22,6,16,
659,0,22,6,16,
660,0,22,7,15,
661,0,23,6,17,
662,0,22,6,16,
663,0,24,7,17,
664,0,23,6,17,
665,0,23,7,16,
666,0,23,6,17,
667,0,22,6,16,
668,0,27,8,19,
669,0,24,6,18,
670,0,23,6,17,
671,0,24,7,17,
672,0,23,6,17,
673,0,30,9,21,
674,0,23,6,17,
675,0,24,7,17,
676,0,23,6,17,
677,0,26,7,19,
678,0,22,6,16,
679,0,23,6,17,
680,0,22,6,16,
681,0,22,7,15,
682,0,24,7,17,
683,0,24,7,17,
684,0,24,6,18,
685,0,22,6,16,
686,0,24,6,18,
687,0,23,7,16,
688,0,25,7,18,
689,0,23,6,17,
690,0,23,7,16,
691,0,22,6,16,
692,0,22,7,15,
693,0,22,6,16,
694,0,21,6,15,
695,0,25,7,18,
696,0,23,6,17,
697,0,22,6,16,
698,0,24,7,17,
699,0,24,7,17,
700,0,23,6,17,
701,0,23,7,16,
702,0,11,3,8,
706,0,20,7,13,
707,0,23,6,17,
708,0,25,7,18,
709,0,24,7,17,
710,0,23,7,16,
711,0,23,6,17,
712,0,22,6,16,
713,0,26,7,19,
714,0,25,7,18,
715,0,23,6,17,
716,0,24,7,17,
717,0,24,7,17,
718,0,22,6,16,
719,0,22,7,15,
720,0,23,7,16,
721,0,21,6,15,
722,0,25,7,18,
723,0,23,6,17,
724,0,22,6,16,
725,0,24,7,17,
726,0,23,6,17,
727,0,23,7,16,
728,0,23,6,17,
729,0,22,6,16,
730,0,25,7,18,
731,0,24,6,18,
732,0,23,6,17,
733,0,24,7,17,
734,0,23,6,17,
735,0,22,6,16,
736,0,22,7,15,
737,0,23,7,16,
738,0,25,7,18,
739,0,23,6,17,
740,0,24,7,17,
741,0,22,6,16,
742,0,23,7,16,
743,0,22,6,16,
744,0,23,6,17,
745,0,23,7,16,
746,0,23,6,17,
747,0,25,7,18,
748,0,23,6,17,
749,0,23,7,16,
750,0,24,7,17,
751,0,22,6,16,
752,0,22,7,15,
753,0,23,6,17,
754,0,22,6,16,
755,0,24,7,17,
756,0,22,6,16,
757,0,26,7,19,
758,0,22,6,16,
759,0,26,7,19,
760,0,25,7,18,
761,0,24,6,18,
762,0,24,7,17,
763,0,22,6,16,
764,0,22,6,16,
765,0,22,6,16,
766,0,24,7,17,
767,0,24,7,17,
768,0,23,6,17,
769,0,22,6,16,
770,0,24,7,17,
771,0,23,7,16,
772,0,22,6,16,
773,0,22,7,15,
774,0,23,6,17,
775,0,22,6,16,
776,0,22,7,15,
777,0,23,6,17,
778,0,23,6,17,
779,0,23,7,16,
780,0,23,6,17,
781,0,22,6,16,
782,0,24,7,17,
783,0,23,6,17,
784,0,22,7,15,
785,0,22,6,16,
786,0,23,6,17,
787,0,26,7,19,
788,0,24,6,18,
789,0,24,7,17,
790,0,26,8,18,
791,0,23,7,16,
792,0,24,7,17,
793,0,24,6,18,
794,0,24,6,18,
795,0,23,7,16,
796,0,23,5,18,
797,0,24,8,16,
798,0,21,6,15,
799,0,23,7,16,
800,0,23,6,17,
801,0,22,7,15,
802,0,21,6,15,
803,0,25,7,18,
804,0,24,6,18,
805,0,25,7,18,
806,0,22,6,16,
807,0,25,7,18,
808,0,22,6,16,
809,0,22,7,15,
810,0,23,7,16,
811,0,21,6,15,
812,0,24,7,17,
813,0,23,6,17,
814,0,25,8,17,
815,0,23,6,17,
816,0,23,7,16,
817,0,23,6,17,
818,0,22,6,16,
819,0,24,7,17,
820,0,25,7,18,
821,0,23,6,17,
822,0,22,6,16,
823,0,25,7,18,
824,0,23,6,17,
825,0,22,6,16,
826,0,24,7,17,
827,0,22,6,16,
828,0,25,8,17,
829,0,23,6,17,
830,0,23,7,16,
831,0,23,6,17,
832,0,24,7,17,
833,0,25,6,19,
834,0,24,7,17,
835,0,23,6,17,
836,0,24,7,17,
837,0,25,7,18,
838,0,23,6,17,
839,0,23,7,16,
840,0,23,6,17,
841,0,22,6,16,
842,0,23,7,16,
843,0,23,6,17,
844,0,23,7,16,
845,0,25,7,18,
846,0,23,6,17,
847,0,23,7,16,
848,0,22,6,16,
849,0,21,6,15,
850,0,23,7,16,
851,0,22,6,16,
852,0,23,7,16,
853,0,22,7,15,
854,0,24,7,17,
855,0,23,6,17,
856,0,22,6,16,
857,0,24,7,17,
858,0,24,6,18,
859,0,24,7,17,
860,0,25,7,18,
861,0,23,6,17,
862,0,25,7,18,
863,0,23,6,17,
864,0,23,7,16,
865,0,22,6,16,
866,0,22,6,16,
867,0,25,7,18,
868,0,23,7,16,
869,0,22,6,16,
870,0,23,6,17,
871,0,24,7,17,
872,0,23,6,17,
873,0,23,7,16,
874,0,24,6,18,
875,0,21,6,15,
876,0,24,7,17,
877,0,22,6,16,
878,0,21,6,15,
879,0,24,7,17,
880,0,22,6,16,
881,0,24,7,17,
882,0,24,7,17,
883,0,24,7,17,
884,0,29,11,18,
885,0,25,6,19,
886,0,27,9,18,
887,0,29,12,17,
888,0,29,12,17,
889,0,26,10,16,
890,0,27,9,18,
891,0,27,10,17,
892,0,29,12,17,
893,0,27,10,17,
894,0,26,8,18,
895,0,25,8,17,
896,0,26,9,17,
897,0,27,9,18,
898,0,28,11,17,
899,0,28,9,19,
900,0,29,12,17,
901,0,25,7,18,
902,0,29,12,17,
903,0,29,12,17,
904,0,31,14,17,
905,0,26,10,16,
906,0,27,10,16,1
907,0,26,7,19,
908,0,24,7,17,
909,0,25,8,17,
910,0,23,6,17,
911,0,23,6,17,
912,0,25,7,18,
913,0,22,6,16,
914,0,23,7,15,1
915,0,23,6,17,
916,0,22,6,16,
917,0,24,7,17,
918,0,24,7,17,
919,0,26,8,18,
920,0,25,8,17,
921,0,24,7,17,
922,0,25,6,18,1
923,0,22,6,16,
924,0,22,7,15,
925,0,23,6,17,
926,0,23,7,16,
927,0,24,7,17,
928,0,24,6,18,
929,0,24,7,17,
930,0,22,6,16,
931,0,23,6,17,
932,0,24,7,17,
933,0,23,6,17,
934,0,24,6,18,
935,0,22,6,16,
936,0,24,7,17,
937,0,23,6,16,1
938,0,22,7,15,
939,0,25,6,19,
940,0,23,6,17,
941,0,26,8,18,
942,0,23,7,16,
943,0,24,6,18,
944,0,23,6,17,
945,0,24,7,17,
946,0,22,6,16,
947,0,21,6,15,
948,0,25,8,17,
949,0,22,6,16,
950,0,23,7,16,
951,0,25,6,19,
952,0,26,8,17,1
953,0,24,7,17,
954,0,24,7,17,
955,0,24,6,18,
956,0,23,6,17,
957,0,22,6,16,
958,0,25,7,18,
959,0,24,6,18,
960,0,24,7,17,
961,0,22,6,16,
962,0,21,6,15,
963,0,23,7,16,
964,0,21,6,15,
965,0,25,7,18,
966,0,23,6,17,
967,0,22,6,16,
968,0,25,7,18,
969,0,23,6,17,
970,0,24,7,17,
971,0,24,7,17,
972,0,24,7,17,
973,0,22,6,16,
974,0,21,6,15,
975,0,23,7,16,
976,0,23,7,16,
977,0,22,7,15,
978,0,24,8,16,
979,0,25,9,16,
980,0,24,7,17,
981,0,23,6,17,
982,0,24,7,16,1
983,0,22,6,16,
984,0,24,6,18,
985,0,24,7,17,
986,0,24,7,17,
987,0,24,7,17,
988,0,23,6,17,
989,0,23,7,16,
990,0,23,6,17,
991,0,22,6,16,
992,0,26,7,19,
993,0,24,6,18,
994,0,23,6,17,
995,0,23,7,16,
996,0,21,6,15,
997,0,22,7,15,
998,0,22,6,16,
999,0,22,7,15,
1000,0,24,7,17,
1001,0,23,6,17,
1002,0,23,7,16,
1003,0,23,6,17,
1004,0,22,6,16,
1005,0,24,7,17,
1006,0,23,6,17,
1007,0,23,7,16,
1008,0,23,6,17,
1009,0,24,7,17,
1010,0,22,6,16,
1011,0,22,7,15,
1012,0,24,7,17,
1013,0,25,7,17,1
1014,0,25,7,18,
1015,0,22,6,16,
1016,0,23,7,16,
1017,0,23,7,16,
1018,0,23,6,17,
1019,0,23,7,16,
1020,0,25,7,18,
1021,0,24,8,16,
1022,0,23,6,17,
1023,0,22,6,16,
1024,0,22,6,16,
1025,0,25,7,18,
1026,0,23,6,17,
1027,0,22,6,16,
1028,0,25,7,18,
1029,0,24,6,18,
1030,0,24,7,17,
1031,0,22,7,15,
1032,0,23,7,16,
1033,0,21,6,15,
1034,0,24,7,17,
1035,0,23,7,16,
1036,0,24,6,18,
1037,0,23,6,17,
1038,0,24,7,17,
1039,0,24,8,16,
1040,0,23,6,17,
1041,0,23,6,17,
1042,0,23,7,16,
1043,0,22,6,15,1
1044,0,24,8,16,
1045,0,22,6,16,
1046,0,22,6,16,
1047,0,24,7,17,
1048,0,23,6,17,
1049,0,23,7,16,
1050,0,24,7,17,
1051,0,22,6,16,
1052,0,24,7,17,
1053,0,26,6,20,
1054,0,24,6,18,
1055,0,23,6,17,
1056,0,23,7,16,
1057,0,22,6,16,
1058,0,24,7,17,
1059,0,24,6,18,
1060,0,22,6,16,
1061,0,24,7,17,
1062,0,24,7,17,
1063,0,22,7,15,
1064,0,23,7,16,
1065,0,24,7,17,
1066,0,24,7,17,
1067,0,23,7,16,
1068,0,23,6,17,
1069,0,24,7,17,
1070,0,28,12,16,
1071,0,30,12,18,
1072,0,25,9,16,
1073,0,30,12,17,1
1074,0,31,11,20,
1075,0,27,7,20,
1076,0,31,9,22,
1077,0,30,7,23,
1078,0,31,7,24,
1079,0,30,6,24,
1080,0,34,7,27,
1081,0,33,6,27,
1082,0,33,6,27,
1083,0,35,7,28,
1084,0,36,7,29,
1085,0,36,6,30,
1086,0,35,6,29,
1087,0,38,7,31,
1088,0,38,6,32,
1089,0,38,6,32,
1090,0,41,7,34,
1091,0,40,6,34,
1092,0,39,6,33,
1093,0,40,7,33,
1094,0,41,6,35,
1095,0,42,7,35,
1096,0,43,7,36,
1097,0,42,6,36,
1098,0,43,7,36,
1099,0,43,6,37,
1100,0,44,7,37,
1101,0,45,7,38,
1102,0,44,6,38,
1103,0,46,7,39,
1104,0,47,7,39,1
1105,0,45,6,39,
1106,0,48,7,41,
1107,0,46,6,40,
1108,0,48,7,41,
1109,0,46,6,40,
1110,0,49,7,42,
1111,0,47,6,41,
1112,0,49,7,42,
1113,0,49,6,43,
1114,0,48,6,42,
1115,0,50,7,43,
1116,0,50,6,44,
1117,0,50,7,43,
1118,0,50,6,44,
1119,0,50,6,44,
1120,0,52,7,45,
1121,0,50,6,44,
1122,0,54,7,47,
1123,0,52,6,46,
1124,0,51,6,45,
1125,0,54,7,47,
1126,0,54,6,48,
1127,0,54,7,47,
1128,0,54,7,47,
1129,0,54,6,48,
1130,0,57,9,48,
1131,0,55,6,49,
1132,0,55,7,48,
1133,0,56,7,49,
1134,0,55,6,48,1
1135,0,59,8,51,
1136,0,57,7,50,
1137,0,62,13,49,
1138,0,63,13,50,
1139,0,62,12,50,
1140,0,64,13,51,
1141,0,63,12,51,
1142,0,63,12,51,
1143,0,63,12,51,
1144,0,65,13,52,
1145,0,65,13,52,
1146,0,65,13,52,
1147,0,64,12,52,
1148,0,65,13,52,
1149,0,66,12,54,
1150,0,66,13,53,
1151,0,67,13,54,
1152,0,66,12,54,
1153,0,68,13,55,
1154,0,66,12,54,
1155,0,67,13,54,
1156,0,69,13,56,
1157,0,67,12,55,
1158,0,67,12,55,
1159,0,68,13,55,
1160,0,69,12,57,
1161,0,70,13,57,
1162,0,69,13,56,
1163,0,69,12,57,
1164,0,71,13,57,1
1165,0,70,13,57,
1166,0,70,13,57,
1167,0,70,12,58,
1168,0,70,13,57,
1169,0,70,12,58,
1170,0,71,13,58,
1171,0,71,12,59,
1172,0,72,13,59,
1173,0,72,13,59,
1174,0,71,12,59,
1175,0,72,12,60,
1176,0,72,13,59,
1177,0,71,12,59,
1178,0,72,12,60,
1179,0,74,13,61,
1180,0,73,13,60,
1181,0,73,13,60,
1182,0,74,12,62,
1183,0,75,13,62,
1184,0,75,13,62,
1185,0,73,12,61,
1186,0,75,13,62,
1187,0,74,12,62,
1188,0,75,13,62,
1189,0,74,12,62,
1190,0,75,13,62,
1191,0,75,13,62,
1192,0,76,13,63,
1193,0,76,12,64,
1194,0,75,11,64,
1195,0,77,12,64,1
1196,0,76,12,64,
1197,0,76,12,64,
1198,0,77,13,64,
1199,0,71,6,65,
1200,0,71,7,64,
1201,0,73,7,66,
1202,0,72,6,66,
1203,0,72,7,65,
1204,0,73,7,66,
1205,0,71,6,65,
1206,0,75,7,68,
1207,0,73,6,67,
1208,0,73,7,66,
1209,0,73,6,67,
1210,0,72,6,66,
1211,0,76,7,69,
1212,0,74,6,68,
1213,0,73,6,67,
1214,0,75,7,68,
1215,0,74,6,68,
1216,0,75,7,68,
1217,0,75,6,69,
1218,0,76,7,69,
1219,0,74,6,68,
1220,0,77,7,70,
1221,0,75,6,69,
1222,0,77,7,70,
1223,0,75,6,69,
1224,0,76,7,69,
1225,0,77,6,70,1
1226,0,78,7,71,
1227,0,76,6,70,
1228,0,78,7,71,
1229,0,77,6,71,
1230,0,76,6,70,
1231,0,78,7,71,
1232,0,78,6,72,
1233,0,79,7,72,
1234,0,78,7,71,
1235,0,79,7,72,
1236,0,77,6,71,
1237,0,80,7,73,
1238,0,79,6,73,
1239,0,78,6,72,
1240,0,80,7,73,
1241,0,79,6,73,
1242,0,79,7,72,
1243,0,80,6,74,
1244,0,79,6,73,
1245,0,81,7,74,
1246,0,82,7,75,
1247,0,80,6,74,
1248,0,79,6,73,
1249,0,83,7,76,
1250,0,81,6,75,
1251,0,83,8,75,
1252,0,81,7,74,
1253,0,82,7,75,
1254,0,84,7,77,
1255,0,83,7,75,1
1256,0,83,6,76,1
1257,0,84,7,77,
1258,0,82,6,76,
1259,0,81,6,75,
1260,0,84,7,77,
1261,0,82,7,75,
1262,0,83,6,77,
1263,0,84,7,77,
1264,0,82,6,76,
1265,0,82,6,76,
1266,0,73,7,66,
1267,0,60,6,54,
1268,0,53,6,47,
1269,0,53,7,46,
1270,0,46,6,40,
1271,0,41,6,35,
1272,0,38,6,32,
1273,0,38,7,31,
1274,0,42,6,36,
1275,0,53,7,46,
1276,0,55,6,49,
1277,0,55,7,48,
1278,0,57,7,50,
1279,0,56,7,49,
1280,0,58,7,51,
1281,0,57,7,50,
1282,0,58,7,51,
1283,0,56,6,50,
1284,0,59,7,52,
1285,0,58,6,52,
1286,0,60,7,52,1
1287,0,60,7,53,
1288,0,58,6,52,
1289,0,60,7,53,
1290,0,59,6,53,
1291,0,60,7,53,
1292,0,61,7,54,
1293,0,59,6,53,
1294,0,63,7,56,
1295,0,61,6,55,
1296,0,60,6,54,
1297,0,64,7,57,
1298,0,62,6,56,
1299,0,62,7,55,
1300,0,62,6,56,
1301,0,62,6,56,
1302,0,64,7,57,
1303,0,63,6,57,
1304,0,63,6,57,
1305,0,65,7,58,
1306,0,66,7,59,
1307,0,64,6,58,
1308,0,65,7,58,
1309,0,66,7,59,
1310,0,64,6,58,
1311,0,66,7,59,
1312,0,66,6,60,
1313,0,68,7,61,
1314,0,66,6,60,
1315,0,66,6,60,
1316,0,68,7,60,1
1317,0,68,7,61,
1318,0,67,7,60,
1319,0,68,6,62,
1320,0,69,7,62,
1321,0,67,6,61,
1322,0,68,7,61,
1323,0,69,6,63,
1324,0,70,7,63,
1325,0,68,6,62,
1326,0,70,7,63,
1327,0,69,6,63,
1328,0,70,7,63,
1329,0,70,6,64,
1330,0,70,7,63,
1331,0,71,6,65,
1332,0,71,6,65,
1333,0,71,7,64,
1334,0,72,7,65,
1335,0,73,7,66,
1336,0,71,6,65,
1337,0,72,7,65,
1338,0,72,6,66,
1339,0,71,6,65,
1340,0,75,8,67,
1341,0,73,6,67,
1342,0,74,7,67,
1343,0,74,8,66,
1344,0,74,6,68,
1345,0,75,7,68,
1346,0,73,6,67,
1347,0,76,8,67,1
1348,0,76,7,69,
1349,0,75,7,68,
1350,0,75,6,69,
1351,0,74,6,68,
1352,0,76,7,69,
1353,0,76,7,69,
1354,0,76,6,70,
1355,0,75,6,69,
1356,0,76,7,69,
1357,0,78,7,71,
1358,0,77,6,71,
1359,0,76,6,70,
1360,0,78,7,71,
1361,0,76,6,70,
1362,0,78,7,71,
1363,0,78,6,72,
1364,0,78,7,71,
1365,0,79,7,72,
1366,0,77,6,71,
1367,0,81,7,74,
1368,0,79,6,73,
1369,0,78,6,72,
1370,0,79,7,72,
1371,0,81,7,74,
1372,0,81,7,74,
1373,0,83,7,76,
1374,0,79,6,73,
1375,0,80,7,73,
1376,0,81,6,75,
1377,0,82,7,74,1
1378,0,81,7,74,
1379,0,81,6,75,
1380,0,81,7,74,
1381,0,82,6,76,
1382,0,81,6,75,
1383,0,83,7,76,
1384,0,82,6,76,
1385,0,81,6,75,
1386,0,83,8,75,
1387,0,83,7,76,
1388,0,82,6,76,
1389,0,82,7,75,
1390,0,82,6,76,
1391,0,81,6,75,
1392,0,74,7,67,
1393,0,62,6,56,
1394,0,52,6,46,
1395,0,53,7,46,
1396,0,47,6,41,
1397,0,41,7,34,
1398,0,36,6,30,
1399,0,36,6,30,
1400,0,43,7,36,
1401,0,52,7,45,
1402,0,55,7,48,
1403,0,55,7,48,
1404,0,57,7,50,
1405,0,56,6,50,
1406,0,56,7,49,
1407,0,58,7,50,1
1408,0,58,7,51,
1409,0,56,6,50,
1410,0,59,7,52,
1411,0,58,6,52,
1412,0,57,6,51,
1413,0,60,7,53,
1414,0,58,6,52,
1415,0,59,7,52,
1416,0,59,7,52,
1417,0,60,6,54,
1418,0,59,6,53,
1419,0,61,7,54,
1420,0,61,6,55,
1421,0,60,6,54,
1422,0,62,7,55,
1423,0,61,6,55,
1424,0,64,7,57,
1425,0,62,6,56,
1426,0,63,7,56,
1427,0,62,6,56,
1428,0,64,7,57,
1429,0,63,6,57,
1430,0,63,6,57,
1431,0,65,7,58,
1432,0,65,7,58,
1433,0,65,8,57,
1434,0,65,7,58,
1435,0,65,6,59,
1436,0,65,7,58,
1437,0,67,7,60,
1438,0,68,7,60,1
1439,0,66,7,59,
1440,0,67,7,60,
1441,0,68,7,61,
1442,0,66,6,60,
1443,0,68,7,61,
1444,0,67,7,60,
1445,0,68,6,62,
1446,0,67,6,61,
1447,0,69,7,62,
1448,0,68,7,61,
1449,0,70,7,63,
1450,0,69,7,62,
1451,0,69,6,63,
1452,0,68,6,62,
1453,0,71,7,64,
1454,0,70,6,64,
1455,0,70,7,63,
1456,0,70,6,64,
1457,0,71,6,65,
1458,0,71,7,64,
1459,0,71,6,65,
1460,0,70,6,64,
1461,0,73,7,66,
1462,0,73,7,66,
1463,0,72,7,65,
1464,0,72,6,66,
1465,0,74,7,67,
1466,0,73,6,67,
1467,0,73,7,66,
1468,0,73,6,66,1
1469,0,74,7,67,
1470,0,73,6,67,
1471,0,75,7,68,
1472,0,74,7,67,
1473,0,74,6,68,
1474,0,74,6,68,
1475,0,77,7,70,
1476,0,75,6,69,
1477,0,74,6,68,
1478,0,76,7,69,
1479,0,75,6,69,
1480,0,76,7,69,
1481,0,77,6,71,
1482,0,77,7,70,
1483,0,77,6,71,
1484,0,76,6,70,
1485,0,79,7,72,
1486,0,77,6,71,
1487,0,77,7,70,
1488,0,78,6,72,
1489,0,77,6,71,
1490,0,79,7,72,
1491,0,78,6,72,
1492,0,78,7,71,
1493,0,79,6,73,
1494,0,80,7,73,
1495,0,79,7,72,
1496,0,79,6,73,
1497,0,79,6,73,
1498,0,81,7,73,1
1499,0,81,7,74,
1500,0,80,6,74,
1501,0,82,7,75,
1502,0,82,7,75,
1503,0,81,6,75,
1504,0,81,7,74,
1505,0,82,6,76,
1506,0,81,7,74,
1507,0,82,6,76,
1508,0,81,6,75,
1509,0,82,7,75,
1510,0,82,6,76,
1511,0,81,6,75,
1512,0,84,7,77,
1513,0,82,6,76,
1514,0,81,6,75,
1515,0,83,7,76,
1516,0,81,6,75,
1517,0,80,7,73,
1518,0,67,7,60,
1519,0,55,7,48,
1520,0,52,6,46,
1521,0,51,7,44,
1522,0,40,5,35,
1523,0,32,7,25,
1524,0,26,7,19,
1525,0,25,7,18,
1526,0,29,6,23,
1527,0,40,7,33,
1528,0,40,7,33,
1529,0,41,7,33,1
1530,0,41,6,35,
1531,0,41,6,35,
1532,0,43,8,35,
1533,0,42,6,36,
1534,0,42,6,36,
1535,0,45,7,38,
1536,0,43,6,37,
1537,0,47,7,40,
1538,0,45,6,39,
1539,0,44,6,38,
1540,0,47,7,40,
1541,0,46,6,40,
1542,0,47,7,40,
1543,0,47,6,41,
1544,0,47,6,41,
1545,0,49,7,42,
1546,0,48,6,42,
1547,0,50,7,43,
1548,0,48,6,42,
1549,0,51,7,44,
1550,0,49,6,43,
1551,0,51,7,44,
1552,0,51,6,45,
1553,0,51,7,44,
1554,0,53,7,46,
1555,0,53,7,46,
1556,0,53,6,47,
1557,0,52,6,46,
1558,0,54,7,47,
1559,0,56,8,47,1
1560,0,55,8,47,
1561,0,54,6,48,
1562,0,56,7,49,
1563,0,54,6,48,
1564,0,56,7,49,
1565,0,56,6,50,
1566,0,56,7,49,
1567,0,56,6,50,
1568,0,56,6,50,
1569,0,58,7,51,
1570,0,57,6,51,
1571,0,59,7,52,
1572,0,57,6,51,
1573,0,60,7,53,
1574,0,59,6,53,
1575,0,60,6,54,
1576,0,58,6,52,
1577,0,60,7,53,
1578,0,61,7,54,
1579,0,61,7,54,
1580,0,61,7,54,
1581,0,61,6,55,
1582,0,60,6,54,
1583,0,61,7,54,
1584,0,62,6,56,
1585,0,63,8,55,
1586,0,63,7,56,
1587,0,62,6,56,
1588,0,65,8,57,
1589,0,65,7,57,1
1590,0,62,6,56,
1591,0,65,7,58,
1592,0,65,7,58,
1593,0,65,7,58,
1594,0,65,7,58,
1595,0,65,6,59,
1596,0,64,6,58,
1597,0,66,7,59,
1598,0,66,6,60,
1599,0,65,6,59,
1600,0,67,7,60,
1601,0,65,6,59,
1602,0,67,7,60,
1603,0,67,6,61,
1604,0,71,9,62,
1605,0,68,7,61,
1606,0,67,6,61,
1607,0,70,7,63,
1608,0,67,6,61,
1609,0,70,7,63,
1610,0,69,6,63,
1611,0,69,7,62,
1612,0,69,6,63,
1613,0,68,6,62,
1614,0,71,7,64,
1615,0,74,11,63,
1616,0,70,7,63,
1617,0,70,6,64,
1618,0,70,6,64,
1619,0,71,7,64,
1620,0,72,6,65,1
1621,0,72,7,65,
1622,0,72,7,65,
1623,0,72,7,65,
1624,0,73,7,66,
1625,0,74,7,67,
1626,0,73,6,67,
1627,0,72,6,66,
1628,0,74,7,67,
1629,0,73,6,67,
1630,0,74,7,67,
1631,0,74,6,68,
1632,0,73,6,67,
1633,0,75,7,68,
1634,0,74,6,68,
1635,0,76,7,69,
1636,0,74,6,68,
1637,0,76,7,69,
1638,0,75,6,69,
1639,0,76,7,69,
1640,0,76,6,70,
1641,0,76,7,69,
1642,0,76,6,70,
1643,0,76,6,70,
1644,0,77,7,70,
1645,0,77,7,70,
1646,0,79,8,71,
1647,0,76,6,70,
1648,0,79,7,72,
1649,0,78,6,72,
1650,0,80,7,72,1
1651,0,77,6,71,
1652,0,80,7,73,
1653,0,79,7,72,
1654,0,79,6,73,
1655,0,79,7,72,
1656,0,80,7,73,
1657,0,78,6,72,
1658,0,81,7,74,
1659,0,80,6,74,
1660,0,79,6,73,
1661,0,80,7,73,
1662,0,82,7,75,
1663,0,81,6,75,
1664,0,81,7,74,
1665,0,81,6,75,
1666,0,80,6,74,
1667,0,82,7,75,
1668,0,84,7,77,
1669,0,82,6,76,
1670,0,81,6,75,
1671,0,83,7,76,
1672,0,81,6,75,
1673,0,82,7,75,
1674,0,82,6,76,
1675,0,83,8,75,
1676,0,82,7,75,
1677,0,84,7,77,
1678,0,77,6,71,
1679,0,64,6,58,
1680,0,54,7,46,1
1681,0,53,7,46,
1682,0,48,6,42,
1683,0,40,7,33,
1684,0,31,7,24,
1685,0,24,6,18,
1686,0,23,6,17,
1687,0,31,6,25,
1688,0,40,7,33,
1689,0,39,6,33,
1690,0,42,7,35,
1691,0,41,6,35,
1692,0,42,7,35,
1693,0,42,6,36,
1694,0,42,6,36,
1695,0,45,8,37,
1696,0,44,7,37,
1697,0,45,7,38,
1698,0,44,6,38,
1699,0,46,7,39,
1700,0,46,6,40,
1701,0,46,7,39,
1702,0,47,6,41,
1703,0,46,6,40,
1704,0,49,7,42,
1705,0,48,6,42,
1706,0,53,11,42,
1707,0,50,7,43,
1708,0,48,6,42,
1709,0,52,7,45,
1710,0,50,7,43,
1711,0,51,7,43,1
1712,0,51,6,45,
1713,0,51,6,45,
1714,0,52,7,45,
1715,0,52,7,45,
1716,0,52,6,46,
1717,0,54,7,47,
1718,0,52,6,46,
1719,0,55,7,48,
1720,0,54,6,48,
1721,0,53,6,47,
1722,0,56,7,49,
1723,0,55,6,49,
1724,0,55,7,48,
1725,0,55,6,49,
1726,0,55,6,49,
1727,0,57,7,50,
1728,0,56,6,50,
1729,0,58,8,50,
1730,0,57,6,51,
1731,0,57,6,51,
1732,0,58,7,51,
1733,0,58,6,52,
1734,0,58,7,51,
1735,0,60,7,53,
1736,0,60,7,53,
1737,0,59,7,52,
1738,0,61,8,53,
1739,0,60,6,54,
1740,0,59,6,53,
1741,0,63,7,55,1
1742,0,61,7,54,
1743,0,60,6,54,
1744,0,63,8,55,
1745,0,61,6,55,
1746,0,63,7,56,
1747,0,62,6,56,
1748,0,62,6,56,
1749,0,64,7,57,
1750,0,63,6,57,
1751,0,63,7,56,
1752,0,64,6,58,
1753,0,64,7,57,
1754,0,65,7,58,
1755,0,64,6,58,
1756,0,67,7,60,
1757,0,65,6,59,
1758,0,64,6,58,
1759,0,67,7,60,
1760,0,66,7,59,
1761,0,66,6,60,
1762,0,66,7,59,
1763,0,68,7,61,
1764,0,66,6,60,
1765,0,69,7,62,
1766,0,67,6,61,
1767,0,69,7,62,
1768,0,69,8,61,
1769,0,68,6,62,
1770,0,68,6,62,
1771,0,72,8,63,1
1772,0,69,6,63,
1773,0,69,7,62,
1774,0,70,6,64,
1775,0,69,6,63,
1776,0,70,7,63,
1777,0,70,6,64,
1778,0,71,7,64,
1779,0,72,7,65,
1780,0,70,6,64,
1781,0,72,7,65,
1782,0,71,6,65,
1783,0,71,6,65,
1784,0,73,7,66,
1785,0,72,6,66,
1786,0,72,7,65,
1787,0,73,6,67,
1788,0,72,6,66,
1789,0,74,7,67,
1790,0,74,7,67,
1791,0,74,6,68,
1792,0,73,6,67,
1793,0,75,7,68,
1794,0,74,6,68,
1795,0,74,7,67,
1796,0,75,6,69,
1797,0,76,8,68,
1798,0,76,7,69,
1799,0,76,7,69,
1800,0,76,6,70,
1801,0,77,7,70,
1802,0,76,6,69,1
1803,0,77,7,70,
1804,0,76,6,70,
1805,0,77,7,70,
1806,0,77,6,71,
1807,0,78,7,71,
1808,0,76,6,70,
1809,0,80,7,73,
1810,0,78,6,72,
1811,0,77,6,71,
1812,0,79,7,72,
1813,0,78,6,72,
1814,0,80,7,73,
1815,0,79,7,72,
1816,0,81,8,73,
1817,0,79,7,72,
1818,0,78,6,72,
1819,0,83,9,74,
1820,0,80,6,74,
1821,0,81,7,74,
1822,0,80,7,73,
1823,0,82,7,75,
1824,0,80,6,74,
1825,0,82,7,75,
1826,0,81,6,75,
1827,0,82,7,75,
1828,0,81,6,75,
1829,0,84,8,76,
1830,0,82,7,75,
1831,0,82,6,76,
1832,0,83,8,75,
1833,0,83,7,76,
1834,0,81,6,75,
1835,0,84,7,77,
1836,0,82,6,76,
1837,0,81,6,75,
1838,0,83,7,76,
1839,0,75,6,69,
1840,0,64,7,57,
1841,0,53,6,47,
1842,0,52,6,46,
1843,0,48,7,41,
1844,0,38,6,32,
1845,0,29,6,23,
1846,0,24,7,17,
1847,0,25,6,19,
1848,0,33,6,27,
1849,0,40,7,33,
1850,0,39,6,33,
1851,0,40,7,33,
1852,0,41,6,35,
1853,0,41,6,35,
1854,0,44,7,37,
1855,0,43,6,37,
1856,0,43,7,36,
1857,0,44,6,38,
1858,0,43,6,37,
1859,0,45,7,38,
1860,0,46,7,39,
1861,0,46,6,40,
1862,0,47,7,40,
1863,0,45,6,39,
1864,0,48,7,41,
1865,0,47,7,40,
1866,0,48,6,42,
1867,0,47,6,41,
1868,0,50,7,43,
1869,0,48,6,42,
1870,0,52,7,45,
1871,0,50,6,44,
1872,0,49,6,43,
1873,0,52,7,45,
1874,0,51,6,45,
1875,0,51,7,44,
1876,0,52,6,46,
1877,0,52,7,45,
1878,0,54,7,47,
1879,0,53,6,47,
1880,0,53,7,46,
1881,0,57,9,48,
1882,0,59,12,47,
1883,0,60,13,47,
1884,0,62,13,49,
1885,0,61,13,48,
1886,0,61,13,48,
1887,0,62,13,49,
1888,0,59,10,49,
1889,0,56,6,50,
1890,0,56,6,50,
1891,0,58,7,51,
1892,0,58,8,50,
1893,0,58,7,51,
1894,0,58,6,52,
1895,0,58,7,51,
1896,0,60,7,53,
1897,0,59,6,53,
1898,0,58,6,52,
1899,0,61,7,54,
1900,0,59,6,53,
1901,0,62,7,55,
1902,0,62,6,56,
1903,0,62,7,55,
1904,0,60,6,54,
1905,0,61,7,54,
1906,0,63,6,57,
1907,0,62,7,55,
1908,0,62,6,56,
1909,0,62,6,56,
1910,0,64,7,57,
1911,0,64,7,57,
1912,0,64,6,58,
1913,0,64,7,57,
1914,0,67,10,57,
1915,0,71,13,58,
1916,0,71,12,59,
1917,0,71,12,59,
1918,0,69,11,58,
1919,0,70,12,58,
1920,0,73,13,60,
1921,0,72,13,59,
1922,0,72,13,59,
1923,0,71,12,59,
1924,0,74,13,61,
1925,0,74,13,61,
1926,0,73,13,60,
1927,0,73,11,62,
1928,0,75,13,62,
1929,0,74,13,61,
1930,0,73,12,61,
1931,0,75,13,62,
1932,0,75,12,63,
1933,0,75,13,62,
1934,0,75,13,62,
1935,0,77,13,64,
1936,0,76,12,64,
1937,0,76,13,63,
1938,0,75,12,63,
1939,0,78,13,65,
1940,0,77,13,64,
1941,0,77,13,64,
1942,0,76,12,64,
1943,0,74,10,64,
1944,0,72,7,65,
1945,0,74,7,67,
1946,0,72,6,66,
1947,0,71,6,65,
1948,0,73,7,66,
1949,0,75,7,68,
1950,0,73,6,67,
1951,0,73,7,66,
1952,0,74,6,68,
1953,0,74,7,67,
1954,0,75,7,68,
1955,0,74,7,67,
1956,0,76,7,69,
1957,0,74,6,68,
1958,0,76,7,69,
1959,0,75,6,69,
1960,0,75,7,68,
1961,0,76,6,70,
1962,0,75,6,69,
1963,0,78,7,71,
1964,0,76,6,70,
1965,0,75,6,69,
1966,0,77,7,70,
1967,0,78,7,71,
1968,0,77,6,71,
1969,0,77,7,70,
1970,0,78,6,72,
1971,0,78,7,71,
1972,0,80,7,73,
1973,0,78,6,72,
1974,0,78,7,71,
1975,0,79,6,73,
1976,0,78,6,72,
1977,0,80,7,73,
1978,0,79,7,72,
1979,0,80,8,72,
1980,0,80,6,74,
1981,0,80,6,74,
1982,0,81,7,74,
1983,0,81,8,73,
1984,0,81,6,75,
1985,0,80,6,74,
1986,0,81,7,74,
1987,0,83,7,76,
1988,0,81,6,75,
1989,0,80,6,74,
1990,0,84,7,77,
1991,0,82,6,76,
1992,0,82,7,75,
1993,0,82,6,76,
1994,0,81,6,75,
1995,0,83,7,76,
1996,0,81,6,75,
1997,0,83,7,76,
1998,0,81,6,75,
1999,0,83,7,76,
2000,0,75,6,69,
2001,0,64,7,57,
2002,0,53,6,47,
2003,0,52,6,46,
2004,0,48,7,41,
2005,0,38,6,32,
2006,0,28,6,22,
2007,0,25,7,18,
2008,0,25,6,19,
2009,0,36,7,29,
2010,0,38,6,32,
2011,0,42,7,35,
2012,0,40,6,34,
2013,0,41,7,34,
2014,0,42,6,36,
2015,0,41,6,35,
2016,0,45,7,38,
2017,0,44,7,37,
2018,0,43,6,37,
2019,0,45,7,38,
2020,0,44,6,38,
2021,0,45,7,38,
2022,0,46,6,40,
2023,0,46,7,39,
2024,0,47,6,41,
2025,0,47,6,41,
2026,0,47,7,40,
2027,0,48,6,42,
2028,0,47,6,41,
2029,0,50,7,43,
2030,0,48,6,42,
2031,0,49,7,42,
2032,0,50,6,44,
2033,0,49,6,43,
2034,0,53,7,46,
2035,0,51,6,45,
2036,0,51,7,44,
2037,0,52,6,46,
2038,0,52,7,45,
2039,0,53,7,46,
2040,0,54,7,47,
2041,0,53,6,47,
2042,0,53,6,47,
2043,0,55,7,48,
2044,0,55,7,48,
2045,0,55,6,49,
2046,0,56,7,49,
2047,0,56,7,49,
2048,0,56,7,49,
2049,0,56,6,50,
2050,0,55,6,49,
2051,0,59,7,52,
2052,0,57,6,51,
2053,0,57,7,50,
2054,0,59,7,52,
2055,0,57,6,51,
2056,0,59,7,52,
2057,0,59,6,53,
2058,0,59,7,52,
2059,0,59,6,53,
2060,0,59,6,53,
2061,0,60,7,53,
2062,0,60,6,54,
2063,0,61,7,54,
2064,0,62,7,55,
2065,0,60,6,54,
2066,0,62,7,55,
2067,0,62,6,56,
2068,0,61,6,55,
2069,0,64,8,56,
2070,0,64,6,58,
2071,0,62,6,56,
2072,0,63,7,56,
2073,0,65,7,58,
2074,0,64,6,58,
2075,0,64,7,57,
2076,0,64,6,58,
2077,0,65,6,59,
2078,0,65,7,58,
2079,0,65,7,58,
2080,0,65,6,59,
2081,0,65,6,59,
2082,0,67,7,60,
2083,0,66,6,60,
2084,0,66,7,59,
2085,0,66,6,60,
2086,0,68,7,61,
2087,0,67,6,61,
2088,0,67,7,60,
2089,0,67,6,61,
2090,0,69,7,62,
2091,0,67,6,61,
2092,0,71,7,64,
2093,0,69,7,62,
2094,0,69,6,63,
2095,0,68,6,62,
2096,0,70,7,63,
2097,0,70,6,64,
2098,0,69,6,63,
2099,0,71,7,64,
2100,0,73,8,65,
2101,0,71,6,65,
2102,0,71,7,64,
2103,0,71,6,65,
2104,0,72,7,65,
2105,0,73,7,66,
2106,0,72,7,65,
2107,0,73,7,66,
2108,0,71,6,65,
2109,0,74,7,67,
2110,0,73,6,67,
2111,0,73,7,66,
2112,0,73,6,67,
2113,0,74,6,68,
2114,0,74,7,67,
2115,0,74,6,68,
2116,0,73,6,67,
2117,0,75,7,68,
2118,0,75,6,69,
2119,0,76,7,69,
2120,0,75,7,68,
2121,0,75,6,69,
2122,0,76,6,70,
2123,0,76,7,69,
2124,0,76,6,70,
2125,0,75,6,69,
2126,0,77,7,70,
2127,0,77,6,71,
2128,0,77,7,70,
2129,0,77,6,71,
2130,0,78,7,71,
2131,0,78,6,72,
2132,0,78,7,71,
2133,0,78,6,72,
2134,0,77,6,71,
2135,0,80,8,72,
2136,0,79,6,73,
2137,0,79,7,72,
2138,0,78,6,72,
2139,0,80,7,73,
2140,0,79,6,73,
2141,0,79,6,73,
2142,0,81,7,74,
2143,0,79,6,73,
2144,0,80,7,73,
2145,0,80,6,74,
2146,0,81,7,74,
2147,0,81,6,75,
2148,0,80,6,74,
2149,0,83,7,76,
2150,0,81,6,75,
2151,0,81,6,75,
2152,0,83,7,76,
2153,0,82,6,76,
2154,0,82,7,75,
2155,0,82,6,76,
2156,0,81,6,75,
2157,0,83,7,76,
2158,0,82,6,76,
2159,0,81,6,75,
2160,0,83,8,75,
2161,0,76,8,68,
2162,0,63,6,57,
2163,0,54,7,47,
2164,0,52,6,46,
2165,0,48,8,40,
2166,0,38,6,32,
2167,0,30,7,23,
2168,0,25,7,18,
2169,0,25,6,19,
2170,0,37,7,30,
2171,0,38,6,32,
2172,0,42,7,35,
2173,0,40,6,34,
2174,0,41,7,34,
2175,0,43,7,36,
2176,0,41,6,35,
2177,0,45,7,38,
2178,0,43,6,37,
2179,0,43,6,37,
2180,0,46,7,39,
2181,0,45,6,39,
2182,0,46,7,39,
2183,0,46,7,39,
2184,0,47,7,40,
2185,0,45,6,39,
2186,0,48,7,41,
2187,0,47,6,41,
2188,0,47,6,41,
2189,0,48,7,41,
2190,0,49,6,43,
2191,0,51,8,43,
2192,0,48,6,42,
2193,0,51,7,44,
2194,0,49,6,43,
2195,0,51,7,44,
2196,0,51,6,45,
2197,0,50,6,44,
2198,0,52,7,45,
2199,0,52,6,46,
2200,0,52,6,46,
2201,0,54,7,47,
2202,0,52,6,46,
2203,0,56,7,49,
2204,0,54,6,48,
2205,0,53,6,47,
2206,0,57,7,50,
2207,0,55,6,49,
2208,0,57,7,50,
2209,0,59,9,50,
2210,0,56,7,49,
2211,0,56,6,50,
2212,0,56,6,50,
2213,0,58,7,51,
2214,0,57,6,51,
2215,0,57,6,51,
2216,0,59,7,52,
2217,0,57,6,51,
2218,0,59,7,52,
2219,0,59,6,53,
2220,0,59,7,52,
2221,0,60,7,53,
2222,0,60,7,53,
2223,0,62,7,55,
2224,0,62,7,55,
2225,0,60,6,54,
2226,0,61,7,54,
2227,0,61,7,54,
2228,0,62,6,56,
2229,0,63,7,56,
2230,0,61,6,55,
2231,0,64,7,57,
2232,0,63,6,57,
2233,0,62,6,56,
2234,0,64,7,57,
2235,0,64,6,58,
2236,0,64,7,57,
2237,0,64,6,58,
2238,0,64,6,58,
2239,0,66,7,59,
2240,0,65,6,59,
2241,0,65,7,58,
2242,0,66,6,60,
2243,0,67,7,60,
2244,0,66,6,60,
2245,0,66,7,59,
2246,0,67,6,61,
2247,0,66,6,60,
2248,0,68,7,61,
2249,0,67,6,61,
2250,0,68,7,61,
2251,0,68,7,61,
2252,0,70,7,63,
2253,0,70,7,63,
2254,0,69,7,62,
2255,0,68,6,62,
2256,0,71,8,63,
2257,0,69,6,63,
2258,0,70,7,63,
2259,0,70,6,64,
2260,0,69,6,63,
2261,0,73,7,66,
2262,0,71,6,65,
2263,0,71,7,64,
2264,0,72,7,65,
2265,0,70,6,64,
2266,0,73,7,66,
2267,0,72,6,66,
2268,0,72,7,65,
2269,0,72,6,66,
2270,0,73,6,67,
2271,0,73,7,66,
2272,0,73,6,67,
2273,0,72,6,66,
2274,0,75,7,68,
2275,0,74,6,68,
2276,0,74,7,67,
2277,0,74,6,68,
2278,0,73,6,67,
2279,0,77,7,70,
2280,0,75,6,69,
2281,0,74,6,68,
2282,0,75,7,68,
2283,0,77,7,70,
2284,0,76,7,69,
2285,0,76,6,70,
2286,0,76,7,69,
2287,0,78,8,70,
2288,0,77,6,71,
2289,0,78,7,71,
2290,0,76,6,70,
2291,0,78,7,71,
2292,0,78,6,72,
2293,0,78,7,71,
2294,0,78,6,72,
2295,0,77,6,71,
2296,0,79,7,72,
2297,0,79,6,73,
2298,0,78,6,72,
2299,0,80,7,73,
2300,0,79,6,73,
2301,0,79,7,72,
2302,0,80,6,74,
2303,0,79,6,73,
2304,0,81,7,74,
2305,0,82,7,75,
2306,0,80,6,74,
2307,0,80,6,74,
2308,0,83,7,76,
2309,0,81,6,75,
2310,0,81,7,74,
2311,0,82,7,75,
2312,0,83,7,76,
2313,0,82,6,76,
2314,0,81,6,75,
2315,0,83,7,76,
2316,0,81,6,75,
2317,0,85,8,77,
2318,0,83,8,75,
2319,0,82,6,76,
2320,0,81,6,75,
2321,0,83,7,76,
2322,0,77,6,71,
2323,0,65,7,58,
2324,0,53,6,47,
2325,0,52,6,46,
2326,0,49,7,42,
2327,0,39,5,34,
2328,0,31,7,24,
2329,0,25,6,19,
2330,0,23,6,17,
2331,0,34,7,27,
2332,0,40,7,33,
2333,0,42,7,35,
2334,0,40,6,34,
2335,0,42,7,35,
2336,0,42,6,36,
2337,0,42,7,35,
2338,0,43,6,37,
2339,0,42,6,36,
2340,0,45,7,38,
2341,0,43,6,37,
2342,0,48,9,39,
2343,0,45,7,38,
2344,0,46,6,40,
2345,0,47,7,40,
2346,0,46,7,39,
2347,0,47,7,40,
2348,0,47,6,41,
2349,0,47,6,41,
2350,0,50,8,42,
2351,0,49,6,43,
2352,0,51,8,43,
2353,0,48,6,42,
2354,0,52,7,45,
2355,0,50,6,44,
2356,0,52,7,45,
2357,0,51,6,45,
2358,0,51,7,44,
2359,0,52,6,46,
2360,0,51,6,45,
2361,0,55,7,48,
2362,0,53,6,47,
2363,0,52,6,46,
2364,0,54,7,47,
2365,0,55,7,48,
2366,0,54,6,48,
2367,0,55,7,48,
2368,0,55,6,49,
2369,0,54,6,48,
2370,0,58,7,51,
2371,0,56,6,50,
2372,0,55,6,49,
2373,0,58,7,51,
2374,0,57,6,51,
2375,0,57,7,50,
2376,0,58,6,52,
2377,0,59,7,52,
2378,0,58,7,51,
2379,0,60,7,53,
2380,0,63,9,54,
2381,0,58,6,52,
2382,0,62,7,55,
2383,0,60,6,54,
2384,0,60,7,53,
2385,0,61,6,55,
2386,0,60,6,54,
2387,0,62,7,55,
2388,0,61,6,55,
2389,0,61,6,55,
2390,0,63,7,56,
2391,0,62,6,56,
2392,0,63,7,56,
2393,0,63,6,57,
2394,0,63,7,56,
2395,0,65,7,58,
2396,0,66,7,59,
2397,0,64,6,58,
2398,0,63,6,57,
2399,0,67,7,60,
2400,0,65,6,59,
2401,0,65,7,58,
2402,0,65,6,59,
2403,0,67,7,60,
2404,0,65,6,59,
2405,0,66,7,59,
2406,0,66,6,60,
2407,0,68,7,61,
2408,0,69,7,62,
2409,0,68,7,61,
2410,0,66,6,60,
2411,0,68,7,61,
2412,0,69,7,62,
2413,0,68,6,62,
2414,0,69,7,62,
2415,0,69,6,63,
2416,0,68,6,62,
2417,0,71,7,64,
2418,0,70,6,64,
2419,0,69,6,63,
2420,0,71,7,64,
2421,0,69,6,63,
2422,0,70,7,63,
2423,0,71,6,65,
2424,0,70,6,64,
2425,0,72,7,65,
2426,0,72,7,65,
2427,0,71,6,65,
2428,0,73,7,66,
2429,0,71,6,65,
2430,0,72,7,65,
2431,0,73,6,67,
2432,0,73,7,66,
2433,0,74,8,66,
2434,0,74,7,67,
2435,0,74,6,68,
2436,0,74,7,67,
2437,0,75,7,68,
2438,0,73,6,67,
2439,0,74,7,67,
2440,0,75,7,68,
2441,0,74,6,68,
2442,0,76,7,69,
2443,0,76,7,69,
2444,0,76,6,70,
2445,0,75,6,69,
2446,0,77,7,70,
2447,0,76,6,70,
2448,0,76,7,69,
2449,0,77,6,71,
2450,0,76,6,70,
2451,0,78,7,71,
2452,0,76,6,70,
2453,0,78,7,71,
2454,0,78,6,72,
2455,0,77,6,71,
2456,0,79,7,72,
2457,0,78,7,71,
2458,0,79,6,73,
2459,0,78,6,72,
2460,0,80,7,73,
2461,0,79,6,73,
2462,0,79,7,72,
2463,0,80,6,74,
2464,0,80,6,74,
2465,0,81,7,74,
2466,0,80,7,73,
2467,0,80,6,74,
2468,0,81,7,74,
2469,0,83,8,75,
2470,0,81,6,75,
2471,0,82,8,74,
2472,0,81,6,75,
2473,0,82,6,76,
2474,0,82,7,75,
2475,0,82,6,76,
2476,0,81,6,75,
2477,0,83,7,76,
2478,0,82,6,76,
2479,0,82,7,75,
2480,0,82,6,76,
2481,0,81,6,75,
2482,0,82,7,75,
2483,0,76,6,70,
2484,0,64,6,58,
2485,0,54,7,47,
2486,0,53,6,47,
2487,0,56,13,43,
2488,0,46,12,34,
2489,0,37,12,25,
2490,0,31,11,20,
2491,0,36,13,23,
2492,0,45,13,32,
2493,0,44,12,32,
2494,0,46,12,34,
2495,0,47,13,34,
2496,0,46,12,34,
2497,0,47,13,34,
2498,0,49,13,36,
2499,0,49,13,36,
2500,0,49,13,36,
2501,0,49,12,37,
2502,0,51,13,38,
2503,0,51,13,38,
2504,0,51,13,38,
2505,0,51,12,39,
2506,0,51,12,39,
2507,0,51,12,39,
2508,0,53,13,40,
2509,0,53,12,41,
2510,0,55,13,42,
2511,0,54,13,41,
2512,0,53,11,42,
2513,0,56,13,43,
2514,0,56,13,43,
2515,0,56,13,43,
2516,0,56,12,44,
2517,0,58,13,45,
2518,0,57,13,44,
2519,0,57,13,44,
2520,0,59,13,46,
2521,0,58,13,45,
2522,0,58,13,45,
2523,0,57,11,46,
2524,0,58,11,47,
2525,0,53,6,47,
2526,0,54,7,47,
2527,0,56,8,48,
2528,0,55,7,48,
2529,0,55,6,49,
2530,0,56,7,49,
2531,0,55,6,49,
2532,0,57,7,50,
2533,0,56,7,49,
2534,0,56,6,50,
2535,0,59,7,52,
2536,0,58,7,51,
2537,0,57,6,51,
2538,0,58,7,51,
2539,0,58,6,52,
2540,0,59,7,52,
2541,0,60,7,53,
2542,0,58,6,52,
2543,0,62,7,55,
2544,0,60,6,54,
2545,0,59,6,53,
2546,0,61,7,54,
2547,0,61,6,55,
2548,0,61,7,54,
2549,0,62,7,55,
2550,0,61,6,55,
2551,0,64,7,57,
2552,0,62,6,56,
2553,0,62,6,56,
2554,0,63,7,56,
2555,0,63,7,56,
2556,0,63,7,56,
2557,0,64,6,58,
2558,0,63,6,57,
2559,0,66,8,58,
2560,0,65,6,59,
2561,0,65,7,58,
2562,0,65,6,59,
2563,0,65,6,59,
2564,0,67,7,60,
2565,0,65,6,59,
2566,0,66,7,59,
2567,0,67,7,60,
2568,0,67,7,60,
2569,0,67,6,61,
2570,0,67,7,60,
2571,0,67,6,61,
2572,0,68,6,62,
2573,0,68,7,61,
2574,0,68,6,62,
2575,0,67,6,61,
2576,0,70,7,63,
2577,0,69,6,63,
2578,0,69,7,62,
2579,0,69,7,62,
2580,0,70,6,64,
2581,0,70,6,64,
2582,0,70,7,63,
2583,0,71,7,64,
2584,0,70,6,64,
2585,0,72,7,65,
2586,0,71,6,65,
2587,0,71,7,64,
2588,0,72,6,66,
2589,0,73,7,66,
2590,0,72,6,66,
2591,0,71,6,65,
2592,0,74,7,67,
2593,0,72,6,66,
2594,0,75,7,68,
2595,0,73,6,67,
2596,0,73,7,66,
2597,0,75,7,68,
2598,0,73,6,67,
2599,0,76,7,69,
2600,0,74,6,68,
2601,0,74,6,68,
2602,0,76,7,69,
2603,0,75,6,69,
2604,0,75,7,68,
2605,0,76,6,70,
2606,0,75,6,69,
2607,0,77,7,70,
2608,0,76,7,69,
2609,0,76,6,70,
2610,0,77,7,70,
2611,0,78,7,71,
2612,0,76,6,70,
2613,0,78,7,71,
2614,0,77,6,71,
2615,0,79,8,71,
2616,0,78,6,72,
2617,0,77,6,71,
2618,0,80,7,73,
2619,0,79,6,73,
2620,0,80,7,73,
2621,0,78,6,72,
2622,0,79,7,72,
2623,0,79,7,72,
2624,0,80,6,74,
2625,0,79,6,73,
2626,0,81,7,74,
2627,0,79,6,73,
2628,0,81,7,74,
2629,0,81,7,74,
2630,0,81,6,75,
2631,0,80,6,74,
2632,0,82,7,75,
2633,0,81,6,75,
2634,0,82,7,75,
2635,0,82,6,76,
2636,0,81,6,75,
2637,0,84,7,77,
2638,0,81,6,75,
2639,0,83,7,76,
2640,0,81,6,75,
2641,0,84,7,77,
2642,0,82,6,76,
2643,0,82,7,75,
2644,0,80,6,74,
2645,0,68,6,62,
2646,0,58,7,51,
2647,0,53,6,47,
2648,0,49,6,43,
2649,0,44,6,38,
2650,0,35,7,28,
2651,0,25,6,19,
2652,0,23,7,16,
2653,0,28,7,21,
2654,0,39,7,32,
2655,0,41,7,34,
2656,0,40,6,34,
2657,0,40,6,34,
2658,0,42,7,35,
2659,0,41,6,35,
2660,0,43,7,36,
2661,0,43,6,37,
2662,0,43,7,36,
2663,0,44,6,38,
2664,0,43,6,37,
2665,0,47,7,40,
2666,0,45,6,39,
2667,0,45,6,39,
2668,0,47,7,40,
2669,0,49,7,42,
2670,0,47,6,41,
2671,0,48,7,41,
2672,0,48,6,42,
2673,0,47,6,41,
2674,0,51,7,44,
2675,0,49,6,43,
2676,0,50,7,43,
2677,0,50,6,44,
2678,0,50,6,44,
2679,0,51,7,44,
2680,0,52,7,45,
2681,0,52,6,46,
2682,0,52,7,45,
2683,0,53,7,46,
2684,0,55,7,48,
2685,0,53,6,47,
2686,0,53,6,47,
2687,0,55,7,48,
2688,0,55,7,48,
2689,0,54,6,48,
2690,0,56,7,49,
2691,0,54,6,48,
2692,0,56,7,49,
2693,0,56,6,50,
2694,0,55,6,49,
2695,0,57,7,50,
2696,0,57,6,51,
2697,0,56,6,50,
2698,0,59,7,52,
2699,0,57,6,51,
2700,0,60,7,53,
2701,0,59,6,53,
2702,0,58,6,52,
2703,0,61,7,54,
2704,0,60,6,54,
2705,0,62,8,54,
2706,0,62,8,54,
2707,0,66,13,53,
2708,0,67,13,54,
2709,0,65,11,54,
2710,0,67,13,54,
2711,0,69,13,56,
2712,0,68,13,55,
2713,0,68,12,56,
2714,0,70,13,57,
2715,0,70,13,57,
2716,0,68,12,56,
2717,0,70,13,57,
2718,0,70,13,57,
2719,0,68,12,56,
2720,0,67,10,57,
2721,0,70,13,57,
2722,0,71,12,59,
2723,0,71,13,58,
2724,0,71,12,59,
2725,0,73,13,60,
2726,0,73,13,60,
2727,0,71,12,59,
2728,0,73,13,60,
2729,0,73,13,60,
2730,0,73,13,60,
2731,0,73,13,60,
2732,0,74,13,61,
2733,0,75,13,62,
2734,0,74,13,61,
2735,0,74,12,62,
2736,0,75,13,62,
2737,0,75,12,63,
2738,0,75,13,62,
2739,0,76,13,63,
2740,0,75,13,62,
2741,0,76,13,63,
2742,0,75,12,63,
2743,0,77,13,64,
2744,0,77,13,64,
2745,0,76,12,64,
2746,0,77,12,65,
2747,0,78,13,65,
2748,0,78,13,65,
2749,0,77,12,65,
2750,0,79,13,66,
2751,0,77,12,65,
2752,0,78,13,65,
2753,0,79,13,66,
2754,0,80,13,67,
2755,0,80,13,67,
2756,0,79,13,66,
2757,0,79,12,67,
2758,0,81,13,68,
2759,0,81,13,68,
2760,0,79,12,67,
2761,0,81,13,68,
2762,0,81,13,68,
2763,0,78,11,67,
2764,0,81,13,68,
2765,0,82,13,69,
2766,0,81,12,69,
2767,0,82,13,69,
2768,0,82,12,70,
2769,0,83,13,70,
2770,0,83,13,70,
2771,0,82,12,70,
2772,0,84,13,71,
2773,0,83,13,70,
2774,0,83,13,70,
2775,0,83,13,70,
2776,0,85,13,72,
2777,0,84,13,71,
2778,0,84,13,71,
2779,0,84,12,72,
2780,0,85,13,72,
2781,0,86,13,73,
2782,0,84,12,72,
2783,0,86,13,73,
2784,0,85,13,72,
2785,0,85,13,72,
2786,0,86,13,73,
2787,0,87,13,74,
2788,0,85,12,73,
2789,0,86,13,73,
2790,0,87,12,75,
2791,0,88,13,75,
2792,0,86,12,74,
2793,0,86,12,74,
2794,0,88,13,75,
2795,0,88,13,75,
2796,0,87,12,75,
2797,0,87,11,76,
2798,0,82,6,76,
2799,0,82,7,75,
2800,0,82,6,76,
2801,0,82,6,76,
2802,0,82,7,75,
2803,0,82,6,76,
2804,0,81,6,75,
2805,0,83,7,76,
2806,0,75,6,69,
2807,0,63,7,56,
2808,0,53,6,47,
2809,0,52,6,46,
2810,0,48,7,41,
2811,0,36,5,31,
2812,0,30,7,23,
2813,0,24,6,18,
2814,0,23,6,17,
2815,0,37,7,30,
2816,0,38,6,32,
2817,0,42,7,35,
2818,0,40,6,34,
2819,0,41,6,35,
2820,0,42,7,35,
2821,0,42,6,36,
2822,0,45,7,38,
2823,0,43,6,37,
2824,0,44,7,37,
2825,0,44,6,38,
2826,0,44,6,38,
2827,0,46,7,39,
2828,0,46,7,39,
2829,0,46,6,40,
2830,0,47,7,40,
2831,0,47,6,41,
2832,0,46,6,40,
2833,0,49,7,42,
2834,0,48,6,42,
2835,0,49,7,42,
2836,0,49,6,43,
2837,0,49,6,43,
2838,0,51,7,44,
2839,0,49,6,43,
2840,0,52,7,45,
2841,0,51,6,45,
2842,0,51,6,45,
2843,0,53,7,46,
2844,0,51,6,45,
2845,0,54,7,47,
2846,0,53,6,47,
2847,0,55,7,48,
2848,0,54,6,48,
2849,0,53,6,47,
2850,0,56,7,49,
2851,0,54,6,48,
2852,0,57,7,50,
2853,0,56,6,50,
2854,0,56,7,49,
2855,0,56,6,50,
2856,0,56,6,50,
2857,0,58,7,51,
2858,0,59,7,52,
2859,0,57,6,51,
2860,0,59,7,52,
2861,0,58,6,52,
2862,0,60,7,53,
2863,0,59,6,53,
2864,0,58,6,52,
2865,0,61,8,53,
2866,0,59,6,53,
2867,0,62,7,55,
2868,0,60,6,54,
2869,0,61,7,54,
2870,0,61,6,55,
2871,0,60,6,54,
2872,0,63,7,56,
2873,0,62,6,56,
2874,0,65,9,56,
2875,0,68,13,55,
2876,0,69,13,56,
2877,0,68,12,56,
2878,0,69,13,56,
2879,0,71,13,58,
2880,0,70,13,57,
2881,0,71,13,58,
2882,0,70,12,58,
2883,0,72,13,59,
2884,0,70,12,58,
2885,0,71,13,58,
2886,0,72,13,59,
2887,0,72,13,59,
2888,0,72,13,59,
2889,0,71,12,59,
2890,0,74,13,61,
2891,0,74,13,61,
2892,0,73,13,60,
2893,0,73,12,61,
2894,0,75,13,62,
2895,0,74,13,61,
2896,0,73,12,61,
2897,0,74,13,61,
2898,0,76,13,63,
2899,0,75,13,62,
2900,0,75,13,62,
2901,0,75,12,63,
2902,0,77,13,64,
2903,0,77,13,64,
2904,0,75,12,63,
2905,0,77,13,64,
2906,0,78,13,65,
2907,0,77,13,64,
2908,0,76,12,64,
2909,0,77,13,64,
2910,0,79,13,66,
2911,0,78,13,65,
2912,0,79,13,66,
2913,0,78,12,66,
2914,0,79,13,66,
2915,0,79,13,66,
2916,0,79,13,66,
2917,0,79,12,67,
2918,0,79,13,66,
2919,0,80,13,67,
2920,0,80,13,67,
2921,0,80,12,68,
2922,0,81,13,68,
2923,0,81,13,68,
2924,0,80,12,68,
2925,0,82,13,69,
2926,0,81,13,68,
2927,0,81,13,68,
2928,0,82,13,69,
2929,0,83,13,70,
2930,0,83,13,70,
2931,0,82,13,69,
2932,0,83,12,71,
2933,0,83,12,71,
2934,0,84,13,71,
2935,0,82,12,70,
2936,0,83,11,72,
2937,0,79,8,71,
2938,0,78,6,72,
2939,0,78,7,71,
2940,0,78,6,72,
2941,0,78,6,72,
2942,0,79,7,72,
2943,0,79,6,73,
2944,0,80,7,73,
2945,0,79,7,72,
2946,0,79,6,73,
2947,0,79,6,73,
2948,0,82,7,75,
2949,0,80,6,74,
2950,0,80,7,73,
2951,0,81,6,75,
2952,0,81,7,74,
2953,0,81,7,74,
2954,0,82,7,75,
2955,0,81,6,75,
2956,0,83,7,76,
2957,0,82,7,75,
2958,0,82,6,76,
2959,0,82,7,75,
2960,0,82,6,76,
2961,0,81,6,75,
2962,0,84,7,77,
2963,0,82,6,76,
2964,0,82,7,75,
2965,0,82,6,76,
2966,0,82,7,75,
2967,0,73,6,67,
2968,0,61,6,55,
2969,0,55,7,48,
2970,0,52,6,46,
2971,0,47,7,40,
2972,0,36,5,31,
2973,0,30,7,23,
2974,0,22,6,16,
2975,0,25,7,18,
2976,0,39,6,33,
2977,0,38,6,32,
2978,0,41,7,34,
2979,0,41,6,35,
2980,0,42,7,35,
2981,0,43,7,36,
2982,0,44,9,35,
2983,0,42,6,36,
2984,0,44,7,37,
2985,0,44,6,38,
2986,0,46,7,39,
2987,0,45,6,39,
2988,0,46,7,39,
2989,0,46,7,39,
2990,0,47,7,40,
2991,0,46,6,40,
2992,0,48,7,41,
2993,0,48,6,42,
2994,0,49,7,42,
2995,0,48,6,42,
2996,0,49,7,42,
2997,0,49,6,43,
2998,0,51,7,44,
2999,0,50,6,44,
3000,0,52,7,45,
3001,0,50,6,44,
3002,0,53,8,45,
3003,0,51,6,45,
3004,0,54,7,47,
3005,0,52,7,45,
3006,0,53,6,47,
3007,0,53,7,46,
3008,0,54,6,48,
3009,0,54,7,47,
3010,0,55,7,48,
3011,0,55,6,49,
3012,0,55,7,48,
3013,0,55,6,49,
3014,0,57,8,49,
3015,0,56,6,50,
3016,0,57,7,50,
3017,0,59,7,52,
3018,0,57,6,51,
3019,0,57,7,50,
3020,0,58,7,51,
3021,0,58,6,52,
3022,0,58,7,51,
3023,0,59,6,53,
3024,0,58,6,52,
3025,0,61,7,54,
3026,0,60,6,54,
3027,0,60,7,53,
3028,0,61,7,54,
3029,0,59,6,53,
3030,0,62,7,55,
3031,0,61,6,55,
3032,0,62,7,55,
3033,0,61,6,55,
3034,0,64,7,57,
3035,0,62,6,56,
3036,0,64,8,56,
3037,0,63,6,57,
3038,0,62,6,56,
3039,0,64,7,57,
3040,0,63,6,57,
3041,0,64,7,57,
3042,0,64,6,58,
3043,0,63,6,57,
3044,0,65,7,58,
3045,0,65,6,59,
3046,0,65,7,58,
3047,0,67,7,60,
3048,0,65,6,59,
3049,0,67,7,60,
3050,0,66,6,60,
3051,0,66,6,60,
3052,0,67,7,60,
3053,0,67,7,60,
3054,0,67,6,61,
3055,0,68,7,61,
3056,0,69,7,62,
3057,0,67,6,61,
3058,0,69,7,62,
3059,0,69,6,63,
3060,0,68,6,62,
3061,0,70,7,63,
3062,0,69,7,62,
3063,0,70,6,64,
3064,0,71,7,64,
3065,0,69,6,63,
3066,0,71,7,64,
3067,0,70,6,64,
3068,0,71,7,64,
3069,0,71,7,64,
3070,0,73,8,65,
3071,0,71,6,65,
3072,0,72,7,65,
3073,0,72,6,66,
3074,0,73,8,65,
3075,0,74,8,66,
3076,0,74,7,67,
3077,0,73,6,67,
3078,0,73,7,66,
3079,0,73,7,66,
3080,0,75,7,68,
3081,0,74,6,68,
3082,0,74,7,67,
3083,0,74,6,68,
3084,0,74,6,68,
3085,0,76,7,69,
3086,0,75,6,69,
3087,0,74,6,68,
3088,0,77,7,70,
3089,0,75,6,69,
3090,0,76,7,69,
3091,0,76,6,70,
3092,0,76,7,69,
3093,0,77,6,71,
3094,0,76,6,70,
3095,0,79,7,72,
3096,0,77,6,71,
3097,0,80,7,73,
3098,0,77,6,71,
3099,0,79,7,72,
3100,0,78,6,72,
3101,0,78,7,71,
3102,0,79,6,73,
3103,0,78,6,72,
3104,0,81,7,74,
3105,0,79,6,73,
3106,0,78,6,72,
3107,0,81,7,74,
3108,0,79,6,73,
3109,0,80,7,73,
3110,0,80,6,74,
3111,0,80,7,73,
3112,0,80,6,74,
3113,0,83,7,76,
3114,0,81,6,75,
3115,0,80,6,74,
3116,0,82,7,75,
3117,0,81,6,75,
3118,0,82,7,75,
3119,0,82,6,76,
3120,0,82,7,75,
3121,0,81,6,75,
3122,0,85,8,77,
3123,0,82,7,75,
3124,0,81,6,75,
3125,0,83,7,76,
3126,0,81,6,75,
3127,0,80,7,73,
3128,0,68,7,61,
3129,0,54,6,48,
3130,0,54,6,48,
3131,0,48,6,42,
3132,0,40,6,34,
3133,0,31,6,25,
3134,0,26,7,19,
3135,0,26,7,19,
3136,0,32,6,26,
3137,0,39,7,32,
3138,0,40,6,34,
3139,0,41,7,34,
3140,0,40,6,34,
3141,0,41,7,34,
3142,0,42,6,36,
3143,0,43,7,36,
3144,0,43,6,37,
3145,0,43,6,37,
3146,0,46,7,39,
3147,0,45,6,39,
3148,0,44,6,38,
3149,0,47,7,40,
3150,0,46,6,40,
3151,0,46,7,39,
3152,0,47,6,41,
3153,0,46,6,40,
3154,0,49,7,42,
3155,0,49,7,42,
3156,0,48,6,42,
3157,0,50,7,43,
3158,0,48,6,42,
3159,0,50,7,43,
3160,0,52,8,44,
3161,0,54,9,45,
3162,0,51,7,44,
3163,0,52,7,45,
3164,0,52,6,46,
3165,0,51,6,45,
3166,0,54,7,47,
3167,0,52,6,46,
3168,0,54,7,47,
3169,0,54,6,48,
3170,0,54,7,47,
3171,0,54,7,47,
3172,0,56,7,49,
3173,0,55,6,49,
3174,0,54,6,48,
3175,0,57,7,50,
3176,0,55,6,49,
3177,0,56,7,49,
3178,0,57,6,51,
3179,0,56,6,50,
3180,0,58,7,51,
3181,0,57,6,51,
3182,0,59,7,52,
3183,0,58,6,52,
3184,0,59,7,52,
3185,0,59,7,52,
3186,0,59,6,53,
3187,0,60,7,53,
3188,0,61,7,54,
3189,0,59,6,53,
3190,0,62,7,55,
3191,0,62,8,54,
3192,0,61,6,55,
3193,0,61,6,55,
3194,0,62,7,55,
3195,0,62,6,56,
3196,0,61,6,55,
3197,0,64,7,57,
3198,0,64,7,57,
3199,0,63,6,57,
3200,0,63,7,56,
3201,0,64,6,58,
3202,0,64,6,58,
3203,0,64,7,57,
3204,0,65,6,59,
3205,0,64,6,58,
3206,0,66,7,59,
3207,0,65,6,59,
3208,0,66,7,59,
3209,0,66,6,60,
3210,0,65,6,59,
3211,0,68,7,61,
3212,0,67,6,61,
3213,0,66,6,60,
3214,0,68,7,61,
3215,0,66,6,60,
3216,0,68,7,61,
3217,0,68,6,62,
3218,0,69,7,62,
3219,0,68,7,61,
3220,0,71,7,64,
3221,0,68,6,62,
3222,0,70,7,63,
3223,0,68,6,62,
3224,0,71,7,64,
3225,0,70,6,64,
3226,0,70,7,63,
3227,0,71,7,64,
3228,0,70,6,64,
3229,0,72,7,65,
3230,0,70,6,64,
3231,0,72,7,65,
3232,0,71,6,65,
3233,0,72,7,65,
3234,0,72,7,65,
3235,0,72,6,66,
3236,0,72,6,66,
3237,0,74,7,67,
3238,0,73,6,67,
3239,0,72,6,66,
3240,0,75,7,68,
3241,0,74,6,68,
3242,0,74,7,67,
3243,0,74,6,68,
3244,0,73,6,67,
3245,0,76,7,69,
3246,0,75,6,69,
3247,0,75,7,68,
3248,0,75,6,69,
3249,0,76,7,69,
3250,0,76,7,69,
3251,0,77,7,70,
3252,0,78,8,70,
3253,0,75,6,69,
3254,0,78,7,71,
3255,0,77,6,71,
3256,0,77,7,70,
3257,0,77,6,71,
3258,0,77,6,71,
3259,0,79,7,72,
3260,0,77,6,71,
3261,0,80,8,72,
3262,0,77,6,71,
3263,0,81,7,74,
3264,0,79,7,72,
3265,0,79,6,73,
3266,0,78,6,72,
3267,0,81,7,74,
3268,0,80,6,74,
3269,0,79,6,73,
3270,0,81,7,74,
3271,0,79,6,73,
3272,0,80,7,73,
3273,0,81,6,75,
3274,0,81,7,74,
3275,0,82,7,75,
3276,0,81,6,75,
3277,0,80,6,74,
3278,0,83,7,76,
3279,0,81,6,75,
3280,0,83,7,76,
3281,0,82,7,75,
3282,0,83,8,75,
3283,0,83,7,76,
3284,0,81,6,75,
3285,0,84,7,77,
3286,0,83,7,76,
3287,0,81,6,75,
3288,0,82,7,75,
3289,0,68,6,62,
3290,0,57,7,50,
3291,0,53,7,46,
3292,0,49,6,43,
3293,0,42,6,36,
3294,0,33,7,26,
3295,0,27,7,20,
3296,0,23,6,17,
3297,0,29,7,22,
3298,0,39,6,33,
3299,0,40,7,33,
3300,0,41,7,34,
3301,0,40,6,34,
3302,0,43,7,36,
3303,0,42,6,36,
3304,0,41,6,35,
3305,0,45,7,38,
3306,0,44,6,38,
3307,0,44,7,37,
3308,0,43,6,37,
3309,0,46,7,39,
3310,0,45,7,38,
3311,0,48,8,40,
3312,0,46,7,39,
3313,0,47,6,41,
3314,0,47,6,41,
3315,0,48,7,41,
3316,0,48,6,42,
3317,0,51,8,43,
3318,0,48,6,42,
3319,0,51,7,44,
3320,0,51,7,44,
3321,0,50,7,43,
3322,0,51,6,45,
3323,0,51,6,45,
3324,0,51,7,44,
3325,0,52,6,46,
3326,0,51,6,45,
3327,0,54,7,47,
3328,0,53,6,47,
3329,0,53,7,46,
3330,0,54,6,48,
3331,0,53,6,47,
3332,0,56,7,49,
3333,0,57,7,50,
3334,0,54,6,48,
3335,0,56,7,49,
3336,0,56,6,50,
3337,0,56,7,49,
3338,0,56,6,50,
3339,0,58,7,51,
3340,0,56,6,50,
3341,0,59,7,52,
3342,0,59,7,52,
3343,0,57,6,51,
3344,0,59,7,52,
3345,0,59,7,52,
3346,0,59,6,53,
3347,0,58,6,52,
3348,0,61,7,54,
3349,0,59,6,53,
3350,0,62,7,55,
3351,0,61,6,55,
3352,0,60,6,54,
3353,0,62,7,55,
3354,0,61,6,55,
3355,0,62,7,55,
3356,0,63,7,56,
3357,0,61,6,55,
3358,0,64,7,57,
3359,0,63,6,57,
3360,0,62,6,56,
3361,0,65,7,58,
3362,0,64,6,58,
3363,0,64,7,57,
3364,0,64,6,58,
3365,0,66,7,59,
3366,0,64,6,58,
3367,0,65,7,58,
3368,0,65,6,59,
3369,0,65,6,59,
3370,0,66,7,59,
3371,0,66,6,60,
3372,0,68,7,61,
3373,0,66,6,60,
3374,0,67,7,60,
3375,0,69,7,62,
3376,0,67,6,61,
3377,0,69,7,62,
3378,0,67,6,61,
3379,0,70,7,63,
3380,0,69,8,61,
3381,0,70,7,63,
3382,0,68,6,62,
3383,0,70,7,63,
3384,0,69,6,63,
3385,0,70,7,63,
3386,0,70,6,64,
3387,0,71,7,64,
3388,0,70,6,64,
3389,0,70,6,64,
3390,0,72,7,65,
3391,0,70,6,64,
3392,0,73,7,66,
3393,0,72,6,66,
3394,0,72,7,65,
3395,0,72,6,66,
3396,0,73,7,66,
3397,0,73,6,67,
3398,0,72,6,66,
3399,0,74,7,67,
3400,0,72,6,66,
3401,0,74,7,67,
3402,0,74,6,68,
3403,0,75,7,68,
3404,0,73,6,67,
3405,0,75,7,68,
3406,0,75,6,69,
3407,0,75,7,68,
3408,0,75,6,69,
3409,0,75,7,68,
3410,0,76,6,70,
3411,0,77,8,69,
3412,0,76,6,70,
3413,0,75,6,69,
3414,0,77,7,70,
3415,0,77,6,71,
3416,0,76,6,70,
3417,0,78,7,71,
3418,0,77,6,71,
3419,0,78,7,71,
3420,0,78,6,72,
3421,0,77,6,71,
3422,0,79,7,72,
3423,0,77,6,71,
3424,0,79,7,72,
3425,0,79,6,73,
3426,0,78,6,72,
3427,0,79,7,72,
3428,0,79,6,73,
3429,0,79,6,73,
3430,0,81,7,74,
3431,0,79,6,73,
3432,0,82,7,75,
3433,0,81,7,74,
3434,0,81,7,74,
3435,0,82,7,75,
3436,0,82,7,75,
3437,0,80,6,74,
3438,0,81,7,74,
3439,0,83,7,76,
3440,0,82,6,76,
3441,0,82,7,75,
3442,0,82,6,76,
3443,0,83,7,76,
3444,0,82,6,76,
3445,0,82,7,75,
3446,0,83,7,76,
3447,0,81,6,75,
3448,0,83,7,76,
3449,0,79,7,72,
3450,0,65,6,59,
3451,0,53,6,47,
3452,0,54,7,47,
3453,0,49,6,43,
3454,0,40,6,34,
3455,0,31,6,25,
3456,0,24,6,18,
3457,0,23,7,16,
3458,0,32,6,26,
3459,0,38,6,32,
3460,0,41,7,34,
3461,0,39,6,33,
3462,0,43,7,36,
3463,0,41,6,35,
3464,0,41,6,35,
3465,0,42,7,35,
3466,0,46,8,38,
3467,0,44,7,37,
3468,0,44,7,37,
3469,0,45,6,39,
3470,0,44,6,38,
3471,0,49,8,41,
3472,0,46,6,40,
3473,0,45,6,39,
3474,0,48,7,41,
3475,0,46,6,40,
3476,0,48,7,41,
3477,0,48,6,42,
3478,0,49,7,42,
3479,0,50,7,43,
3480,0,49,6,43,
3481,0,50,7,43,
3482,0,51,7,44,
3483,0,50,6,44,
3484,0,52,7,45,
3485,0,51,6,45,
3486,0,52,7,45,
3487,0,52,6,46,
3488,0,52,6,46,
3489,0,55,7,48,
3490,0,53,6,47,
3491,0,53,6,47,
3492,0,55,7,48,
3493,0,53,6,47,
3494,0,56,7,49,
3495,0,56,7,49,
3496,0,55,7,48,
3497,0,56,6,50,
3498,0,58,7,51,
3499,0,57,7,50,
3500,0,56,6,50,
3501,0,58,7,51,
3502,0,56,6,50,
3503,0,60,7,53,
3504,0,58,6,52,
3505,0,58,7,51,
3506,0,59,6,53,
3507,0,59,6,53,
3508,0,60,7,53,
3509,0,59,6,53,
3510,0,61,7,54,
3511,0,59,6,53,
3512,0,62,7,55,
3513,0,61,6,55,
3514,0,61,7,54,
3515,0,60,6,54,
3516,0,64,7,57,
3517,0,62,6,56,
3518,0,62,7,55,
3519,0,63,6,57,
3520,0,62,6,56,
3521,0,64,7,57,
3522,0,63,6,57,
3523,0,64,7,57,
3524,0,67,9,58,
3525,0,66,7,59,
3526,0,65,6,59,
3527,0,66,7,59,
3528,0,64,6,58,
3529,0,67,8,59,
3530,0,67,7,60,
3531,0,66,6,60,
3532,0,67,7,60,
3533,0,65,6,59,
3534,0,68,7,61,
3535,0,67,7,60,
3536,0,67,6,61,
3537,0,66,6,60,
3538,0,69,7,62,
3539,0,69,7,62,
3540,0,67,6,61,
3541,0,69,7,62,
3542,0,69,6,63,
3543,0,68,6,62,
3544,0,70,7,63,
3545,0,68,6,62,
3546,0,71,7,64,
3547,0,70,7,63,
3548,0,70,6,64,
3549,0,70,7,63,
3550,0,72,7,65,
3551,0,71,6,65,
3552,0,71,7,64,
3553,0,72,7,65,
3554,0,71,6,65,
3555,0,72,7,65,
3556,0,72,7,65,
3557,0,72,7,65,
3558,0,73,6,67,
3559,0,74,7,67,
3560,0,73,6,67,
3561,0,73,7,66,
3562,0,74,6,68,
3563,0,73,6,67,
3564,0,75,7,68,
3565,0,74,6,68,
3566,0,74,7,67,
3567,0,75,6,69,
3568,0,74,6,68,
3569,0,77,7,70,
3570,0,75,6,69,
3571,0,76,7,69,
3572,0,77,7,70,
3573,0,77,7,70,
3574,0,75,6,69,
3575,0,76,7,69,
3576,0,77,6,71,
3577,0,76,6,70,
3578,0,78,7,71,
3579,0,78,7,71,
3580,0,77,7,70,
3581,0,78,6,72,
3582,0,77,6,71,
3583,0,79,7,72,
3584,0,78,6,72,
3585,0,79,7,72,
3586,0,78,6,72,
3587,0,80,7,73,
3588,0,79,6,73,
3589,0,80,7,73,
3590,0,81,7,74,
3591,0,79,6,73,
3592,0,81,7,74,
3593,0,80,6,74,
3594,0,80,7,73,
3595,0,81,6,75,
3596,0,80,6,74,
3597,0,81,7,74,
3598,0,81,6,75,
3599,0,81,7,74,
3600,0,83,7,76,
3601,0,81,6,75,
3602,0,83,7,76,
3603,0,82,6,76,
3604,0,81,6,75,
3605,0,83,7,76,
3606,0,82,6,76,
3607,0,82,7,75,
3608,0,82,6,76,
3609,0,81,6,75,
3610,0,80,7,73,
3611,0,66,6,60,
3612,0,56,7,49,
3613,0,52,6,46,
3614,0,51,7,44,
3615,0,43,7,36,
3616,0,32,6,26,
3617,0,26,6,20,
3618,0,21,6,15,
3619,0,29,7,22,
3620,0,41,7,34,
3621,0,40,6,34,
3622,0,39,6,33,
3623,0,43,8,35,
3624,0,41,6,35,
3625,0,43,7,36,
3626,0,41,6,35,
3627,0,44,7,37,
3628,0,42,6,36,
3629,0,46,7,39,
3630,0,44,6,38,
3631,0,44,6,38,
3632,0,47,7,40,
3633,0,46,6,40,
3634,0,46,7,39,
3635,0,47,6,41,
3636,0,31,1,30,
3637,0,8,,8,
