window-id,queue-size-CL,queue-size-LL,10.0.0.13:48721 -> 10.0.1.13:3000,10.0.1.13:3000 -> 10.0.0.13:48721,10.0.0.13:43459 -> 10.0.1.13:1000
0,0,41,12,29,
1,0,32,8,24,
2,0,30,8,22,
3,0,28,8,20,
4,0,27,8,19,
5,0,26,7,19,
6,0,26,8,18,
7,0,27,9,18,
8,0,25,8,17,
9,0,23,7,16,
10,0,26,9,17,
11,0,27,9,18,
12,0,25,8,17,
13,0,24,7,17,
14,0,25,8,17,
15,0,23,8,15,
16,0,24,7,17,
17,0,25,8,17,
18,0,25,9,16,
19,0,26,10,16,
20,0,31,13,18,
21,0,29,12,17,
22,0,28,12,16,
23,0,31,14,17,
24,0,28,11,17,
25,0,29,12,17,
26,0,27,11,16,
27,0,29,12,17,
28,0,29,12,17,
29,0,28,12,16,
30,0,23,8,15,
31,0,27,12,15,
32,0,26,10,16,
33,0,31,13,18,
34,0,32,14,18,
35,0,28,12,16,
36,0,29,13,16,
37,0,29,12,17,
38,0,29,12,17,
39,0,28,12,16,
40,0,30,13,17,
41,0,29,12,17,
42,0,29,12,17,
43,0,30,13,17,
44,0,29,12,17,
45,0,30,13,17,
46,0,25,9,16,
47,0,23,6,17,
48,0,21,6,15,
49,0,23,7,16,
50,0,24,6,18,
51,0,24,7,17,
52,0,24,6,18,
53,0,22,6,16,
54,0,25,7,18,
55,0,25,7,18,
56,0,23,6,17,
57,0,21,6,15,
58,0,23,7,16,
59,0,25,7,18,
60,0,23,6,17,
61,0,23,7,16,
62,0,23,6,17,
63,0,22,6,16,
64,0,25,7,18,
65,0,23,6,17,
66,0,22,6,16,
67,0,27,8,19,
68,0,23,6,17,
69,0,23,7,16,
70,0,24,6,18,
71,0,22,6,16,
72,0,21,6,15,
73,0,24,7,17,
74,0,22,6,16,
75,0,21,6,15,
76,0,24,7,17,
77,0,22,6,16,
78,0,23,7,16,
79,0,23,6,17,
80,0,24,7,17,
81,0,24,6,18,
82,0,23,6,17,
83,0,25,7,18,
84,0,24,6,18,
85,0,24,7,17,
86,0,23,6,17,
87,0,23,7,16,
88,0,24,7,17,
89,0,24,6,18,
90,0,23,6,17,
91,0,22,6,16,
92,0,24,7,17,
93,0,23,6,17,
94,0,23,7,16,
95,0,22,6,16,
96,0,25,7,18,
97,0,22,6,16,
98,0,24,7,17,
99,0,25,7,18,
100,0,24,6,18,
101,0,24,7,17,
102,0,23,7,16,
103,0,23,6,17,
104,0,22,6,16,
105,0,24,7,17,
106,0,24,6,18,
107,0,24,7,17,
108,0,24,7,17,
109,0,22,6,16,
110,0,22,6,16,
111,0,22,7,15,
112,0,22,6,16,
113,0,21,6,15,
114,0,23,7,16,
115,0,23,7,16,
116,0,23,7,16,
117,0,23,6,17,
118,0,23,6,17,
119,0,24,7,17,
120,0,22,6,16,
121,0,24,7,17,
122,0,22,6,16,
123,0,23,7,16,
124,0,23,6,17,
125,0,24,7,17,
126,0,24,8,16,
127,0,23,7,16,
128,0,24,6,18,
129,0,24,7,17,
130,0,24,7,17,
131,0,22,6,16,
132,0,23,6,17,
133,0,25,7,18,
134,0,23,6,17,
135,0,23,7,16,
136,0,23,6,17,
137,0,27,9,18,
138,0,26,7,19,
139,0,24,6,18,
140,0,23,6,17,
141,0,25,7,18,
142,0,23,6,17,
143,0,25,7,18,
144,0,26,8,18,
145,0,23,6,17,
146,0,22,6,16,
147,0,23,6,17,
148,0,26,7,19,
149,0,23,6,17,
150,0,23,7,16,
151,0,23,6,17,
152,0,21,6,15,
153,0,23,7,16,
154,0,23,6,17,
155,0,24,7,17,
156,0,24,6,18,
157,0,25,6,19,
158,0,24,6,18,
159,0,24,7,17,
160,0,23,7,16,
161,0,23,6,17,
162,0,22,6,16,
163,0,24,7,17,
164,0,23,6,17,
165,0,22,6,16,
166,0,26,8,18,
167,0,25,6,19,
168,0,25,7,18,
169,0,24,7,17,
170,0,22,6,16,
171,0,21,6,15,
172,0,23,7,16,
173,0,22,6,16,
174,0,21,6,15,
175,0,24,7,17,
176,0,22,6,16,
177,0,23,7,16,
178,0,23,6,17,
179,0,23,7,16,
180,0,23,7,16,
181,0,24,7,17,
182,0,24,7,17,
183,0,30,13,17,
184,0,29,11,18,
185,0,25,8,17,
186,0,22,6,16,
187,0,24,7,17,
188,0,23,6,17,
189,0,23,7,16,
190,0,23,7,16,
191,0,24,6,18,
192,0,24,6,18,
193,0,24,7,17,
194,0,22,6,16,
195,0,21,6,15,
196,0,23,7,16,
197,0,21,6,15,
198,0,22,7,15,
199,0,23,6,17,
200,0,22,6,16,
201,0,25,7,18,
202,0,27,8,19,
203,0,25,6,19,
204,0,23,6,17,
205,0,21,6,15,
206,0,22,7,15,
207,0,23,7,16,
208,0,22,6,16,
209,0,23,6,17,
210,0,25,7,18,
211,0,23,6,17,
212,0,23,7,16,
213,0,23,6,17,
214,0,22,6,16,
215,0,25,7,18,
216,0,23,6,17,
217,0,24,7,17,
218,0,22,6,16,
219,0,22,7,15,
220,0,23,7,16,
221,0,22,7,15,
222,0,23,7,16,
223,0,22,6,16,
224,0,23,6,17,
225,0,25,7,18,
226,0,23,6,17,
227,0,23,7,16,
228,0,30,10,20,
229,0,24,7,17,
230,0,25,6,19,
231,0,25,7,18,
232,0,23,6,17,
233,0,25,7,18,
234,0,23,6,17,
235,0,23,7,16,
236,0,23,6,17,
237,0,25,7,18,
238,0,24,7,17,
239,0,23,6,17,
240,0,22,6,16,
241,0,22,7,15,
242,0,23,7,16,
243,0,24,8,16,
244,0,24,9,15,
245,0,23,6,17,
246,0,23,6,17,
247,0,23,7,16,
248,0,23,6,17,
249,0,22,6,16,
250,0,23,7,16,
251,0,24,7,17,
252,0,23,7,16,
253,0,24,6,18,
254,0,23,6,17,
255,0,22,6,16,
256,0,22,7,15,
257,0,22,6,16,
258,0,21,6,15,
259,0,23,7,16,
260,0,24,7,17,
261,0,24,6,18,
262,0,24,7,17,
263,0,24,6,18,
264,0,23,6,17,
265,0,24,7,17,
266,0,23,6,17,
267,0,22,6,16,
268,0,24,8,16,
269,0,24,7,17,
270,0,25,7,18,
271,0,24,7,17,
272,0,24,6,18,
273,0,23,6,17,
274,0,23,7,16,
275,0,22,7,15,
276,0,22,6,16,
277,0,21,6,15,
278,0,24,7,17,
279,0,22,6,16,
280,0,24,7,17,
281,0,22,6,16,
282,0,24,7,17,
283,0,23,6,17,
284,0,23,7,16,
285,0,24,6,18,
286,0,23,6,17,
287,0,25,7,18,
288,0,23,6,17,
289,0,24,7,17,
290,0,24,7,17,
291,0,22,6,16,
292,0,24,7,17,
293,0,23,6,17,
294,0,23,6,17,
295,0,21,6,15,
296,0,24,7,17,
297,0,22,6,16,
298,0,26,8,18,
299,0,23,6,17,
300,0,22,6,16,
301,0,24,7,17,
302,0,23,7,16,
303,0,23,6,17,
304,0,22,6,16,
305,0,27,10,17,
306,0,26,8,18,
307,0,23,6,17,
308,0,22,6,16,
309,0,24,7,17,
310,0,25,6,19,
311,0,24,7,17,
312,0,24,6,18,
313,0,23,6,17,
314,0,24,7,17,
315,0,25,7,18,
316,0,24,6,18,
317,0,23,6,17,
318,0,24,7,17,
319,0,24,8,16,
320,0,23,7,16,
321,0,23,6,17,
322,0,23,6,17,
323,0,25,9,16,
324,0,23,6,17,
325,0,22,6,16,
326,0,26,7,19,
327,0,24,6,18,
328,0,23,7,16,
329,0,21,6,15,
330,0,23,8,15,
331,0,25,8,17,
332,0,24,6,18,
333,0,23,7,16,
334,0,23,6,17,
335,0,22,6,16,
336,0,24,7,17,
337,0,24,6,18,
338,0,22,6,16,
339,0,24,7,17,
340,0,23,6,17,
341,0,25,7,18,
342,0,25,7,18,
343,0,23,6,17,
344,0,25,7,18,
345,0,22,6,16,
346,0,21,6,15,
347,0,24,7,17,
348,0,24,6,18,
349,0,23,7,16,
350,0,24,7,17,
351,0,22,6,16,
352,0,24,7,17,
353,0,23,6,17,
354,0,22,6,16,
355,0,23,7,16,
356,0,22,7,15,
357,0,23,6,17,
358,0,26,6,20,
359,0,25,7,18,
360,0,23,6,17,
361,0,24,7,17,
362,0,23,7,16,
363,0,22,6,16,
364,0,22,7,15,
365,0,25,7,18,
366,0,24,6,18,
367,0,24,7,17,
368,0,23,7,16,
369,0,24,7,17,
370,0,22,6,16,
371,0,23,7,16,
372,0,23,6,17,
373,0,21,6,15,
374,0,24,7,17,
375,0,22,7,15,
376,0,23,6,17,
377,0,23,7,16,
378,0,24,7,17,
379,0,23,6,17,
380,0,24,7,17,
381,0,23,7,16,
382,0,24,7,17,
383,0,22,6,16,
384,0,26,7,19,
385,0,24,6,18,
386,0,24,7,17,
387,0,23,7,16,
388,0,23,6,17,
389,0,22,6,16,
390,0,25,7,18,
391,0,24,6,18,
392,0,24,7,17,
393,0,24,8,16,
394,0,24,7,17,
395,0,24,7,17,
396,0,23,6,17,
397,0,21,6,15,
398,0,26,8,18,
399,0,23,6,17,
400,0,26,7,19,
401,0,24,7,17,
402,0,23,7,16,
403,0,22,6,16,
404,0,22,6,16,
405,0,24,7,17,
406,0,22,6,16,
407,0,24,7,17,
408,0,24,7,17,
409,0,23,6,17,
410,0,28,12,16,
411,0,29,13,16,
412,0,28,12,16,
413,0,30,12,18,
414,0,28,12,16,
415,0,29,12,17,
416,0,27,11,16,
417,0,31,13,18,
418,0,30,12,18,
419,0,25,10,15,
420,0,30,13,17,
421,0,29,12,17,
422,0,29,13,16,
423,0,26,9,17,
424,0,29,12,17,
425,0,29,13,16,
426,0,28,11,17,
427,0,30,13,17,
428,0,30,13,17,
429,0,27,11,16,
430,0,28,12,16,
431,0,30,13,17,
432,0,30,13,17,
433,0,30,13,17,
434,0,30,13,17,
435,0,29,11,18,
436,0,29,13,16,
437,0,29,11,18,
438,0,28,10,18,
439,0,29,13,16,
440,0,30,12,18,
441,0,32,13,19,
442,0,29,13,16,
443,0,30,10,20,
444,0,30,10,20,
445,0,32,11,21,
446,0,31,13,18,
447,0,30,13,17,
448,0,29,13,16,
449,0,28,11,17,
450,0,29,11,18,
451,0,29,12,17,
452,0,30,13,17,
453,0,29,11,18,
454,0,33,13,20,
455,0,30,12,18,
456,0,30,11,19,
457,0,29,12,17,
458,0,29,12,17,
459,0,32,13,19,
460,0,29,12,17,
461,0,32,13,19,
462,0,31,13,18,
463,0,30,13,17,
464,0,31,13,18,
465,0,32,14,18,
466,0,28,13,15,
467,0,29,13,16,
468,0,30,13,17,
469,0,28,12,16,
470,0,29,12,17,
471,0,31,14,17,
472,0,30,12,18,
473,0,30,13,17,
474,0,30,13,17,
475,0,30,13,17,
476,0,30,13,17,
477,0,32,13,19,
478,0,30,12,18,
479,0,32,14,18,
480,0,31,13,18,
481,0,32,14,18,
482,0,32,15,17,
483,0,31,13,18,
484,0,30,12,18,
485,0,31,13,18,
486,0,31,13,18,
487,0,31,13,18,
488,0,31,13,18,
489,0,30,12,18,
490,0,32,14,18,
491,0,31,13,18,
492,0,32,13,19,
493,0,30,13,17,
494,0,30,12,18,
495,0,31,13,18,
496,0,31,13,18,
497,0,31,13,18,
498,0,32,14,18,
499,0,29,12,17,
500,0,31,13,18,
501,0,25,8,17,
502,0,25,7,18,
503,0,25,7,18,
504,0,23,6,17,
505,0,24,7,17,
506,0,22,6,16,
507,0,23,7,16,
508,0,25,8,17,
509,0,24,6,18,
510,0,26,8,18,
511,0,23,7,16,
512,0,24,6,18,
513,0,25,8,17,
514,0,23,6,17,
515,0,24,7,17,
516,0,24,6,18,
517,0,26,8,18,
518,0,25,7,18,
519,0,24,6,18,
520,0,26,7,19,
521,0,23,6,17,
522,0,25,7,18,
523,0,24,8,16,
524,0,23,6,17,
525,0,23,7,16,
526,0,25,7,18,
527,0,25,7,18,
528,0,23,7,16,
529,0,22,7,15,
530,0,24,7,17,
531,0,24,6,18,
532,0,25,8,17,
533,0,24,7,17,
534,0,25,7,18,
535,0,24,6,18,
536,0,25,7,18,
537,0,23,6,17,
538,0,26,7,19,
539,0,24,6,18,
540,0,21,6,15,
541,0,24,7,17,
542,0,21,6,15,
543,0,27,8,19,
544,0,23,6,17,
545,0,24,7,17,
546,0,21,6,15,
547,0,25,7,18,
548,0,24,7,17,
549,0,24,6,18,
550,0,23,7,16,
551,0,24,6,18,
552,0,25,7,18,
553,0,25,7,18,
554,0,25,7,18,
555,0,25,7,18,
556,0,25,6,19,
557,0,26,7,19,
558,0,26,7,19,
559,0,23,6,17,
560,0,24,7,17,
561,0,24,7,17,
562,0,22,6,16,
563,0,26,7,19,
564,0,24,7,17,
565,0,24,6,18,
566,0,25,7,18,
567,0,23,6,17,
568,0,25,7,18,
569,0,22,6,16,
570,0,24,7,17,
571,0,23,7,16,
572,0,23,6,17,
573,0,27,8,19,
574,0,24,6,18,
575,0,26,7,19,
576,0,22,6,16,
577,0,24,7,17,
578,0,24,7,17,
579,0,24,8,16,
580,0,23,6,17,
581,0,27,9,18,
582,0,22,6,16,
583,0,26,7,19,
584,0,24,6,18,
585,0,25,7,18,
586,0,23,6,17,
587,0,23,6,17,
588,0,18,5,13,
589,0,25,7,18,
590,0,23,6,17,
591,0,25,7,18,
592,0,25,7,18,
593,0,23,7,16,
594,0,24,7,17,
595,0,21,6,15,
596,0,24,8,16,
597,0,26,8,18,
598,0,24,6,18,
599,0,23,6,17,
600,0,24,7,17,
601,0,24,7,17,
602,0,26,6,20,
603,0,24,6,18,
604,0,25,7,18,
605,0,24,7,17,
606,0,21,6,15,
607,0,24,7,17,
608,0,22,7,15,
609,0,24,7,17,
610,0,25,7,18,
611,0,24,6,18,
612,0,24,7,17,
613,0,26,7,19,
614,0,23,7,16,
615,0,23,6,17,
616,0,23,7,16,
617,0,24,6,18,
618,0,26,7,19,
619,0,24,6,18,
620,0,25,7,18,
621,0,23,7,16,
622,0,25,7,18,
623,0,21,6,15,
624,0,23,7,16,
625,0,24,7,17,
626,0,26,9,17,
627,0,23,6,17,
628,0,23,7,16,
629,0,26,7,19,
630,0,23,7,16,
631,0,25,7,18,
632,0,24,6,18,
633,0,24,7,17,
634,0,23,7,16,
635,0,24,8,16,
636,0,26,7,19,
637,0,24,6,18,
638,0,25,7,18,
639,0,23,6,17,
640,0,24,7,17,
641,0,24,7,17,
642,0,25,7,18,
643,0,23,6,17,
644,0,23,7,16,
645,0,22,7,15,
646,0,22,6,16,
647,0,25,7,18,
648,0,25,6,19,
649,0,25,7,18,
650,0,25,7,18,
651,0,23,7,16,
652,0,23,6,17,
653,0,24,7,17,
654,0,22,6,16,
655,0,24,7,17,
656,0,24,6,18,
657,0,24,7,17,
658,0,23,6,17,
659,0,25,7,18,
660,0,24,6,18,
661,0,23,7,16,
662,0,24,6,18,
663,0,25,7,18,
664,0,24,7,17,
665,0,24,8,16,
666,0,24,7,17,
667,0,24,6,18,
668,0,26,7,19,
669,0,24,6,18,
670,0,25,7,18,
671,0,23,7,16,
672,0,23,6,17,
673,0,23,6,17,
674,0,25,8,17,
675,0,25,7,18,
676,0,21,6,15,
677,0,23,7,16,
678,0,22,7,15,
679,0,23,6,17,
680,0,25,7,18,
681,0,23,6,17,
682,0,26,8,18,
683,0,24,8,16,
684,0,25,7,18,
685,0,22,6,16,
686,0,25,7,18,
687,0,23,7,16,
688,0,24,7,17,
689,0,22,6,16,
690,0,24,7,17,
691,0,23,7,16,
692,0,23,6,17,
693,0,22,7,15,
694,0,23,6,17,
695,0,26,8,18,
696,0,22,6,16,
697,0,24,7,17,
698,0,23,6,17,
699,0,26,7,19,
700,0,23,6,17,
701,0,25,7,18,
702,0,22,6,16,
703,0,23,8,15,
704,0,22,6,16,
705,0,24,8,16,
706,0,21,6,15,
707,0,24,7,17,
708,0,23,6,17,
709,0,24,7,17,
710,0,24,6,18,
711,0,25,7,18,
712,0,23,6,17,
713,0,24,6,18,
714,0,23,7,16,
715,0,21,6,15,
716,0,23,7,16,
717,0,23,6,17,
718,0,24,6,18,
719,0,23,6,17,
720,0,25,7,18,
721,0,22,6,16,
722,0,23,7,16,
723,0,25,6,19,
724,0,24,6,18,
725,0,25,8,17,
726,0,23,6,17,
727,0,24,7,17,
728,0,23,6,17,
729,0,22,7,15,
730,0,25,7,18,
731,0,23,6,17,
732,0,23,6,17,
733,0,25,7,18,
734,0,24,6,18,
735,0,22,6,16,
736,0,25,7,18,
737,0,22,6,16,
738,0,22,7,15,
739,0,25,7,18,
740,0,23,6,17,
741,0,25,7,18,
742,0,25,7,18,
743,0,25,7,18,
744,0,24,6,18,
745,0,23,6,17,
746,0,23,7,16,
747,0,21,6,15,
748,0,22,7,15,
749,0,22,6,16,
750,0,21,6,15,
751,0,24,7,17,
752,0,22,6,16,
753,0,25,7,18,
754,0,23,6,17,
755,0,23,7,16,
756,0,23,6,17,
757,0,23,7,16,
758,0,23,6,17,
759,0,23,6,17,
760,0,25,7,18,
761,0,23,6,17,
762,0,25,7,18,
763,0,24,6,18,
764,0,23,6,17,
765,0,24,7,17,
766,0,22,6,16,
767,0,22,7,15,
768,0,22,6,16,
769,0,21,6,15,
770,0,24,7,17,
771,0,23,6,17,
772,0,22,6,16,
773,0,23,7,16,
774,0,22,6,16,
775,0,24,7,17,
776,0,24,7,17,
777,0,22,6,16,
778,0,25,7,18,
779,0,27,8,19,
780,0,23,6,17,
781,0,22,6,16,
782,0,23,7,16,
783,0,22,7,15,
784,0,24,6,18,
785,0,23,6,17,
786,0,23,7,16,
787,0,24,7,17,
788,0,22,6,16,
789,0,23,6,17,
790,0,24,7,17,
791,0,23,6,17,
792,0,23,7,16,
793,0,24,7,17,
794,0,21,6,15,
795,0,25,7,18,
796,0,23,6,17,
797,0,22,6,16,
798,0,22,7,15,
799,0,25,7,18,
800,0,23,6,17,
801,0,24,6,18,
802,0,25,7,18,
803,0,25,7,18,
804,0,24,7,17,
805,0,23,6,17,
806,0,26,7,19,
807,0,24,6,18,
808,0,23,6,17,
809,0,23,7,16,
810,0,21,6,15,
811,0,22,7,15,
812,0,24,7,17,
813,0,24,6,18,
814,0,22,6,16,
815,0,26,7,19,
816,0,23,7,16,
817,0,23,6,17,
818,0,22,6,16,
819,0,24,7,17,
820,0,24,7,17,
821,0,23,7,16,
822,0,23,6,17,
823,0,23,6,17,
824,0,22,6,16,
825,0,25,7,18,
826,0,25,7,18,
827,0,24,7,17,
828,0,23,7,16,
829,0,24,6,18,
830,0,23,6,17,
831,0,23,7,16,
832,0,22,6,16,
833,0,22,7,15,
834,0,23,7,16,
835,0,21,6,15,
836,0,24,7,17,
837,0,24,6,18,
838,0,22,6,16,
839,0,23,7,16,
840,0,24,6,18,
841,0,23,6,17,
842,0,22,6,16,
843,0,24,7,17,
844,0,22,6,16,
845,0,24,7,17,
846,0,23,7,16,
847,0,22,6,16,
848,0,22,7,15,
849,0,23,6,17,
850,0,23,6,17,
851,0,23,7,16,
852,0,23,6,17,
853,0,22,6,16,
854,0,24,7,17,
855,0,22,6,16,
856,0,24,8,16,
857,0,24,6,18,
858,0,23,6,17,
859,0,24,6,18,
860,0,25,7,18,
861,0,23,6,17,
862,0,23,7,16,
863,0,23,6,17,
864,0,28,11,17,
865,0,36,14,22,
866,0,31,11,20,
867,0,31,11,20,
868,0,32,13,19,
869,0,30,11,19,
870,0,30,12,18,
871,0,31,13,18,
872,0,30,11,19,
873,0,28,11,17,
874,0,31,12,19,
875,0,31,11,20,
876,0,29,11,18,
877,0,30,12,18,
878,0,30,11,19,
879,0,30,11,19,
880,0,30,12,18,
881,0,30,11,19,
882,0,29,11,18,
883,0,29,10,19,
884,0,29,11,18,
885,0,31,11,20,
886,0,31,13,18,
887,0,29,11,18,
888,0,28,12,16,
889,0,29,11,18,
890,0,28,10,18,
891,0,26,10,16,
892,0,27,12,15,
893,0,25,9,16,
894,0,29,12,17,
895,0,30,13,17,
896,0,28,11,17,
897,0,26,9,17,
898,0,25,9,16,
899,0,27,10,17,
900,0,29,13,16,
901,0,26,10,16,
902,0,31,15,16,
903,0,24,7,17,
904,0,29,11,18,
905,0,31,13,18,
906,0,29,12,17,
907,0,28,9,19,
908,0,24,7,17,
909,0,29,11,17,1
910,0,24,7,17,
911,0,23,6,17,
912,0,21,6,15,
913,0,24,7,17,
914,0,23,6,17,
915,0,22,6,16,
916,0,24,7,17,
917,0,25,7,17,1
918,0,25,7,18,
919,0,24,7,17,
920,0,23,7,16,
921,0,22,6,16,
922,0,21,6,15,
923,0,23,7,16,
924,0,23,6,16,1
925,0,22,7,15,
926,0,25,7,18,
927,0,24,6,18,
928,0,23,6,17,
929,0,25,8,17,
930,0,26,7,19,
931,0,24,6,18,
932,0,23,6,17,
933,0,23,7,16,
934,0,21,6,15,
935,0,22,7,15,
936,0,22,6,16,
937,0,24,7,17,
938,0,21,6,15,
939,0,26,7,19,
940,0,22,6,15,1
941,0,23,6,17,
942,0,22,6,16,
943,0,23,7,16,
944,0,23,6,17,
945,0,22,6,16,
946,0,24,7,17,
947,0,24,6,18,
948,0,23,6,17,
949,0,23,7,16,
950,0,24,6,18,
951,0,25,8,17,
952,0,24,7,17,
953,0,22,6,16,
954,0,22,7,15,
955,0,26,9,16,1
956,0,23,6,17,
957,0,25,7,18,
958,0,22,6,16,
959,0,24,7,17,
960,0,24,7,17,
961,0,26,7,19,
962,0,23,7,16,
963,0,23,6,17,
964,0,22,6,16,
965,0,23,7,16,
966,0,24,7,17,
967,0,24,6,18,
968,0,23,7,16,
969,0,24,7,17,
970,0,23,7,16,
971,0,25,7,18,
972,0,24,6,18,
973,0,23,6,17,
974,0,24,7,17,
975,0,22,6,16,
976,0,21,6,15,
977,0,23,7,16,
978,0,26,8,18,
979,0,23,6,17,
980,0,21,6,15,
981,0,25,7,18,
982,0,24,6,18,
983,0,23,6,17,
984,0,23,7,16,
985,0,25,7,17,1
986,0,24,7,17,
987,0,23,6,17,
988,0,23,7,16,
989,0,24,7,17,
990,0,23,6,17,
991,0,23,6,17,
992,0,25,7,18,
993,0,24,8,16,
994,0,23,6,17,
995,0,22,6,16,
996,0,24,7,17,
997,0,25,7,18,
998,0,26,7,19,
999,0,24,6,18,
1000,0,23,6,17,
1001,0,25,8,17,
1002,0,23,6,17,
1003,0,24,6,18,
1004,0,24,7,17,
1005,0,23,6,17,
1006,0,22,6,16,
1007,0,25,7,18,
1008,0,22,6,16,
1009,0,21,6,15,
1010,0,25,7,18,
1011,0,23,6,17,
1012,0,25,7,18,
1013,0,26,7,19,
1014,0,24,7,17,
1015,0,24,7,16,1
1016,0,23,7,16,
1017,0,24,7,17,
1018,0,24,6,18,
1019,0,27,9,18,
1020,0,26,8,18,
1021,0,26,9,17,
1022,0,23,6,17,
1023,0,25,8,17,
1024,0,22,6,16,
1025,0,25,8,17,
1026,0,25,7,18,
1027,0,24,7,17,
1028,0,22,7,15,
1029,0,22,6,16,
1030,0,26,7,19,
1031,0,25,7,18,
1032,0,24,6,18,
1033,0,22,6,16,
1034,0,23,7,16,
1035,0,24,6,18,
1036,0,23,6,17,
1037,0,24,7,17,
1038,0,23,7,16,
1039,0,21,6,15,
1040,0,23,7,16,
1041,0,24,6,18,
1042,0,22,6,16,
1043,0,22,7,15,
1044,0,24,7,17,
1045,0,23,6,17,
1046,0,26,8,17,1
1047,0,24,7,17,
1048,0,25,7,18,
1049,0,26,7,19,
1050,0,25,7,18,
1051,0,23,6,17,
1052,0,24,7,17,
1053,0,28,8,20,
1054,0,23,6,17,
1055,0,25,8,17,
1056,0,23,6,17,
1057,0,22,6,16,
1058,0,23,6,17,
1059,0,26,7,19,
1060,0,22,6,16,
1061,0,22,7,15,
1062,0,24,7,17,
1063,0,22,6,16,
1064,0,23,7,16,
1065,0,23,6,17,
1066,0,22,6,16,
1067,0,25,7,18,
1068,0,24,6,18,
1069,0,23,6,17,
1070,0,23,7,16,
1071,0,23,6,17,
1072,0,21,6,15,
1073,0,26,7,19,
1074,0,23,6,17,
1075,0,26,7,19,
1076,0,26,8,17,1
1077,0,24,7,17,
1078,0,25,7,18,
1079,0,25,6,19,
1080,0,23,6,17,
1081,0,25,7,18,
1082,0,23,6,17,
1083,0,24,7,17,
1084,0,22,6,16,
1085,0,24,7,17,
1086,0,23,6,17,
1087,0,23,7,16,
1088,0,23,7,16,
1089,0,23,6,17,
1090,0,22,6,16,
1091,0,24,7,17,
1092,0,27,7,20,
1093,0,24,6,18,
1094,0,23,6,17,
1095,0,23,7,16,
1096,0,25,7,18,
1097,0,23,6,17,
1098,0,24,7,17,
1099,0,24,7,17,
1100,0,24,7,17,
1101,0,23,6,17,
1102,0,23,6,17,
1103,0,23,7,16,
1104,0,24,6,18,
1105,0,23,6,17,
1106,0,27,8,18,1
1107,0,26,8,18,
1108,0,24,7,17,
1109,0,23,7,16,
1110,0,23,6,17,
1111,0,22,6,16,
1112,0,21,6,15,
1113,0,24,7,17,
1114,0,24,7,17,
1115,0,25,6,19,
1116,0,24,7,17,
1117,0,24,6,18,
1118,0,23,6,17,
1119,0,24,7,17,
1120,0,25,7,18,
1121,0,24,6,18,
1122,0,23,6,17,
1123,0,25,8,17,
1124,0,24,6,18,
1125,0,23,6,17,
1126,0,24,7,17,
1127,0,23,6,17,
1128,0,23,6,17,
1129,0,23,7,16,
1130,0,23,6,17,
1131,0,22,6,16,
1132,0,24,6,18,
1133,0,24,7,17,
1134,0,22,6,16,
1135,0,22,7,15,
1136,0,21,6,15,
1137,0,26,8,17,1
1138,0,23,7,16,
1139,0,24,7,17,
1140,0,24,7,17,
1141,0,25,7,18,
1142,0,24,6,18,
1143,0,23,7,16,
1144,0,23,7,16,
1145,0,22,6,16,
1146,0,22,6,16,
1147,0,24,7,17,
1148,0,23,7,16,
1149,0,23,6,17,
1150,0,23,7,16,
1151,0,24,7,17,
1152,0,22,6,16,
1153,0,25,7,18,
1154,0,24,6,18,
1155,0,23,6,17,
1156,0,24,7,17,
1157,0,22,6,16,
1158,0,22,7,15,
1159,0,22,7,15,
1160,0,25,7,18,
1161,0,23,6,17,
1162,0,24,6,18,
1163,0,25,7,18,
1164,0,24,6,18,
1165,0,23,6,17,
1166,0,25,7,18,
1167,0,24,7,16,1
1168,0,23,7,16,
1169,0,23,7,16,
1170,0,22,6,16,
1171,0,23,7,16,
1172,0,21,6,15,
1173,0,25,7,18,
1174,0,23,7,16,
1175,0,26,7,19,
1176,0,23,6,17,
1177,0,24,7,17,
1178,0,24,6,18,
1179,0,24,7,17,
1180,0,23,7,16,
1181,0,23,7,16,
1182,0,22,6,16,
1183,0,22,6,16,
1184,0,22,7,15,
1185,0,22,6,16,
1186,0,21,6,15,
1187,0,25,7,18,
1188,0,23,6,17,
1189,0,22,6,16,
1190,0,24,7,17,
1191,0,24,6,18,
1192,0,23,6,17,
1193,0,23,7,16,
1194,0,23,6,17,
1195,0,22,6,16,
1196,0,24,7,17,
1197,0,26,7,18,1
1198,0,24,6,18,
1199,0,26,8,18,
1200,0,23,6,17,
1201,0,22,6,16,
1202,0,24,7,17,
1203,0,23,6,17,
1204,0,25,7,18,
1205,0,26,8,18,
1206,0,23,6,17,
1207,0,23,7,16,
1208,0,22,6,16,
1209,0,22,6,16,
1210,0,24,7,17,
1211,0,22,6,16,
1212,0,25,7,18,
1213,0,21,6,15,
1214,0,24,7,17,
1215,0,24,7,17,
1216,0,23,6,17,
1217,0,23,6,17,
1218,0,25,7,18,
1219,0,23,6,17,
1220,0,23,7,16,
1221,0,24,7,17,
1222,0,23,6,17,
1223,0,23,7,16,
1224,0,25,7,18,
1225,0,23,6,17,
1226,0,23,7,16,
1227,0,22,6,16,
1228,0,25,8,16,1
1229,0,23,7,16,
1230,0,23,6,17,
1231,0,22,6,16,
1232,0,26,8,18,
1233,0,25,7,18,
1234,0,23,7,16,
1235,0,22,6,16,
1236,0,24,7,17,
1237,0,23,6,17,
1238,0,25,7,18,
1239,0,23,6,17,
1240,0,25,7,18,
1241,0,24,6,18,
1242,0,24,7,17,
1243,0,23,6,17,
1244,0,24,6,18,
1245,0,24,7,17,
1246,0,23,6,17,
1247,0,23,6,17,
1248,0,23,7,16,
1249,0,24,6,18,
1250,0,24,7,17,
1251,0,24,7,17,
1252,0,24,7,17,
1253,0,21,6,15,
1254,0,24,7,17,
1255,0,23,6,17,
1256,0,22,6,16,
1257,0,25,7,18,
1258,0,24,7,16,1
1259,0,24,7,17,
1260,0,23,7,16,
1261,0,23,7,16,
1262,0,24,7,17,
1263,0,22,6,16,
1264,0,24,7,17,
1265,0,22,6,16,
1266,0,23,6,17,
1267,0,24,8,16,
1268,0,24,7,17,
1269,0,22,6,16,
1270,0,23,7,16,
1271,0,26,7,19,
1272,0,25,6,19,
1273,0,23,6,17,
1274,0,24,7,17,
1275,0,23,6,17,
1276,0,23,7,16,
1277,0,21,6,15,
1278,0,22,7,15,
1279,0,22,6,16,
1280,0,21,6,15,
1281,0,24,7,17,
1282,0,22,6,16,
1283,0,23,7,16,
1284,0,23,6,17,
1285,0,23,6,17,
1286,0,23,7,16,
1287,0,23,6,17,
1288,0,24,7,16,1
1289,0,23,6,17,
1290,0,23,7,16,
1291,0,22,6,16,
1292,0,22,7,15,
1293,0,21,6,15,
1294,0,24,7,17,
1295,0,23,6,17,
1296,0,22,6,16,
1297,0,22,7,15,
1298,0,23,6,17,
1299,0,23,6,17,
1300,0,23,7,16,
1301,0,23,7,16,
1302,0,22,6,16,
1303,0,22,6,16,
1304,0,24,7,17,
1305,0,24,6,18,
1306,0,22,6,16,
1307,0,24,7,17,
1308,0,24,6,18,
1309,0,22,6,16,
1310,0,25,8,17,
1311,0,26,7,19,
1312,0,24,6,18,
1313,0,24,6,18,
1314,0,23,6,17,
1315,0,23,7,16,
1316,0,22,6,16,
1317,0,22,6,16,
1318,0,24,8,16,
1319,0,24,7,16,1
1320,0,22,6,16,
1321,0,24,7,17,
1322,0,21,6,15,
1323,0,23,7,16,
1324,0,24,7,17,
1325,0,23,6,17,
1326,0,25,7,18,
1327,0,24,6,18,
1328,0,24,7,17,
1329,0,25,8,17,
1330,0,24,7,17,
1331,0,23,7,16,
1332,0,21,6,15,
1333,0,23,7,16,
1334,0,21,6,15,
1335,0,24,7,17,
1336,0,24,6,18,
1337,0,23,6,17,
1338,0,24,7,17,
1339,0,23,6,17,
1340,0,21,6,15,
1341,0,24,7,17,
1342,0,22,6,16,
1343,0,23,7,16,
1344,0,23,6,17,
1345,0,24,7,17,
1346,0,23,6,17,
1347,0,23,7,16,
1348,0,23,6,17,
1349,0,24,6,17,1
1350,0,23,6,17,
1351,0,25,7,18,
1352,0,23,7,16,
1353,0,24,6,18,
1354,0,23,6,17,
1355,0,23,7,16,
1356,0,25,8,17,
1357,0,23,6,17,
1358,0,22,6,16,
1359,0,25,7,18,
1360,0,23,6,17,
1361,0,22,6,16,
1362,0,24,7,17,
1363,0,22,6,16,
1364,0,23,7,16,
1365,0,24,6,18,
1366,0,23,6,17,
1367,0,23,7,16,
1368,0,22,6,16,
1369,0,21,6,15,
1370,0,23,7,16,
1371,0,23,7,16,
1372,0,25,7,18,
1373,0,23,6,17,
1374,0,23,7,16,
1375,0,24,7,17,
1376,0,22,6,16,
1377,0,23,6,17,
1378,0,25,7,18,
1379,0,25,7,17,1
1380,0,25,7,18,
1381,0,24,6,18,
1382,0,24,7,17,
1383,0,22,6,16,
1384,0,21,6,15,
1385,0,23,7,16,
1386,0,22,7,15,
1387,0,23,6,17,
1388,0,23,6,17,
1389,0,23,7,16,
1390,0,23,6,17,
1391,0,22,6,16,
1392,0,26,8,18,
1393,0,23,6,17,
1394,0,22,6,16,
1395,0,25,7,18,
1396,0,24,6,18,
1397,0,24,6,18,
1398,0,24,7,17,
1399,0,22,6,16,
1400,0,22,6,16,
1401,0,24,7,17,
1402,0,23,6,17,
1403,0,25,7,18,
1404,0,24,6,18,
1405,0,23,7,16,
1406,0,24,6,18,
1407,0,25,6,19,
1408,0,23,6,17,
1409,0,24,8,16,
1410,0,24,7,16,1
1411,0,23,8,15,
1412,0,21,6,15,
1413,0,25,8,17,
1414,0,24,6,18,
1415,0,26,7,19,
1416,0,24,6,18,
1417,0,23,7,16,
1418,0,23,6,17,
1419,0,25,7,18,
1420,0,23,6,17,
1421,0,24,7,17,
1422,0,23,6,17,
1423,0,21,6,15,
1424,0,22,7,15,
1425,0,23,6,17,
1426,0,22,6,16,
1427,0,23,6,17,
1428,0,25,7,18,
1429,0,24,6,18,
1430,0,23,7,16,
1431,0,24,6,18,
1432,0,24,6,18,
1433,0,25,7,18,
1434,0,23,6,17,
1435,0,25,7,18,
1436,0,23,6,17,
1437,0,22,6,16,
1438,0,24,7,17,
1439,0,24,7,17,
1440,0,24,6,17,1
1441,0,23,7,16,
1442,0,22,6,16,
1443,0,21,6,15,
1444,0,24,7,17,
1445,0,23,6,17,
1446,0,22,6,16,
1447,0,22,7,15,
1448,0,21,6,15,
1449,0,24,7,17,
1450,0,22,6,16,
1451,0,25,7,18,
1452,0,25,7,18,
1453,0,24,6,18,
1454,0,23,6,17,
1455,0,23,7,16,
1456,0,23,6,17,
1457,0,22,6,16,
1458,0,25,7,18,
1459,0,24,6,18,
1460,0,23,7,16,
1461,0,23,6,17,
1462,0,22,6,16,
1463,0,23,6,17,
1464,0,25,7,18,
1465,0,24,6,18,
1466,0,24,7,17,
1467,0,23,6,17,
1468,0,24,6,18,
1469,0,24,7,17,
1470,0,23,6,17,
1471,0,25,7,17,1
1472,0,22,6,16,
1473,0,21,6,15,
1474,0,24,7,17,
1475,0,25,7,18,
1476,0,23,6,17,
1477,0,23,7,16,
1478,0,26,7,19,
1479,0,24,6,18,
1480,0,22,6,16,
1481,0,26,7,19,
1482,0,24,6,18,
1483,0,24,6,18,
1484,0,24,7,17,
1485,0,25,7,18,
1486,0,22,6,16,
1487,0,24,7,17,
1488,0,23,6,17,
1489,0,24,7,17,
1490,0,24,6,18,
1491,0,26,7,19,
1492,0,23,6,17,
1493,0,22,6,16,
1494,0,24,7,17,
1495,0,22,6,16,
1496,0,24,7,17,
1497,0,23,6,17,
1498,0,23,7,16,
1499,0,24,6,18,
1500,0,27,9,18,
1501,0,30,11,18,1
1502,0,31,11,20,
1503,0,30,10,20,
1504,0,31,11,20,
1505,0,30,11,19,
1506,0,29,12,17,
1507,0,33,11,22,
1508,0,29,9,20,
1509,0,29,11,18,
1510,0,23,7,16,
1511,0,21,6,15,
1512,0,23,7,16,
1513,0,24,7,17,
1514,0,23,6,17,
1515,0,25,8,17,
1516,0,22,6,16,
1517,0,25,7,18,
1518,0,23,6,17,
1519,0,23,7,16,
1520,0,24,7,17,
1521,0,22,6,16,
1522,0,25,7,18,
1523,0,24,6,18,
1524,0,24,7,17,
1525,0,22,6,16,
1526,0,22,6,16,
1527,0,22,7,15,
1528,0,22,6,16,
1529,0,21,6,15,
1530,0,24,7,17,
1531,0,26,8,17,1
1532,0,23,6,17,
1533,0,25,7,18,
1534,0,24,6,18,
1535,0,27,9,18,
1536,0,23,7,16,
1537,0,24,6,18,
1538,0,24,7,17,
1539,0,25,7,18,
1540,0,23,6,17,
1541,0,23,7,16,
1542,0,24,7,17,
1543,0,24,6,18,
1544,0,22,6,16,
1545,0,23,7,16,
1546,0,23,6,17,
1547,0,23,6,17,
1548,0,25,7,18,
1549,0,23,6,17,
1550,0,24,7,17,
1551,0,22,7,15,
1552,0,27,7,20,
1553,0,24,6,18,
1554,0,24,7,17,
1555,0,25,7,18,
1556,0,23,6,17,
1557,0,25,7,18,
1558,0,23,6,17,
1559,0,25,7,18,
1560,0,24,6,18,
1561,0,25,7,18,
1562,0,24,6,17,1
1563,0,23,7,16,
1564,0,22,6,16,
1565,0,24,7,17,
1566,0,24,7,17,
1567,0,22,6,16,
1568,0,24,7,17,
1569,0,23,7,16,
1570,0,24,6,18,
1571,0,23,6,17,
1572,0,24,7,17,
1573,0,22,6,16,
1574,0,24,8,16,
1575,0,23,7,16,
1576,0,24,6,18,
1577,0,24,6,18,
1578,0,24,7,17,
1579,0,23,6,17,
1580,0,22,6,16,
1581,0,23,8,15,
1582,0,22,6,16,
1583,0,22,7,15,
1584,0,25,8,17,
1585,0,22,6,16,
1586,0,24,7,17,
1587,0,23,6,17,
1588,0,23,7,16,
1589,0,23,6,17,
1590,0,22,6,16,
1591,0,27,10,17,
1592,0,31,11,19,1
1593,0,29,11,18,
1594,0,31,11,20,
1595,0,32,11,21,
1596,0,31,11,20,
1597,0,33,12,21,
1598,0,31,12,19,
1599,0,31,12,19,
1600,0,32,11,21,
1601,0,30,11,19,
1602,0,30,11,19,
1603,0,28,9,19,
1604,0,30,12,18,
1605,0,29,11,18,
1606,0,29,11,18,
1607,0,30,11,19,
1608,0,29,11,18,
1609,0,29,11,18,
1610,0,29,10,19,
1611,0,29,12,17,
1612,0,30,12,18,
1613,0,29,10,19,
1614,0,30,11,19,
1615,0,31,12,19,
1616,0,31,11,20,
1617,0,31,12,19,
1618,0,29,10,19,
1619,0,31,13,18,
1620,0,30,11,19,
1621,0,27,10,17,
1622,0,33,12,20,1
1623,0,28,11,17,
1624,0,29,10,19,
1625,0,30,11,19,
1626,0,29,12,17,
1627,0,30,11,19,
1628,0,30,10,20,
1629,0,29,11,18,
1630,0,31,11,20,
1631,0,32,13,19,
1632,0,30,10,20,
1633,0,29,11,18,
1634,0,33,13,20,
1635,0,30,11,19,
1636,0,31,13,18,
1637,0,28,11,17,
1638,0,31,11,20,
1639,0,29,11,18,
1640,0,31,10,21,
1641,0,31,11,20,
1642,0,30,12,18,
1643,0,30,10,20,
1644,0,31,11,20,
1645,0,30,11,19,
1646,0,31,13,18,
1647,0,30,11,19,
1648,0,29,10,19,
1649,0,31,11,20,
1650,0,30,10,20,
1651,0,31,11,20,
1652,0,29,10,19,
1653,0,33,12,20,1
1654,0,29,12,17,
1655,0,30,12,18,
1656,0,30,10,20,
1657,0,30,10,20,
1658,0,32,12,20,
1659,0,30,12,18,
1660,0,31,12,19,
1661,0,31,10,21,
1662,0,29,10,19,
1663,0,33,11,22,
1664,0,32,10,22,
1665,0,29,9,20,
1666,0,30,12,18,
1667,0,29,11,18,
1668,0,29,10,19,
1669,0,31,11,20,
1670,0,31,12,19,
1671,0,29,11,18,
1672,0,32,10,22,
1673,0,30,11,19,
1674,0,31,12,19,
1675,0,30,12,18,
1676,0,31,12,19,
1677,0,31,13,18,
1678,0,29,12,17,
1679,0,31,13,18,
1680,0,30,11,19,
1681,0,30,11,19,
1682,0,29,12,17,
1683,0,25,7,17,1
1684,0,24,6,18,
1685,0,23,7,16,
1686,0,23,7,16,
1687,0,25,7,18,
1688,0,23,6,17,
1689,0,24,7,17,
1690,0,23,6,17,
1691,0,23,7,16,
1692,0,24,6,18,
1693,0,23,6,17,
1694,0,23,7,16,
1695,0,23,7,16,
1696,0,25,8,17,
1697,0,22,6,16,
1698,0,21,6,15,
1699,0,24,7,17,
1700,0,22,7,15,
1701,0,22,6,16,
1702,0,21,6,15,
1703,0,25,7,18,
1704,0,26,7,19,
1705,0,23,6,17,
1706,0,26,7,19,
1707,0,24,6,18,
1708,0,22,6,16,
1709,0,24,7,17,
1710,0,24,6,18,
1711,0,24,7,17,
1712,0,22,6,16,
1713,0,25,8,16,1
1714,0,23,6,17,
1715,0,26,7,19,
1716,0,23,6,17,
1717,0,22,6,16,
1718,0,26,7,19,
1719,0,24,7,17,
1720,0,22,6,16,
1721,0,22,7,15,
1722,0,22,6,16,
1723,0,23,7,16,
1724,0,22,7,15,
1725,0,25,6,19,
1726,0,23,6,17,
1727,0,25,7,18,
1728,0,24,6,18,
1729,0,24,7,17,
1730,0,24,7,17,
1731,0,22,6,16,
1732,0,21,6,15,
1733,0,24,7,17,
1734,0,22,6,16,
1735,0,26,7,19,
1736,0,24,6,18,
1737,0,24,7,17,
1738,0,24,6,18,
1739,0,23,6,17,
1740,0,24,7,17,
1741,0,23,7,16,
1742,0,21,6,15,
1743,0,25,7,18,
1744,0,22,6,15,1
1745,0,24,7,17,
1746,0,22,6,16,
1747,0,23,7,16,
1748,0,23,6,17,
1749,0,24,7,17,
1750,0,23,7,16,
1751,0,22,7,15,
1752,0,24,6,18,
1753,0,24,6,18,
1754,0,23,7,16,
1755,0,23,6,17,
1756,0,21,6,15,
1757,0,23,7,16,
1758,0,23,8,15,
1759,0,22,6,16,
1760,0,22,7,15,
1761,0,24,7,17,
1762,0,23,6,17,
1763,0,23,7,16,
1764,0,25,7,18,
1765,0,23,6,17,
1766,0,22,6,16,
1767,0,23,7,16,
1768,0,21,6,15,
1769,0,26,7,19,
1770,0,24,6,18,
1771,0,22,6,16,
1772,0,25,7,18,
1773,0,26,9,17,
1774,0,23,6,16,1
1775,0,21,6,15,
1776,0,23,7,16,
1777,0,21,6,15,
1778,0,22,7,15,
1779,0,23,7,16,
1780,0,22,6,16,
1781,0,25,7,18,
1782,0,26,8,18,
1783,0,23,6,17,
1784,0,23,7,16,
1785,0,23,6,17,
1786,0,22,6,16,
1787,0,24,7,17,
1788,0,22,6,16,
1789,0,23,7,16,
1790,0,24,6,18,
1791,0,23,6,17,
1792,0,24,7,17,
1793,0,23,6,17,
1794,0,22,6,16,
1795,0,25,9,16,
1796,0,22,7,15,
1797,0,22,6,16,
1798,0,24,7,17,
1799,0,23,7,16,
1800,0,25,8,17,
1801,0,23,7,16,
1802,0,27,8,19,
1803,0,26,8,18,
1804,0,24,6,17,1
1805,0,23,7,16,
1806,0,24,7,17,
1807,0,22,7,15,
1808,0,23,7,16,
1809,0,24,6,18,
1810,0,26,8,18,
1811,0,25,7,18,
1812,0,22,6,16,
1813,0,24,7,17,
1814,0,22,7,15,
1815,0,22,6,16,
1816,0,25,8,17,
1817,0,22,6,16,
1818,0,28,10,18,
1819,0,30,11,19,
1820,0,29,9,20,
1821,0,25,7,18,
1822,0,23,6,17,
1823,0,22,6,16,
1824,0,24,7,17,
1825,0,22,6,16,
1826,0,27,8,19,
1827,0,24,6,18,
1828,0,25,7,18,
1829,0,22,6,16,
1830,0,23,7,16,
1831,0,24,6,18,
1832,0,24,6,18,
1833,0,24,7,17,
1834,0,25,7,18,
1835,0,24,7,17,
1836,0,23,6,17,
1837,0,24,7,17,
1838,0,25,8,17,
1839,0,23,6,17,
1840,0,22,6,16,
1841,0,25,8,17,
1842,0,23,7,16,
1843,0,21,6,15,
1844,0,22,7,15,
1845,0,22,6,16,
1846,0,21,6,15,
1847,0,22,7,15,
1848,0,23,6,17,
1849,0,22,6,16,
1850,0,24,7,17,
1851,0,22,6,16,
1852,0,24,7,17,
1853,0,23,6,17,
1854,0,22,6,16,
1855,0,26,7,19,
1856,0,25,8,17,
1857,0,24,6,18,
1858,0,23,6,17,
1859,0,23,7,16,
1860,0,21,6,15,
1861,0,22,7,15,
1862,0,22,6,16,
1863,0,21,6,15,
1864,0,24,7,17,
1865,0,23,7,16,
1866,0,23,6,17,
1867,0,24,7,17,
1868,0,22,6,16,
1869,0,23,7,16,
1870,0,22,6,16,
1871,0,22,7,15,
1872,0,23,7,16,
1873,0,27,7,20,
1874,0,24,6,18,
1875,0,23,6,17,
1876,0,23,7,16,
1877,0,22,6,16,
1878,0,24,7,17,
1879,0,22,6,16,
1880,0,23,6,17,
1881,0,24,7,17,
1882,0,24,7,17,
1883,0,22,6,16,
1884,0,25,7,18,
1885,0,24,6,18,
1886,0,24,7,17,
1887,0,24,7,17,
1888,0,25,7,18,
1889,0,22,6,16,
1890,0,24,7,17,
1891,0,24,6,18,
1892,0,23,6,17,
1893,0,22,6,16,
1894,0,23,7,16,
1895,0,24,8,16,
1896,0,24,7,17,
1897,0,21,6,15,
1898,0,23,7,16,
1899,0,22,6,16,
1900,0,22,7,15,
1901,0,23,6,17,
1902,0,25,7,18,
1903,0,23,6,17,
1904,0,22,6,16,
1905,0,24,7,17,
1906,0,22,6,16,
1907,0,25,7,18,
1908,0,23,7,16,
1909,0,24,6,18,
1910,0,23,6,17,
1911,0,24,6,18,
1912,0,23,7,16,
1913,0,22,6,16,
1914,0,23,7,16,
1915,0,23,6,17,
1916,0,25,7,18,
1917,0,23,7,16,
1918,0,24,7,17,
1919,0,23,6,17,
1920,0,22,6,16,
1921,0,25,7,18,
1922,0,23,6,17,
1923,0,23,7,16,
1924,0,24,6,18,
1925,0,23,6,17,
1926,0,23,7,16,
1927,0,22,6,16,
1928,0,22,7,15,
1929,0,22,6,16,
1930,0,22,6,16,
1931,0,22,7,15,
1932,0,24,6,18,
1933,0,25,7,18,
1934,0,23,6,17,
1935,0,24,7,17,
1936,0,23,6,17,
1937,0,24,7,17,
1938,0,24,7,17,
1939,0,24,6,18,
1940,0,22,6,16,
1941,0,23,7,16,
1942,0,22,6,16,
1943,0,21,6,15,
1944,0,26,11,15,
1945,0,29,11,18,
1946,0,31,11,20,
1947,0,30,11,19,
1948,0,30,12,18,
1949,0,31,10,21,
1950,0,29,11,18,
1951,0,26,10,16,
1952,0,23,6,17,
1953,0,22,6,16,
1954,0,23,7,16,
1955,0,28,11,17,
1956,0,29,11,18,
1957,0,30,10,20,
1958,0,32,12,20,
1959,0,30,11,19,
1960,0,29,11,18,
1961,0,28,12,16,
1962,0,31,12,19,
1963,0,30,10,20,
1964,0,31,11,20,
1965,0,29,11,18,
1966,0,31,11,20,
1967,0,31,11,20,
1968,0,31,11,20,
1969,0,30,11,19,
1970,0,31,12,19,
1971,0,31,11,20,
1972,0,30,11,19,
1973,0,30,11,19,
1974,0,30,12,18,
1975,0,31,12,19,
1976,0,30,11,19,
1977,0,31,12,19,
1978,0,29,11,18,
1979,0,31,11,20,
1980,0,29,11,18,
1981,0,29,11,18,
1982,0,30,12,18,
1983,0,30,11,19,
1984,0,28,11,17,
1985,0,32,12,20,
1986,0,29,10,19,
1987,0,31,12,19,
1988,0,30,12,18,
1989,0,31,12,19,
1990,0,29,11,18,
1991,0,30,11,19,
1992,0,31,11,20,
1993,0,30,11,19,
1994,0,29,11,18,
1995,0,31,11,20,
1996,0,30,12,18,
1997,0,30,11,19,
1998,0,29,10,19,
1999,0,30,11,19,
2000,0,29,11,18,
2001,0,30,11,19,
2002,0,29,11,18,
2003,0,31,12,19,
2004,0,29,11,18,
2005,0,29,12,17,
2006,0,28,11,17,
2007,0,30,12,18,
2008,0,27,11,16,
2009,0,31,11,20,
2010,0,30,11,19,
2011,0,30,12,18,
2012,0,29,12,17,
2013,0,30,12,18,
2014,0,30,11,19,
2015,0,32,11,21,
2016,0,29,11,18,
2017,0,28,12,16,
2018,0,29,11,18,
2019,0,30,11,19,
2020,0,32,12,20,
2021,0,30,10,20,
2022,0,29,11,18,
2023,0,30,11,19,
2024,0,29,11,18,
2025,0,28,10,18,
2026,0,32,12,20,
2027,0,29,11,18,
2028,0,31,11,20,
2029,0,30,11,19,
2030,0,31,12,19,
2031,0,29,10,19,
2032,0,30,11,19,
2033,0,29,12,17,
2034,0,30,11,19,
2035,0,31,11,20,
2036,0,29,11,18,
2037,0,30,11,19,
2038,0,30,11,19,
2039,0,30,12,18,
2040,0,30,11,19,
2041,0,30,12,18,
2042,0,30,12,18,
2043,0,30,11,19,
2044,0,30,11,19,
2045,0,30,11,19,
2046,0,28,9,19,
2047,0,24,8,16,
2048,0,23,6,17,
2049,0,23,6,17,
2050,0,22,6,16,
2051,0,24,7,17,
2052,0,23,6,17,
2053,0,25,7,18,
2054,0,23,7,16,
2055,0,24,6,18,
2056,0,23,6,17,
2057,0,23,7,16,
2058,0,23,6,17,
2059,0,24,6,18,
2060,0,24,7,17,
2061,0,22,6,16,
2062,0,25,7,18,
2063,0,25,6,19,
2064,0,23,6,17,
2065,0,25,7,18,
2066,0,24,6,18,
2067,0,22,6,16,
2068,0,27,9,18,
2069,0,25,7,18,
2070,0,22,6,16,
2071,0,22,7,15,
2072,0,23,6,17,
2073,0,22,6,16,
2074,0,22,7,15,
2075,0,23,6,17,
2076,0,24,6,18,
2077,0,23,6,17,
2078,0,23,7,16,
2079,0,23,7,16,
2080,0,24,7,17,
2081,0,22,6,16,
2082,0,24,7,17,
2083,0,23,6,17,
2084,0,24,7,17,
2085,0,24,7,17,
2086,0,23,7,16,
2087,0,22,7,15,
2088,0,24,6,18,
2089,0,24,8,16,
2090,0,23,6,17,
2091,0,22,6,16,
2092,0,26,7,19,
2093,0,24,6,18,
2094,0,23,6,17,
2095,0,23,7,16,
2096,0,21,6,15,
2097,0,23,7,16,
2098,0,22,6,16,
2099,0,22,7,15,
2100,0,22,6,16,
2101,0,25,7,18,
2102,0,23,6,17,
2103,0,23,7,16,
2104,0,23,6,17,
2105,0,25,7,18,
2106,0,25,7,18,
2107,0,22,6,16,
2108,0,25,7,18,
2109,0,23,6,17,
2110,0,24,6,18,
2111,0,25,7,18,
2112,0,24,6,18,
2113,0,24,7,17,
2114,0,23,7,16,
2115,0,24,7,17,
2116,0,25,8,17,
2117,0,23,6,17,
2118,0,22,6,16,
2119,0,25,7,18,
2120,0,25,7,18,
2121,0,25,6,19,
2122,0,24,7,17,
2123,0,21,6,15,
2124,0,25,7,18,
2125,0,23,6,17,
2126,0,24,6,18,
2127,0,23,6,17,
2128,0,25,7,18,
2129,0,25,7,18,
2130,0,23,7,16,
2131,0,22,6,16,
2132,0,23,7,16,
2133,0,21,6,15,
2134,0,26,7,19,
2135,0,24,6,18,
2136,0,23,7,16,
2137,0,30,10,20,
2138,0,31,13,18,
2139,0,31,12,19,
2140,0,31,12,19,
2141,0,31,11,20,
2142,0,33,11,22,
2143,0,29,10,19,
2144,0,30,11,19,
2145,0,31,12,19,
2146,0,32,12,20,
2147,0,30,11,19,
2148,0,29,11,18,
2149,0,29,11,18,
2150,0,28,11,17,
2151,0,30,12,18,
2152,0,30,11,19,
2153,0,31,11,20,
2154,0,30,12,18,
2155,0,29,12,17,
2156,0,30,11,19,
2157,0,31,12,19,
2158,0,30,11,19,
2159,0,31,12,19,
2160,0,30,12,18,
2161,0,30,12,18,
2162,0,29,12,17,
2163,0,31,11,20,
2164,0,30,10,20,
2165,0,30,11,19,
2166,0,33,12,21,
2167,0,31,12,19,
2168,0,30,12,18,
2169,0,28,12,16,
2170,0,30,12,18,
2171,0,30,11,19,
2172,0,29,12,17,
2173,0,30,13,17,
2174,0,29,10,19,
2175,0,28,9,19,
2176,0,31,11,20,
2177,0,28,10,18,
2178,0,28,11,17,
2179,0,30,12,18,
2180,0,28,11,17,
2181,0,33,13,20,
2182,0,28,11,17,
2183,0,31,13,18,
2184,0,31,12,19,
2185,0,29,11,18,
2186,0,30,12,18,
2187,0,29,11,18,
2188,0,33,13,20,
2189,0,32,12,20,
2190,0,29,10,19,
2191,0,28,11,17,
2192,0,27,10,17,
2193,0,23,7,16,
2194,0,24,7,17,
2195,0,24,6,18,
2196,0,23,6,17,
2197,0,23,7,16,
2198,0,23,6,17,
2199,0,23,6,17,
2200,0,22,6,16,
2201,0,24,7,17,
2202,0,22,6,16,
2203,0,25,7,18,
2204,0,23,6,17,
2205,0,22,7,15,
2206,0,24,7,17,
2207,0,23,6,17,
2208,0,23,7,16,
2209,0,23,6,17,
2210,0,24,7,17,
2211,0,22,6,16,
2212,0,23,7,16,
2213,0,23,6,17,
2214,0,23,6,17,
2215,0,23,7,16,
2216,0,24,6,18,
2217,0,24,6,18,
2218,0,24,6,18,
2219,0,24,8,16,
2220,0,24,7,17,
2221,0,22,6,16,
2222,0,21,6,15,
2223,0,23,7,16,
2224,0,23,6,17,
2225,0,26,7,19,
2226,0,24,6,18,
2227,0,22,6,16,
2228,0,24,8,16,
2229,0,22,6,16,
2230,0,23,7,16,
2231,0,22,6,16,
2232,0,23,6,17,
2233,0,23,7,16,
2234,0,24,7,17,
2235,0,24,6,18,
2236,0,24,7,17,
2237,0,24,7,17,
2238,0,22,6,16,
2239,0,21,6,15,
2240,0,24,7,17,
2241,0,23,7,16,
2242,0,23,6,17,
2243,0,23,7,16,
2244,0,23,6,17,
2245,0,23,6,17,
2246,0,23,7,16,
2247,0,5,2,3,
2248,0,25,6,19,
2249,0,25,6,19,
2250,0,27,7,20,
2251,0,26,6,20,
2252,0,27,7,20,
2253,0,30,6,24,
2254,0,33,8,25,
2255,0,33,7,26,
2256,0,34,6,28,
2257,0,35,7,28,
2258,0,38,9,29,
2259,0,37,7,30,
2260,0,38,7,31,
2261,0,38,6,32,
2262,0,37,6,31,
2263,0,40,7,33,
2264,0,39,6,33,
2265,0,40,7,33,
2266,0,42,6,36,
2267,0,41,6,35,
2268,0,44,8,36,
2269,0,41,6,35,
2270,0,45,7,38,
2271,0,44,7,37,
2272,0,43,6,37,
2273,0,45,7,38,
2274,0,44,6,38,
2275,0,45,7,38,
2276,0,46,6,40,
2277,0,45,6,39,
2278,0,48,7,41,
2279,0,47,6,41,
2280,0,49,7,42,
2281,0,47,6,41,
2282,0,49,7,42,
2283,0,49,6,43,
2284,0,50,7,43,
2285,0,50,7,43,
2286,0,51,7,44,
2287,0,49,6,43,
2288,0,53,7,46,
2289,0,51,6,45,
2290,0,51,6,45,
2291,0,53,7,46,
2292,0,52,6,46,
2293,0,53,7,46,
2294,0,53,6,47,
2295,0,55,7,48,
2296,0,55,7,48,
2297,0,54,6,48,
2298,0,54,6,48,
2299,0,55,7,48,
2300,0,57,7,50,
2301,0,57,8,49,
2302,0,56,6,50,
2303,0,55,6,49,
2304,0,58,7,51,
2305,0,56,6,50,
2306,0,57,7,50,
2307,0,58,6,52,
2308,0,57,6,51,
2309,0,58,7,51,
2310,0,59,6,53,
2311,0,58,6,52,
2312,0,60,7,53,
2313,0,58,6,52,
2314,0,61,7,54,
2315,0,60,6,54,
2316,0,62,8,54,
2317,0,60,6,54,
2318,0,61,7,54,
2319,0,62,8,54,
2320,0,63,7,56,
2321,0,61,6,55,
2322,0,63,7,56,
2323,0,61,6,55,
2324,0,63,7,56,
2325,0,63,6,57,
2326,0,64,7,57,
2327,0,64,6,58,
2328,0,64,7,57,
2329,0,64,7,57,
2330,0,65,7,58,
2331,0,65,7,58,
2332,0,66,7,59,
2333,0,65,7,58,
2334,0,66,6,60,
2335,0,66,6,60,
2336,0,66,7,59,
2337,0,66,6,60,
2338,0,66,6,60,
2339,0,68,7,61,
2340,0,68,7,61,
2341,0,66,6,60,
2342,0,70,7,63,
2343,0,68,6,62,
2344,0,68,7,61,
2345,0,70,8,62,
2346,0,68,6,62,
2347,0,70,7,63,
2348,0,69,6,63,
2349,0,70,8,62,
2350,0,70,6,64,
2351,0,69,6,63,
2352,0,70,7,63,
2353,0,71,7,64,
2354,0,71,7,64,
2355,0,72,7,65,
2356,0,72,7,65,
2357,0,70,6,64,
2358,0,73,7,66,
2359,0,72,6,66,
2360,0,73,7,66,
2361,0,72,7,65,
2362,0,74,7,67,
2363,0,73,7,66,
2364,0,73,6,67,
2365,0,72,6,66,
2366,0,74,7,67,
2367,0,74,6,68,
2368,0,74,7,67,
2369,0,75,7,68,
2370,0,73,6,67,
2371,0,76,7,69,
2372,0,75,6,69,
2373,0,75,7,68,
2374,0,75,6,69,
2375,0,74,6,68,
2376,0,78,7,71,
2377,0,76,6,70,
2378,0,77,7,70,
2379,0,75,6,69,
2380,0,79,7,72,
2381,0,77,6,71,
2382,0,77,7,70,
2383,0,77,6,71,
2384,0,78,7,71,
2385,0,78,6,72,
2386,0,79,7,72,
2387,0,77,6,71,
2388,0,79,7,72,
2389,0,78,6,72,
2390,0,80,7,73,
2391,0,79,7,72,
2392,0,81,8,73,
2393,0,78,6,72,
2394,0,82,7,75,
2395,0,80,6,74,
2396,0,79,6,73,
2397,0,81,7,74,
2398,0,80,6,74,
2399,0,81,7,74,
2400,0,81,6,75,
2401,0,80,6,74,
2402,0,82,7,75,
2403,0,81,6,75,
2404,0,81,6,75,
2405,0,83,7,76,
2406,0,84,7,77,
2407,0,82,6,76,
2408,0,82,7,75,
2409,0,83,8,75,
2410,0,83,7,76,
2411,0,82,7,75,
2412,0,83,7,76,
2413,0,82,6,76,
2414,0,82,7,75,
2415,0,73,7,66,
2416,0,60,6,54,
2417,0,55,7,48,
2418,0,52,6,46,
2419,0,48,8,40,
2420,0,36,5,31,
2421,0,29,7,22,
2422,0,23,6,17,
2423,0,28,7,21,
2424,0,36,6,30,
2425,0,41,8,33,
2426,0,39,6,33,
2427,0,42,7,35,
2428,0,40,6,34,
2429,0,42,7,35,
2430,0,42,6,36,
2431,0,42,6,36,
2432,0,44,7,37,
2433,0,44,7,37,
2434,0,44,6,38,
2435,0,44,6,38,
2436,0,45,7,38,
2437,0,48,7,41,
2438,0,46,6,40,
2439,0,47,7,40,
2440,0,48,7,41,
2441,0,56,11,45,
2442,0,55,11,44,
2443,0,54,12,42,
2444,0,54,11,43,
2445,0,56,12,44,
2446,0,56,12,44,
2447,0,56,12,44,
2448,0,58,12,46,
2449,0,58,11,47,
2450,0,59,11,48,
2451,0,59,12,47,
2452,0,58,12,46,
2453,0,59,11,48,
2454,0,59,12,47,
2455,0,60,10,50,
2456,0,60,12,48,
2457,0,61,12,49,
2458,0,61,12,49,
2459,0,56,7,49,
2460,0,57,7,50,
2461,0,58,7,51,
2462,0,56,7,49,
2463,0,57,6,51,
2464,0,56,6,50,
2465,0,57,7,50,
2466,0,58,6,52,
2467,0,58,7,51,
2468,0,59,7,52,
2469,0,57,6,51,
2470,0,60,8,52,
2471,0,59,6,53,
2472,0,59,6,53,
2473,0,60,7,53,
2474,0,60,6,54,
2475,0,59,6,53,
2476,0,62,7,55,
2477,0,60,6,54,
2478,0,61,7,54,
2479,0,62,6,56,
2480,0,61,6,55,
2481,0,64,7,57,
2482,0,64,7,57,
2483,0,62,6,56,
2484,0,63,7,56,
2485,0,63,6,57,
2486,0,64,7,57,
2487,0,65,7,58,
2488,0,63,6,57,
2489,0,66,7,59,
2490,0,65,6,59,
2491,0,64,6,58,
2492,0,65,7,58,
2493,0,66,7,59,
2494,0,66,7,59,
2495,0,66,6,60,
2496,0,65,6,59,
2497,0,68,7,61,
2498,0,67,6,61,
2499,0,66,6,60,
2500,0,70,9,61,
2501,0,73,11,62,
2502,0,75,13,62,
2503,0,74,10,64,
2504,0,74,12,62,
2505,0,76,11,65,
2506,0,76,11,65,
2507,0,76,11,65,
2508,0,77,12,65,
2509,0,76,11,65,
2510,0,78,12,66,
2511,0,77,12,65,
2512,0,77,12,65,
2513,0,78,13,65,
2514,0,78,12,66,
2515,0,78,11,67,
2516,0,78,12,66,
2517,0,79,11,68,
2518,0,79,12,67,
2519,0,81,11,70,
2520,0,80,12,68,
2521,0,80,11,69,
2522,0,80,12,68,
2523,0,81,12,69,
2524,0,81,12,69,
2525,0,81,11,70,
2526,0,81,12,69,
2527,0,83,13,70,
2528,0,81,11,70,
2529,0,80,10,70,
2530,0,83,13,70,
2531,0,83,11,72,
2532,0,82,10,72,
2533,0,84,14,70,
2534,0,82,12,70,
2535,0,83,12,71,
2536,0,85,13,72,
2537,0,84,12,72,
2538,0,84,11,73,
2539,0,83,11,72,
2540,0,85,12,73,
2541,0,84,11,73,
2542,0,85,11,74,
2543,0,84,12,72,
2544,0,86,11,75,
2545,0,86,11,75,
2546,0,84,10,74,
2547,0,86,12,74,
2548,0,88,13,75,
2549,0,86,11,75,
2550,0,87,12,75,
2551,0,87,12,75,
2552,0,87,11,76,
2553,0,87,11,76,
2554,0,88,12,76,
2555,0,87,11,76,
2556,0,88,11,77,
2557,0,88,11,77,
2558,0,89,12,77,
2559,0,89,11,78,
2560,0,88,11,77,
2561,0,89,13,76,
2562,0,88,12,76,
2563,0,89,13,76,
2564,0,88,12,76,
2565,0,84,7,77,
2566,0,81,6,75,
2567,0,73,7,66,
2568,0,59,6,53,
2569,0,52,6,46,
2570,0,53,8,45,
2571,0,46,7,39,
2572,0,36,6,30,
2573,0,29,7,22,
2574,0,23,6,17,
2575,0,26,7,19,
2576,0,37,6,31,
2577,0,38,6,32,
2578,0,40,7,33,
2579,0,41,6,35,
2580,0,41,7,34,
2581,0,43,7,36,
2582,0,41,6,35,
2583,0,45,8,37,
2584,0,43,6,37,
2585,0,43,6,37,
2586,0,44,7,37,
2587,0,45,7,38,
2588,0,45,6,39,
2589,0,46,7,39,
2590,0,47,7,40,
2591,0,49,9,40,
2592,0,53,11,42,
2593,0,55,12,43,
2594,0,56,12,44,
2595,0,55,11,44,
2596,0,58,12,46,
2597,0,56,11,45,
2598,0,56,12,44,
2599,0,57,12,45,
2600,0,58,11,47,
2601,0,59,11,48,
2602,0,58,11,47,
2603,0,59,11,48,
2604,0,60,12,48,
2605,0,59,12,47,
2606,0,60,11,49,
2607,0,60,12,48,
2608,0,61,12,49,
2609,0,63,12,51,
2610,0,62,12,50,
2611,0,61,12,49,
2612,0,62,13,49,
2613,0,62,13,49,
2614,0,61,10,51,
2615,0,64,11,53,
2616,0,63,10,53,
2617,0,65,12,53,
2618,0,64,11,53,
2619,0,64,12,52,
2620,0,67,13,54,
2621,0,65,12,53,
2622,0,66,11,55,
2623,0,67,11,56,
2624,0,67,11,56,
2625,0,67,11,56,
2626,0,67,11,56,
2627,0,63,8,55,
2628,0,61,7,54,
2629,0,62,6,56,
2630,0,61,6,55,
2631,0,62,7,55,
2632,0,63,7,56,
2633,0,63,6,57,
2634,0,62,6,56,
2635,0,63,7,56,
2636,0,65,7,58,
2637,0,64,6,58,
2638,0,63,6,57,
2639,0,66,7,59,
2640,0,64,6,58,
2641,0,65,7,58,
2642,0,65,6,59,
2643,0,66,7,59,
2644,0,67,7,60,
2645,0,65,6,59,
2646,0,68,7,61,
2647,0,67,6,61,
2648,0,66,6,60,
2649,0,68,7,61,
2650,0,67,7,60,
2651,0,68,6,62,
2652,0,69,7,62,
2653,0,69,7,62,
2654,0,67,6,61,
2655,0,71,7,64,
2656,0,69,6,63,
2657,0,68,6,62,
2658,0,71,7,64,
2659,0,71,7,64,
2660,0,69,6,63,
2661,0,70,7,63,
2662,0,70,6,64,
2663,0,70,6,64,
2664,0,72,7,65,
2665,0,72,7,65,
2666,0,71,7,64,
2667,0,72,6,66,
2668,0,71,6,65,
2669,0,73,7,66,
2670,0,71,6,65,
2671,0,73,7,66,
2672,0,73,6,67,
2673,0,72,6,66,
2674,0,73,7,66,
2675,0,74,6,68,
2676,0,74,7,67,
2677,0,74,6,68,
2678,0,73,6,67,
2679,0,75,7,68,
2680,0,75,6,69,
2681,0,75,7,68,
2682,0,79,10,69,
2683,0,82,11,71,
2684,0,84,12,72,
2685,0,84,11,73,
2686,0,83,11,72,
2687,0,82,11,71,
2688,0,83,11,72,
2689,0,80,9,71,
2690,0,78,7,71,
2691,0,76,6,70,
2692,0,78,7,71,
2693,0,78,6,72,
2694,0,78,7,71,
2695,0,78,7,71,
2696,0,78,7,71,
2697,0,81,7,74,
2698,0,79,6,73,
2699,0,78,6,72,
2700,0,80,7,73,
2701,0,78,6,72,
2702,0,80,7,73,
2703,0,80,6,74,
2704,0,80,7,73,
2705,0,80,6,74,
2706,0,80,6,74,
2707,0,81,7,74,
2708,0,81,6,75,
2709,0,80,6,74,
2710,0,82,7,75,
2711,0,80,6,74,
2712,0,82,7,75,
2713,0,82,7,75,
2714,0,82,6,76,
2715,0,82,6,76,
2716,0,82,7,75,
2717,0,82,6,76,
2718,0,81,6,75,
2719,0,83,7,76,
2720,0,82,7,75,
2721,0,83,7,76,
2722,0,80,6,74,
2723,0,68,6,62,
2724,0,57,7,50,
2725,0,54,7,47,
2726,0,54,10,44,
2727,0,42,6,36,
2728,0,33,7,26,
2729,0,24,6,18,
2730,0,24,7,17,
2731,0,32,7,25,
2732,0,38,6,32,
2733,0,41,7,34,
2734,0,39,6,33,
2735,0,43,8,35,
2736,0,41,7,34,
2737,0,42,6,36,
2738,0,42,6,36,
2739,0,43,7,36,
2740,0,46,7,39,
2741,0,44,6,38,
2742,0,46,7,39,
2743,0,44,6,38,
2744,0,48,7,41,
2745,0,46,7,39,
2746,0,46,6,40,
2747,0,49,8,41,
2748,0,50,8,42,
2749,0,48,6,42,
2750,0,48,7,41,
2751,0,51,8,43,
2752,0,49,6,43,
2753,0,49,7,42,
2754,0,50,6,44,
2755,0,50,7,43,
2756,0,50,6,44,
2757,0,52,7,45,
2758,0,51,7,44,
2759,0,53,7,46,
2760,0,51,6,45,
2761,0,54,7,47,
2762,0,53,6,47,
2763,0,53,7,46,
2764,0,54,6,48,
2765,0,53,6,47,
2766,0,56,7,49,
2767,0,55,6,49,
2768,0,55,7,48,
2769,0,56,7,49,
2770,0,55,6,49,
2771,0,57,7,50,
2772,0,56,7,49,
2773,0,60,9,51,
2774,0,64,12,52,
2775,0,66,12,54,
2776,0,64,11,53,
2777,0,64,11,53,
2778,0,66,11,55,
2779,0,66,12,54,
2780,0,67,12,55,
2781,0,66,10,56,
2782,0,67,13,54,
2783,0,66,11,55,
2784,0,68,11,57,
2785,0,67,10,57,
2786,0,68,12,56,
2787,0,68,11,57,
2788,0,68,12,56,
2789,0,70,12,58,
2790,0,70,10,60,
2791,0,69,12,57,
2792,0,69,11,58,
2793,0,70,11,59,
2794,0,72,12,60,
2795,0,70,11,59,
2796,0,73,12,61,
2797,0,71,11,60,
2798,0,74,13,61,
2799,0,72,11,61,
2800,0,72,12,60,
2801,0,73,12,61,
2802,0,74,12,62,
2803,0,76,12,64,
2804,0,74,11,63,
2805,0,75,13,62,
2806,0,75,12,63,
2807,0,75,12,63,
2808,0,75,12,63,
2809,0,76,13,63,
2810,0,76,12,64,
2811,0,75,11,64,
2812,0,76,12,64,
2813,0,73,8,65,
2814,0,69,6,63,
2815,0,72,7,65,
2816,0,70,7,63,
2817,0,71,6,65,
2818,0,73,7,66,
2819,0,70,6,64,
2820,0,72,7,65,
2821,0,71,6,65,
2822,0,72,7,65,
2823,0,72,6,66,
2824,0,71,6,65,
2825,0,73,7,66,
2826,0,74,7,67,
2827,0,73,7,66,
2828,0,74,7,67,
2829,0,72,6,66,
2830,0,75,7,68,
2831,0,74,6,68,
2832,0,74,7,67,
2833,0,74,6,68,
2834,0,74,6,68,
2835,0,77,7,70,
2836,0,76,8,68,
2837,0,75,6,69,
2838,0,74,6,68,
2839,0,77,7,70,
2840,0,75,6,69,
2841,0,76,7,69,
2842,0,76,6,70,
2843,0,75,6,69,
2844,0,78,7,71,
2845,0,77,6,71,
2846,0,77,7,70,
2847,0,77,6,71,
2848,0,77,6,71,
2849,0,79,7,72,
2850,0,77,6,71,
2851,0,80,7,73,
2852,0,78,6,72,
2853,0,78,6,72,
2854,0,80,7,73,
2855,0,79,6,73,
2856,0,80,7,73,
2857,0,79,7,72,
2858,0,80,6,74,
2859,0,79,6,73,
2860,0,82,7,75,
2861,0,80,6,74,
2862,0,79,6,73,
2863,0,82,7,75,
2864,0,82,7,75,
2865,0,81,6,75,
2866,0,81,7,74,
2867,0,83,6,77,
2868,0,81,6,75,
2869,0,84,7,77,
2870,0,82,6,76,
2871,0,83,7,76,
2872,0,82,7,75,
2873,0,82,6,76,
2874,0,82,7,75,
2875,0,84,8,76,
2876,0,82,7,75,
2877,0,82,6,76,
2878,0,72,6,66,
2879,0,61,7,54,
2880,0,53,6,47,
2881,0,54,8,46,
2882,0,49,9,40,
2883,0,36,6,30,
2884,0,29,6,23,
2885,0,23,6,17,
2886,0,25,7,18,
2887,0,37,7,30,
2888,0,40,7,33,
2889,0,40,7,33,
2890,0,41,6,35,
2891,0,40,6,34,
2892,0,43,7,36,
2893,0,42,6,36,
2894,0,43,7,36,
2895,0,43,6,37,
2896,0,43,6,37,
2897,0,44,7,37,
2898,0,45,6,39,
2899,0,45,7,38,
2900,0,46,6,40,
2901,0,45,6,39,
2902,0,48,7,41,
2903,0,47,6,41,
2904,0,47,6,41,
2905,0,49,7,42,
2906,0,47,6,41,
2907,0,51,8,43,
2908,0,49,6,43,
2909,0,50,7,43,
2910,0,50,6,44,
2911,0,49,6,43,
2912,0,52,7,45,
2913,0,52,7,45,
2914,0,52,6,46,
2915,0,52,7,45,
2916,0,52,6,46,
2917,0,52,6,46,
2918,0,54,7,47,
2919,0,52,6,46,
2920,0,56,7,49,
2921,0,54,6,48,
2922,0,54,6,48,
2923,0,55,6,49,
2924,0,55,7,48,
2925,0,56,6,50,
2926,0,56,7,49,
2927,0,57,7,50,
2928,0,56,6,50,
2929,0,59,7,52,
2930,0,57,6,51,
2931,0,57,6,51,
2932,0,59,7,52,
2933,0,58,6,52,
2934,0,59,7,52,
2935,0,59,6,53,
2936,0,58,6,52,
2937,0,61,7,54,
2938,0,61,7,54,
2939,0,59,6,53,
2940,0,60,7,53,
2941,0,61,6,55,
2942,0,61,7,54,
2943,0,61,6,55,
2944,0,61,6,55,
2945,0,63,7,56,
2946,0,62,6,56,
2947,0,62,7,55,
2948,0,64,7,57,
2949,0,62,6,56,
2950,0,65,7,58,
2951,0,64,6,58,
2952,0,64,7,57,
2953,0,64,6,58,
2954,0,63,6,57,
2955,0,68,9,59,
2956,0,67,7,60,
2957,0,65,6,59,
2958,0,67,7,60,
2959,0,66,7,59,
2960,0,67,7,60,
2961,0,65,6,59,
2962,0,68,7,61,
2963,0,67,6,61,
2964,0,66,6,60,
2965,0,68,7,61,
2966,0,68,6,62,
2967,0,69,7,62,
2968,0,68,7,61,
2969,0,68,6,62,
2970,0,68,6,62,
2971,0,69,7,62,
2972,0,71,7,64,
2973,0,69,6,63,
2974,0,69,6,63,
2975,0,71,7,64,
2976,0,69,6,63,
2977,0,71,7,64,
2978,0,71,7,64,
2979,0,71,6,65,
2980,0,70,6,64,
2981,0,73,7,66,
2982,0,72,6,66,
2983,0,71,6,65,
2984,0,73,7,66,
2985,0,73,7,66,
2986,0,74,7,67,
2987,0,73,6,67,
2988,0,73,7,66,
2989,0,73,6,67,
2990,0,75,7,68,
2991,0,74,6,68,
2992,0,74,7,67,
2993,0,74,6,68,
2994,0,73,6,67,
2995,0,76,7,69,
2996,0,74,6,68,
2997,0,75,7,68,
2998,0,74,6,68,
2999,0,75,7,68,
3000,0,78,7,71,
3001,0,77,7,70,
3002,0,77,7,70,
3003,0,75,6,69,
3004,0,78,7,71,
3005,0,78,7,71,
3006,0,77,6,71,
3007,0,76,6,70,
3008,0,78,7,71,
3009,0,77,6,71,
3010,0,80,7,73,
3011,0,78,6,72,
3012,0,78,7,71,
3013,0,79,6,73,
3014,0,78,6,72,
3015,0,80,7,73,
3016,0,81,8,73,
3017,0,80,7,73,
3018,0,80,6,74,
3019,0,80,7,73,
3020,0,80,6,74,
3021,0,80,7,73,
3022,0,81,7,74,
3023,0,81,6,75,
3024,0,81,7,74,
3025,0,81,6,75,
3026,0,81,7,74,
3027,0,81,6,75,
3028,0,83,7,76,
3029,0,81,6,75,
3030,0,84,7,77,
3031,0,82,6,76,
3032,0,82,7,75,
3033,0,82,6,76,
3034,0,81,6,75,
3035,0,83,7,76,
3036,0,82,7,75,
3037,0,82,7,75,
3038,0,81,7,74,
3039,0,68,6,62,
3040,0,58,7,51,
3041,0,53,6,47,
3042,0,50,6,44,
3043,0,44,6,38,
3044,0,34,7,27,
3045,0,27,6,21,
3046,0,25,8,17,
3047,0,27,6,21,
3048,0,39,6,33,
3049,0,40,7,33,
3050,0,41,7,34,
3051,0,42,8,34,
3052,0,41,6,35,
3053,0,41,6,35,
3054,0,43,7,36,
3055,0,43,6,37,
3056,0,42,6,36,
3057,0,45,7,38,
3058,0,45,7,38,
3059,0,46,6,40,
3060,0,44,6,38,
3061,0,47,8,39,
3062,0,46,6,40,
3063,0,48,7,41,
3064,0,46,6,40,
3065,0,49,7,42,
3066,0,47,6,41,
3067,0,50,7,43,
3068,0,50,7,43,
3069,0,49,6,43,
3070,0,50,7,43,
3071,0,50,6,44,
3072,0,51,6,45,
3073,0,51,7,44,
3074,0,51,6,45,
3075,0,51,6,45,
3076,0,54,8,46,
3077,0,53,7,46,
3078,0,54,7,47,
3079,0,53,7,46,
3080,0,55,7,48,
3081,0,54,6,48,
3082,0,54,7,47,
3083,0,55,6,49,
3084,0,54,6,48,
3085,0,56,7,49,
3086,0,56,6,50,
3087,0,56,7,49,
3088,0,56,6,50,
3089,0,56,6,50,
3090,0,59,7,52,
3091,0,57,7,50,
3092,0,59,7,52,
3093,0,59,7,52,
3094,0,58,6,52,
3095,0,59,7,52,
3096,0,59,6,53,
3097,0,58,6,52,
3098,0,60,7,53,
3099,0,62,7,55,
3100,0,60,6,54,
3101,0,59,6,53,
3102,0,62,7,55,
3103,0,61,6,55,
3104,0,61,7,54,
3105,0,62,6,56,
3106,0,63,7,56,
3107,0,62,7,55,
3108,0,64,7,57,
3109,0,62,6,56,
3110,0,64,7,57,
3111,0,64,7,57,
3112,0,64,6,58,
3113,0,64,7,57,
3114,0,63,6,57,
3115,0,66,7,59,
3116,0,64,6,58,
3117,0,65,7,58,
3118,0,65,6,59,
3119,0,65,6,59,
3120,0,67,7,60,
3121,0,66,6,60,
3122,0,67,7,60,
3123,0,67,7,60,
3124,0,67,7,60,
3125,0,67,6,61,
3126,0,67,6,61,
3127,0,68,7,61,
3128,0,68,6,62,
3129,0,69,7,62,
3130,0,67,6,61,
3131,0,70,7,63,
3132,0,69,6,63,
3133,0,69,7,62,
3134,0,69,6,63,
3135,0,70,6,64,
3136,0,70,7,63,
3137,0,70,7,63,
3138,0,71,7,64,
3139,0,71,7,64,
3140,0,72,7,65,
3141,0,71,6,65,
3142,0,71,7,64,
3143,0,72,6,66,
3144,0,74,7,67,
3145,0,72,6,66,
3146,0,72,7,65,
3147,0,74,7,67,
3148,0,72,6,66,
3149,0,74,7,67,
3150,0,74,7,67,
3151,0,73,6,67,
3152,0,74,7,67,
3153,0,74,6,68,
3154,0,74,7,67,
3155,0,75,7,68,
3156,0,74,6,68,
3157,0,76,7,69,
3158,0,75,6,69,
3159,0,75,7,68,
3160,0,76,6,70,
3161,0,75,6,69,
3162,0,78,7,71,
3163,0,76,6,70,
3164,0,75,6,69,
3165,0,78,7,71,
3166,0,77,6,71,
3167,0,79,8,71,
3168,0,77,7,70,
3169,0,79,7,72,
3170,0,77,6,71,
3171,0,80,7,73,
3172,0,78,6,72,
3173,0,77,6,71,
3174,0,80,7,73,
3175,0,79,6,73,
3176,0,80,7,73,
3177,0,79,7,72,
3178,0,80,7,73,
3179,0,81,7,74,
3180,0,82,7,75,
3181,0,80,6,74,
3182,0,79,6,73,
3183,0,81,7,74,
3184,0,80,6,74,
3185,0,82,8,74,
3186,0,81,6,75,
3187,0,80,6,74,
3188,0,82,7,75,
3189,0,82,6,76,
3190,0,83,8,75,
3191,0,81,6,75,
3192,0,83,7,76,
3193,0,81,6,75,
3194,0,82,7,75,
3195,0,82,6,76,
3196,0,82,7,75,
3197,0,83,7,76,
3198,0,82,6,76,
3199,0,80,7,73,
3200,0,67,6,61,
3201,0,56,7,49,
3202,0,52,6,46,
3203,0,50,7,43,
3204,0,41,6,35,
3205,0,33,6,27,
3206,0,27,7,20,
3207,0,25,7,18,
3208,0,30,6,24,
3209,0,39,7,32,
3210,0,40,6,34,
3211,0,39,6,33,
3212,0,42,7,35,
3213,0,40,6,34,
3214,0,44,7,37,
3215,0,43,6,37,
3216,0,42,6,36,
3217,0,46,7,39,
3218,0,44,6,38,
3219,0,43,6,37,
3220,0,45,7,38,
3221,0,46,7,39,
3222,0,46,6,40,
3223,0,46,7,39,
3224,0,47,6,41,
3225,0,46,6,40,
3226,0,50,7,43,
3227,0,48,6,42,
3228,0,51,8,43,
3229,0,48,6,42,
3230,0,50,7,43,
3231,0,51,7,44,
3232,0,50,7,43,
3233,0,51,6,45,
3234,0,52,7,45,
3235,0,53,7,46,
3236,0,52,6,46,
3237,0,53,7,46,
3238,0,51,6,45,
3239,0,55,7,48,
3240,0,53,7,46,
3241,0,54,6,48,
3242,0,53,6,47,
3243,0,55,7,48,
3244,0,55,6,49,
3245,0,55,7,48,
3246,0,57,8,49,
3247,0,57,7,50,
3248,0,56,6,50,
3249,0,56,7,49,
3250,0,57,6,51,
3251,0,56,6,50,
3252,0,58,7,51,
3253,0,58,6,52,
3254,0,57,6,51,
3255,0,59,7,52,
3256,0,58,6,52,
3257,0,59,7,52,
3258,0,63,10,53,
3259,0,60,7,53,
3260,0,60,7,53,
3261,0,61,8,53,
3262,0,61,7,54,
3263,0,60,6,54,
3264,0,62,7,55,
3265,0,62,7,55,
3266,0,64,7,57,
3267,0,62,6,56,
3268,0,62,7,55,
3269,0,63,6,57,
3270,0,62,6,56,
3271,0,64,7,57,
3272,0,64,7,57,
3273,0,63,6,57,
3274,0,64,7,57,
3275,0,64,6,58,
3276,0,66,8,58,
3277,0,65,6,59,
3278,0,64,6,58,
3279,0,67,7,60,
3280,0,66,6,60,
3281,0,67,7,60,
3282,0,66,7,59,
3283,0,66,6,60,
3284,0,66,6,60,
3285,0,68,7,61,
3286,0,66,6,60,
3287,0,67,7,60,
3288,0,70,8,62,
3289,0,67,6,61,
3290,0,68,7,61,
3291,0,68,6,62,
3292,0,70,7,63,
3293,0,70,7,63,
3294,0,69,6,63,
3295,0,69,7,62,
3296,0,70,6,64,
3297,0,70,6,64,
3298,0,70,7,63,
3299,0,70,6,64,
3300,0,70,6,64,
3301,0,71,7,64,
3302,0,72,7,65,
3303,0,71,6,65,
3304,0,72,7,65,
3305,0,72,6,66,
3306,0,71,6,65,
3307,0,73,7,66,
3308,0,73,7,66,
3309,0,73,7,66,
3310,0,73,6,67,
3311,0,72,6,66,
3312,0,75,7,68,
3313,0,74,6,68,
3314,0,73,6,67,
3315,0,75,7,68,
3316,0,73,6,67,
3317,0,75,7,68,
3318,0,75,6,69,
3319,0,81,11,70,
3320,0,75,6,69,
3321,0,77,7,70,
3322,0,77,7,70,
3323,0,76,6,70,
3324,0,76,7,69,
3325,0,78,7,71,
3326,0,77,7,70,
3327,0,77,6,71,
3328,0,78,7,71,
3329,0,76,6,70,
3330,0,79,7,72,
3331,0,80,7,73,
3332,0,77,6,71,
3333,0,78,7,71,
3334,0,78,6,72,
3335,0,80,7,73,
3336,0,78,6,72,
3337,0,80,7,73,
3338,0,78,6,72,
3339,0,81,7,74,
3340,0,80,6,74,
3341,0,79,6,73,
3342,0,81,7,74,
3343,0,80,6,74,
3344,0,80,7,73,
3345,0,81,6,75,
3346,0,84,8,76,
3347,0,81,6,75,
3348,0,80,6,74,
3349,0,84,8,76,
3350,0,83,7,76,
3351,0,83,8,75,
3352,0,82,6,76,
3353,0,84,9,75,
3354,0,82,7,75,
3355,0,83,7,76,
3356,0,83,7,76,
3357,0,81,6,75,
3358,0,83,7,76,
3359,0,81,6,75,
3360,0,76,7,69,
3361,0,63,6,57,
3362,0,53,7,46,
3363,0,54,7,47,
3364,0,47,6,41,
3365,0,38,6,32,
3366,0,30,6,24,
3367,0,25,7,18,
3368,0,25,7,18,
3369,0,33,6,27,
3370,0,39,7,32,
3371,0,39,6,33,
3372,0,41,7,34,
3373,0,40,6,34,
3374,0,42,7,35,
3375,0,42,6,36,
3376,0,42,6,36,
3377,0,43,7,36,
3378,0,44,6,38,
3379,0,44,7,37,
3380,0,46,7,39,
3381,0,46,7,39,
3382,0,46,7,39,
3383,0,46,6,40,
3384,0,47,6,41,
3385,0,47,7,40,
3386,0,47,6,41,
3387,0,47,6,41,
3388,0,49,7,42,
3389,0,49,6,43,
3390,0,49,7,42,
3391,0,50,6,44,
3392,0,50,7,43,
3393,0,52,7,45,
3394,0,51,6,45,
3395,0,51,7,44,
3396,0,51,6,45,
3397,0,51,6,45,
3398,0,52,7,45,
3399,0,55,7,48,
3400,0,53,6,47,
3401,0,52,6,46,
3402,0,54,7,47,
3403,0,56,7,49,
3404,0,54,6,48,
3405,0,55,7,48,
3406,0,55,6,49,
3407,0,54,6,48,
3408,0,57,7,50,
3409,0,57,7,50,
3410,0,56,7,49,
3411,0,58,7,51,
3412,0,56,6,50,
3413,0,57,7,50,
3414,0,58,6,52,
3415,0,58,7,51,
3416,0,58,6,52,
3417,0,59,7,52,
3418,0,61,7,54,
3419,0,61,7,54,
3420,0,62,7,55,
3421,0,59,6,53,
3422,0,61,7,54,
3423,0,61,7,54,
3424,0,61,6,55,
3425,0,60,6,54,
3426,0,63,7,56,
3427,0,62,6,56,
3428,0,62,7,55,
3429,0,63,7,56,
3430,0,62,6,56,
3431,0,64,7,57,
3432,0,64,7,57,
3433,0,63,6,57,
3434,0,64,7,57,
3435,0,64,6,58,
3436,0,64,6,58,
3437,0,65,7,58,
3438,0,65,6,59,
3439,0,64,6,58,
3440,0,65,7,58,
3441,0,66,7,59,
3442,0,66,7,59,
3443,0,66,6,60,
3444,0,65,6,59,
3445,0,68,7,61,
3446,0,67,7,60,
3447,0,67,7,60,
3448,0,68,6,62,
3449,0,67,6,61,
3450,0,69,7,62,
3451,0,67,6,61,
3452,0,69,7,62,
3453,0,68,6,62,
3454,0,70,7,63,
3455,0,69,6,63,
3456,0,70,7,63,
3457,0,70,6,64,
3458,0,69,6,63,
3459,0,71,7,64,
3460,0,70,6,64,
3461,0,73,7,66,
3462,0,70,6,64,
3463,0,72,7,65,
3464,0,70,6,64,
3465,0,74,7,67,
3466,0,72,6,66,
3467,0,72,7,65,
3468,0,72,6,66,
3469,0,72,6,66,
3470,0,75,7,68,
3471,0,73,6,67,
3472,0,72,6,66,
3473,0,74,7,67,
3474,0,74,7,67,
3475,0,75,7,68,
3476,0,74,7,67,
3477,0,75,6,69,
3478,0,74,6,68,
3479,0,77,7,70,
3480,0,75,6,69,
3481,0,75,7,68,
3482,0,76,6,70,
3483,0,77,7,70,
3484,0,75,6,69,
3485,0,76,7,69,
3486,0,76,6,70,
3487,0,76,6,70,
3488,0,79,7,72,
3489,0,77,6,71,
3490,0,78,8,70,
3491,0,78,6,72,
3492,0,77,6,71,
3493,0,79,7,72,
3494,0,77,6,71,
3495,0,79,7,72,
3496,0,82,8,74,
3497,0,81,7,74,
3498,0,79,6,73,
3499,0,79,7,72,
3500,0,79,7,72,
3501,0,79,6,73,
3502,0,81,7,74,
3503,0,81,7,74,
3504,0,80,6,74,
3505,0,82,7,75,
3506,0,80,6,74,
3507,0,82,7,75,
3508,0,81,6,75,
3509,0,81,7,74,
3510,0,82,6,76,
3511,0,81,6,75,
3512,0,83,7,76,
3513,0,84,7,77,
3514,0,82,6,76,
3515,0,81,6,75,
3516,0,83,7,76,
3517,0,82,6,76,
3518,0,81,6,75,
3519,0,83,7,76,
3520,0,81,6,75,
3521,0,75,7,68,
3522,0,62,6,56,
3523,0,53,7,46,
3524,0,54,7,47,
3525,0,47,6,41,
3526,0,37,6,31,
3527,0,28,6,22,
3528,0,25,7,18,
3529,0,25,6,19,
3530,0,33,7,26,
3531,0,39,6,33,
3532,0,39,6,33,
3533,0,43,7,36,
3534,0,41,6,35,
3535,0,41,6,35,
3536,0,43,7,36,
3537,0,42,6,36,
3538,0,44,7,37,
3539,0,45,7,38,
3540,0,44,6,38,
3541,0,45,7,38,
3542,0,45,6,39,
3543,0,48,7,41,
3544,0,46,6,40,
3545,0,47,7,40,
3546,0,47,6,41,
3547,0,46,6,40,
3548,0,49,7,42,
3549,0,48,6,42,
3550,0,49,7,42,
3551,0,50,7,43,
3552,0,50,6,44,
3553,0,51,7,44,
3554,0,49,6,43,
3555,0,52,7,45,
3556,0,50,6,44,
3557,0,51,7,44,
3558,0,52,6,46,
3559,0,53,7,46,
3560,0,53,6,47,
3561,0,52,6,46,
3562,0,54,8,46,
3563,0,55,7,48,
3564,0,53,6,47,
3565,0,56,7,49,
3566,0,55,6,49,
3567,0,55,7,48,
3568,0,56,6,50,
3569,0,55,6,49,
3570,0,58,7,51,
3571,0,57,6,51,
3572,0,56,6,50,
3573,0,58,7,51,
3574,0,57,6,51,
3575,0,58,7,51,
3576,0,58,6,52,
3577,0,57,6,51,
3578,0,60,7,53,
3579,0,59,6,53,
3580,0,58,6,52,
3581,0,61,7,54,
3582,0,62,7,55,
3583,0,60,6,54,
3584,0,62,8,54,
3585,0,62,7,55,
3586,0,60,6,54,
3587,0,64,7,57,
3588,0,62,6,56,
3589,0,61,6,55,
3590,0,64,7,57,
3591,0,65,8,57,
3592,0,64,8,56,
3593,0,63,6,57,
3594,0,62,6,56,
3595,0,65,7,58,
3596,0,66,7,59,
3597,0,64,6,58,
3598,0,64,6,58,
3599,0,68,8,60,
3600,0,65,6,59,
3601,0,64,6,58,
3602,0,67,7,60,
3603,0,65,6,59,
3604,0,67,7,60,
3605,0,66,7,59,
3606,0,67,6,61,
3607,0,66,6,60,
3608,0,69,7,62,
3609,0,68,6,62,
3610,0,67,6,61,
3611,0,69,7,62,
3612,0,67,6,61,
3613,0,69,7,62,
3614,0,69,6,63,
3615,0,68,6,62,
3616,0,70,7,63,
3617,0,70,6,64,
3618,0,69,6,63,
3619,0,71,8,63,
3620,0,70,6,64,
3621,0,70,6,64,
3622,0,71,7,64,
3623,0,72,7,65,
3624,0,71,6,65,
3625,0,71,7,64,
3626,0,72,6,66,
3627,0,72,6,66,
3628,0,72,7,65,
3629,0,72,7,65,
3630,0,74,7,67,
3631,0,72,6,66,
3632,0,73,7,66,
3633,0,73,6,67,
3634,0,75,8,67,
3635,0,74,7,67,
3636,0,58,1,57,
3637,0,36,,36,
3638,0,12,,12,
